PokerStars Hand #3661260797: Tournament #21391319, $20+$2 - Hold'em No Limit (30/60) - 2018/04/06 22:06:14
Table '#18' Seat #5 is the button
Seat 1: Antonietta_Honeyberry (10,000 in chips)
Seat 2: Georgiann_Tabasco (9,980 in chips)
Seat 3: Hero (10,000 in chips)
Seat 4: Hulda_Salak (10,000 in chips)
Seat 5: Vernia_Lime (10,020 in chips)
Seat 6: Vincenzo_Tabasco (10,029 in chips)
Seat 7: Josefa_Honeyberry (14,870 in chips)
Vincenzo_Tabasco: posts small blind 30
Josefa_Honeyberry: posts big blind 60
*** HOLE CARDS ***
Dealt to Hero [Qd 7h]
Antonietta_Honeyberry: folds
Georgiann_Tabasco: folds
Hero: folds
Hulda_Salak: folds
Vernia_Lime: folds
Vincenzo_Tabasco: raises 150 to 180
Josefa_Honeyberry: calls 120 
*** FLOP *** [Ac 4c Qh]
Vincenzo_Tabasco: bets 200 
Josefa_Honeyberry: calls 200 
*** TURN *** [Ac 4c Qh] [Jh]
Vincenzo_Tabasco: bets 400 
Josefa_Honeyberry: calls 400 
*** RIVER *** [Ac 4c Qh Jh] [2c]
Vincenzo_Tabasco: bets 750 
Josefa_Honeyberry: calls 750 
*** SHOW DOWN ***
Vincenzo_Tabasco: shows [Ad Jd] (two pair, Aces and Jacks)
Josefa_Honeyberry: Mucks [Td Ah] (One pair)
Vincenzo_Tabasco collected 3060 from pot
*** SUMMARY ***
Total pot 3060 | Rake 0
Board [Ac 4c Qh Jh 2c]
Seat 1: Antonietta_Honeyberry mucked [4h 8s]
Seat 2: Georgiann_Tabasco mucked [6h Qs]
Seat 3: Hero mucked [Qd 7h]
Seat 4: Hulda_Salak mucked [5s Tc]
Seat 5: Vernia_Lime (button) mucked [6d Js]
Seat 6: Vincenzo_Tabasco (small blind) showed [Ad Jd] and won (3060) with two pair, Aces and Jacks
Seat 7: Josefa_Honeyberry (big blind) mucked [Td Ah]



PokerStars Hand #3661261701: Tournament #21391319, $20+$2 - Hold'em No Limit (30/60) - 2018/04/06 22:07:41
Table '#18' Seat #7 is the button
Seat 1: Lionel_Nettles (10,000 in chips)
Seat 2: Elda_Arugula (9,980 in chips)
Seat 3: Hero (10,000 in chips)
Seat 4: Lizbeth_Bananas (10,020 in chips)
Seat 5: Armandina_Goji (10,000 in chips)
Seat 6: Tyler_Persimmon (10,000 in chips)
Seat 7: Eilene_Beets (11,559 in chips)
Seat 8: Kylee_Cabbage (13,340 in chips)
Kylee_Cabbage: posts small blind 30
Lionel_Nettles: posts big blind 60
*** HOLE CARDS ***
Dealt to Hero [5h Th]
Elda_Arugula: folds
Hero: folds
Lizbeth_Bananas: folds
Armandina_Goji: folds
Tyler_Persimmon: raises 120 to 120
Eilene_Beets: calls 120 
Kylee_Cabbage: folds
Lionel_Nettles: folds
*** FLOP *** [Jh 7h 8c]
Tyler_Persimmon: bets 60 
Eilene_Beets: calls 60 
*** TURN *** [Jh 7h 8c] [6d]
Tyler_Persimmon: bets 60 
Eilene_Beets: raises 222 to 222
Tyler_Persimmon: folds
Uncalled bet (162) returned to Eilene_Beets
Eilene_Beets: doesn't show hand
Eilene_Beets collected 570 from pot
*** SUMMARY ***
Total pot 570 | Rake 0
Board [Jh 7h 8c 6d]
Seat 1: Lionel_Nettles (big blind) mucked [7s 6c]
Seat 2: Elda_Arugula mucked [Jc 4h]
Seat 3: Hero mucked [5h Th]
Seat 4: Lizbeth_Bananas mucked [As 2h]
Seat 5: Armandina_Goji mucked [Kc Ts]
Seat 6: Tyler_Persimmon mucked [Ks 8d]
Seat 7: Eilene_Beets (button) showed [4c 5c] and won (570)
Seat 8: Kylee_Cabbage (small blind) mucked [2d 5d]



PokerStars Hand #3661262348: Tournament #21391319, $20+$2 - Hold'em No Limit (30/60) - 2018/04/06 22:08:41
Table '#18' Seat #9 is the button
Seat 1: Signe_Juniper (9,940 in chips)
Seat 2: Carli_Cucumber (9,980 in chips)
Seat 3: Hero (10,000 in chips)
Seat 4: Brinda_Soy (10,000 in chips)
Seat 5: Sudie_Yuzu (10,020 in chips)
Seat 6: Vincenza_Daikon (10,000 in chips)
Seat 7: Adrianne_Tangerine (9,760 in chips)
Seat 8: Hubert_Artichoke (11,889 in chips)
Seat 9: Mitchel_Goji (13,310 in chips)
Signe_Juniper: posts small blind 30
Carli_Cucumber: posts big blind 60
*** HOLE CARDS ***
Dealt to Hero [Ah Qs]
Hero: raises 180 to 180
Brinda_Soy: folds
Sudie_Yuzu: folds
Vincenza_Daikon: folds
Adrianne_Tangerine: calls 180 
Hubert_Artichoke: folds
Mitchel_Goji: folds
Signe_Juniper: calls 150 
Carli_Cucumber: folds
*** FLOP *** [Qh 8d Jd]
Signe_Juniper: checks
Hero: bets 400 
Adrianne_Tangerine: folds
Signe_Juniper: folds
Uncalled bet (400) returned to Hero
Hero: doesn't show hand
Hero collected 600 from pot
*** SUMMARY ***
Total pot 600 | Rake 0
Board [Qh 8d Jd]
Seat 1: Signe_Juniper (small blind) mucked [4s Ks]
Seat 2: Carli_Cucumber (big blind) mucked [9h 2s]
Seat 3: Hero showed [Ah Qs] and won (600)
Seat 4: Brinda_Soy mucked [Kh 2h]
Seat 5: Sudie_Yuzu mucked [2d 6d]
Seat 6: Vincenza_Daikon mucked [Jc Tc]
Seat 7: Adrianne_Tangerine mucked [6h 4c]
Seat 8: Hubert_Artichoke mucked [2c Th]
Seat 9: Mitchel_Goji (button) mucked [Ts Kd]



PokerStars Hand #3661263420: Tournament #21391319, $20+$2 - Hold'em No Limit (30/60) - 2018/04/06 22:10:26
Table '#18' Seat #1 is the button
Seat 1: Catheryn_Potatos (9,760 in chips)
Seat 2: Teodora_Soy (9,920 in chips)
Seat 3: Hero (10,420 in chips)
Seat 4: Joseph_Honeyberry (10,000 in chips)
Seat 5: Desirae_Rutabaga (10,020 in chips)
Seat 6: Burma_Plum (10,000 in chips)
Seat 7: Jamaal_Jujube (9,580 in chips)
Seat 8: Yung_Butternut (11,889 in chips)
Seat 9: Lurline_Avocados (13,310 in chips)
Teodora_Soy: posts small blind 30
Hero: posts big blind 60
*** HOLE CARDS ***
Dealt to Hero [8d 3h]
Joseph_Honeyberry: folds
Desirae_Rutabaga: folds
Burma_Plum: folds
Jamaal_Jujube: calls 60 
Yung_Butternut: raises 270 to 270
Lurline_Avocados: calls 270 
Catheryn_Potatos: folds
Teodora_Soy: folds
Hero: folds
Jamaal_Jujube: calls 210 
*** FLOP *** [2c 8s 9d]
Jamaal_Jujube: checks
Yung_Butternut: bets 360 
Lurline_Avocados: calls 360 
Jamaal_Jujube: folds
*** TURN *** [2c 8s 9d] [7d]
Yung_Butternut: bets 890 
Lurline_Avocados: folds
Uncalled bet (890) returned to Yung_Butternut
Yung_Butternut: doesn't show hand
Yung_Butternut collected 1620 from pot
*** SUMMARY ***
Total pot 1620 | Rake 0
Board [2c 8s 9d 7d]
Seat 1: Catheryn_Potatos (button) mucked [5h 4c]
Seat 2: Teodora_Soy (small blind) mucked [7s Qs]
Seat 3: Hero (big blind) mucked [8d 3h]
Seat 4: Joseph_Honeyberry mucked [Ks 7h]
Seat 5: Desirae_Rutabaga mucked [4s 6d]
Seat 6: Burma_Plum mucked [Qd 3c]
Seat 7: Jamaal_Jujube mucked [Kc 4h]
Seat 8: Yung_Butternut showed [9h 9s] and won (1620)
Seat 9: Lurline_Avocados mucked [Qh As]



PokerStars Hand #3661264773: Tournament #21391319, $20+$2 - Hold'em No Limit (30/60) - 2018/04/06 22:12:35
Table '#18' Seat #2 is the button
Seat 1: Elva_Radicchio (9,760 in chips)
Seat 2: Kacy_Jalapeño (9,890 in chips)
Seat 3: Hero (10,360 in chips)
Seat 4: Romona_Rhubarb (10,000 in chips)
Seat 5: Madie_Horseradish (10,020 in chips)
Seat 6: Jeanie_Butternut (10,000 in chips)
Seat 7: Dinorah_Plantain (9,310 in chips)
Seat 8: Naida_Apricots (12,879 in chips)
Seat 9: Malvina_Basil (12,680 in chips)
Hero: posts small blind 30
Romona_Rhubarb: posts big blind 60
*** HOLE CARDS ***
Dealt to Hero [3d 9c]
Madie_Horseradish: folds
Jeanie_Butternut: folds
Dinorah_Plantain: raises 207 to 207
Naida_Apricots: calls 207 
Malvina_Basil: folds
Elva_Radicchio: folds
Kacy_Jalapeño: folds
Hero: folds
Romona_Rhubarb: folds
*** FLOP *** [5h Qd 4c]
Dinorah_Plantain: bets 254 
Naida_Apricots: calls 254 
*** TURN *** [5h Qd 4c] [7d]
Dinorah_Plantain: bets 509 
Naida_Apricots: calls 509 
*** RIVER *** [5h Qd 4c 7d] [Ks]
Dinorah_Plantain: checks
Naida_Apricots: checks
*** SHOW DOWN ***
Dinorah_Plantain: shows [Td Ac] (high card Ace)
Naida_Apricots: shows [Qh Jh] (a pair of Queens)
Naida_Apricots collected 2030 from pot
*** SUMMARY ***
Total pot 2030 | Rake 0
Board [5h Qd 4c 7d Ks]
Seat 1: Elva_Radicchio mucked [Qc 5s]
Seat 2: Kacy_Jalapeño (button) mucked [6d Jc]
Seat 3: Hero (small blind) mucked [3d 9c]
Seat 4: Romona_Rhubarb (big blind) mucked [As 4d]
Seat 5: Madie_Horseradish mucked [Qs 9h]
Seat 6: Jeanie_Butternut mucked [7h 6s]
Seat 7: Dinorah_Plantain showed [Td Ac] and lost with high card Ace
Seat 8: Naida_Apricots showed [Qh Jh] and won (2030) with a pair of Queens
Seat 9: Malvina_Basil mucked [6h 2h]



PokerStars Hand #3661265930: Tournament #21391319, $20+$2 - Hold'em No Limit (30/60) - 2018/04/06 22:14:23
Table '#18' Seat #3 is the button
Seat 1: Deanne_Papaya (9,760 in chips)
Seat 2: Teisha_Cabbage (9,890 in chips)
Seat 3: Hero (10,330 in chips)
Seat 4: Mercedez_Yuzu (9,940 in chips)
Seat 5: Misha_Cherry (10,020 in chips)
Seat 6: Karry_Blueberry (10,000 in chips)
Seat 7: Lance_Celeriac (8,340 in chips)
Seat 8: Vannesa_Ginger (13,939 in chips)
Seat 9: Tish_Thyme (12,680 in chips)
Mercedez_Yuzu: posts small blind 30
Misha_Cherry: posts big blind 60
*** HOLE CARDS ***
Dealt to Hero [6s Ks]
Karry_Blueberry: folds
Lance_Celeriac: raises 320 to 320
Vannesa_Ginger: raises 818 to 818
Tish_Thyme: folds
Deanne_Papaya: calls 818 
Teisha_Cabbage: folds
Hero: folds
Mercedez_Yuzu: folds
Misha_Cherry: folds
Lance_Celeriac: calls 498 
*** FLOP *** [4c 6h 7h]
Lance_Celeriac: bets 60 
Vannesa_Ginger: raises 1418 to 1418
Deanne_Papaya: folds
Lance_Celeriac: folds
Uncalled bet (1358) returned to Vannesa_Ginger
Vannesa_Ginger: doesn't show hand
Vannesa_Ginger collected 2664 from pot
*** SUMMARY ***
Total pot 2664 | Rake 0
Board [4c 6h 7h]
Seat 1: Deanne_Papaya mucked [8d Ac]
Seat 2: Teisha_Cabbage mucked [4d 7s]
Seat 3: Hero (button) mucked [6s Ks]
Seat 4: Mercedez_Yuzu (small blind) mucked [Td 9d]
Seat 5: Misha_Cherry (big blind) mucked [6d 2c]
Seat 6: Karry_Blueberry mucked [Jc 2h]
Seat 7: Lance_Celeriac mucked [Jd Kd]
Seat 8: Vannesa_Ginger showed [Qd Qh] and won (2664)
Seat 9: Tish_Thyme mucked [Ts 6c]



PokerStars Hand #3661267605: Tournament #21391319, $20+$2 - Hold'em No Limit (40/80) - 2018/04/06 22:16:56
Table '#18' Seat #4 is the button
Seat 1: Andera_Ginger (8,942 in chips)
Seat 2: Sadye_Raspberry (9,890 in chips)
Seat 3: Hero (10,330 in chips)
Seat 4: Caterina_Jujube (9,910 in chips)
Seat 5: Mora_Chili (9,960 in chips)
Seat 6: Terry_Lavender (10,000 in chips)
Seat 7: Eulah_Lettuce (7,462 in chips)
Seat 8: Quintin_Tomatoes (15,725 in chips)
Seat 9: Rima_Olive (12,680 in chips)
Mora_Chili: posts small blind 40
Terry_Lavender: posts big blind 80
*** HOLE CARDS ***
Dealt to Hero [Ts 4s]
Eulah_Lettuce: calls 80 
Quintin_Tomatoes: folds
Rima_Olive: calls 80 
Andera_Ginger: folds
Sadye_Raspberry: folds
Hero: folds
Caterina_Jujube: folds
Mora_Chili: calls 40 
Terry_Lavender: folds
*** FLOP *** [5c 5d Qh]
Mora_Chili: checks
Eulah_Lettuce: checks
Rima_Olive: checks
*** TURN *** [5c 5d Qh] [Ac]
Mora_Chili: checks
Eulah_Lettuce: bets 80 
Rima_Olive: folds
Mora_Chili: folds
Uncalled bet (80) returned to Eulah_Lettuce
Eulah_Lettuce: doesn't show hand
Eulah_Lettuce collected 320 from pot
*** SUMMARY ***
Total pot 320 | Rake 0
Board [5c 5d Qh Ac]
Seat 1: Andera_Ginger mucked [7d 6c]
Seat 2: Sadye_Raspberry mucked [9h Jd]
Seat 3: Hero mucked [Ts 4s]
Seat 4: Caterina_Jujube (button) mucked [Qc 5s]
Seat 5: Mora_Chili (small blind) mucked [Kd 8c]
Seat 6: Terry_Lavender (big blind) mucked [8d Ks]
Seat 7: Eulah_Lettuce showed [5h Js] and won (320)
Seat 8: Quintin_Tomatoes mucked [3d 4d]
Seat 9: Rima_Olive mucked [2c 2d]



PokerStars Hand #3661268213: Tournament #21391319, $20+$2 - Hold'em No Limit (40/80) - 2018/04/06 22:17:50
Table '#18' Seat #5 is the button
Seat 1: Cecil_Grapes (8,942 in chips)
Seat 2: Pia_Tamarillo (9,890 in chips)
Seat 3: Hero (10,330 in chips)
Seat 4: Mitch_Thyme (9,910 in chips)
Seat 5: Long_Collard (9,880 in chips)
Seat 6: Denyse_Garlic (9,920 in chips)
Seat 7: Carlota_Parsley (7,702 in chips)
Seat 8: Aisha_Onions (15,725 in chips)
Seat 9: Lesia_Blueberry (12,600 in chips)
Denyse_Garlic: posts small blind 40
Carlota_Parsley: posts big blind 80
*** HOLE CARDS ***
Dealt to Hero [4h Qc]
Aisha_Onions: folds
Lesia_Blueberry: folds
Cecil_Grapes: calls 80 
Pia_Tamarillo: folds
Hero: folds
Mitch_Thyme: folds
Long_Collard: calls 80 
Denyse_Garlic: folds
Carlota_Parsley: checks
*** FLOP *** [Ah 6c 7c]
Carlota_Parsley: bets 359 
Cecil_Grapes: calls 359 
Long_Collard: folds
*** TURN *** [Ah 6c 7c] [Qh]
Carlota_Parsley: bets 486 
Cecil_Grapes: raises 1640 to 1640
Carlota_Parsley: folds
*** SHOW DOWN ***
Cecil_Grapes: shows [As 7h] (two pair, Aces and Sevens)
Uncalled bet (1154) returned to Cecil_Grapes
Cecil_Grapes collected 1970 from pot
*** SUMMARY ***
Total pot 1970 | Rake 0
Board [Ah 6c 7c Qh]
Seat 1: Cecil_Grapes showed [As 7h] and won (1970) with two pair, Aces and Sevens
Seat 2: Pia_Tamarillo mucked [6h 4d]
Seat 3: Hero mucked [4h Qc]
Seat 4: Mitch_Thyme mucked [3c 8h]
Seat 5: Long_Collard (button) mucked [Td Kd]
Seat 6: Denyse_Garlic (small blind) mucked [3s 8s]
Seat 7: Carlota_Parsley (big blind) mucked [2d Ac]
Seat 8: Aisha_Onions mucked [Ad 2c]
Seat 9: Lesia_Blueberry mucked [7s 4c]



PokerStars Hand #3661268828: Tournament #21391319, $20+$2 - Hold'em No Limit (40/80) - 2018/04/06 22:18:47
Table '#18' Seat #6 is the button
Seat 1: Myriam_Satsuma (9,987 in chips)
Seat 2: Muoi_Marionberry (9,890 in chips)
Seat 3: Hero (10,330 in chips)
Seat 4: Yolando_Redcurrant (9,910 in chips)
Seat 5: Celinda_Soy (9,800 in chips)
Seat 6: Felicita_Daikon (9,880 in chips)
Seat 7: Wendi_Parsley (6,777 in chips)
Seat 8: Aurelio_Soursop (15,725 in chips)
Seat 9: Domonique_Papaya (12,600 in chips)
Wendi_Parsley: posts small blind 40
Aurelio_Soursop: posts big blind 80
*** HOLE CARDS ***
Dealt to Hero [5d 4c]
Domonique_Papaya: folds
Myriam_Satsuma: folds
Muoi_Marionberry: folds
Hero: folds
Yolando_Redcurrant: raises 280 to 280
Celinda_Soy: folds
Felicita_Daikon: folds
Wendi_Parsley: calls 240 
Aurelio_Soursop: raises 1040 to 1120
Yolando_Redcurrant: calls 840 
Wendi_Parsley: calls 840 
*** FLOP *** [As 2c Kh]
Wendi_Parsley: bets 80 
Aurelio_Soursop: calls 80 
Yolando_Redcurrant: calls 80 
*** TURN *** [As 2c Kh] [Jc]
Wendi_Parsley: bets 478 
Aurelio_Soursop: folds
Yolando_Redcurrant: calls 478 
*** RIVER *** [As 2c Kh Jc] [2d]
Wendi_Parsley: bets 1401 
Yolando_Redcurrant: folds
Uncalled bet (1401) returned to Wendi_Parsley
Wendi_Parsley: doesn't show hand
Wendi_Parsley collected 4556 from pot
*** SUMMARY ***
Total pot 4556 | Rake 0
Board [As 2c Kh Jc 2d]
Seat 1: Myriam_Satsuma mucked [4d 9d]
Seat 2: Muoi_Marionberry mucked [8c Th]
Seat 3: Hero mucked [5d 4c]
Seat 4: Yolando_Redcurrant mucked [Qc 9c]
Seat 5: Celinda_Soy mucked [Kc 8h]
Seat 6: Felicita_Daikon (button) mucked [5c 8s]
Seat 7: Wendi_Parsley (small blind) showed [Ks 6c] and won (4556)
Seat 8: Aurelio_Soursop (big blind) mucked [Ts Td]
Seat 9: Domonique_Papaya mucked [2s Js]



PokerStars Hand #3661269645: Tournament #21391319, $20+$2 - Hold'em No Limit (40/80) - 2018/04/06 22:19:59
Table '#18' Seat #7 is the button
Seat 1: Bret_Grapes (9,987 in chips)
Seat 2: Sparkle_Peas (9,890 in chips)
Seat 3: Hero (10,330 in chips)
Seat 4: Kerrie_Celeriac (8,232 in chips)
Seat 5: Benjamin_Jicama (9,800 in chips)
Seat 6: Leslee_Blueberry (9,880 in chips)
Seat 7: Jasmine_Mango (9,655 in chips)
Seat 8: Ozie_Raspberry (14,525 in chips)
Seat 9: Laurel_Olive (12,600 in chips)
Ozie_Raspberry: posts small blind 40
Laurel_Olive: posts big blind 80
*** HOLE CARDS ***
Dealt to Hero [9c 8c]
Bret_Grapes: calls 80 
Sparkle_Peas: folds
Hero: raises 320 to 320
Kerrie_Celeriac: folds
Benjamin_Jicama: folds
Leslee_Blueberry: folds
Jasmine_Mango: calls 320 
Ozie_Raspberry: folds
Laurel_Olive: folds
Bret_Grapes: calls 240 
*** FLOP *** [Ts 6s Jd]
Bret_Grapes: checks
Hero: checks
Jasmine_Mango: checks
*** TURN *** [Ts 6s Jd] [5h]
Bret_Grapes: checks
Hero: checks
Jasmine_Mango: checks
*** RIVER *** [Ts 6s Jd 5h] [Ks]
Bret_Grapes: checks
Hero: checks
Jasmine_Mango: checks
*** SHOW DOWN ***
Bret_Grapes: shows [2s Ac] (high card Ace)
Hero: Mucks [9c 8c] (High Card)
Jasmine_Mango: shows [9h Kh] (a pair of Kings)
Jasmine_Mango collected 1080 from pot
*** SUMMARY ***
Total pot 1080 | Rake 0
Board [Ts 6s Jd 5h Ks]
Seat 1: Bret_Grapes showed [2s Ac] and lost with high card Ace
Seat 2: Sparkle_Peas mucked [4s Jh]
Seat 3: Hero mucked [9c 8c]
Seat 4: Kerrie_Celeriac mucked [8d Tc]
Seat 5: Benjamin_Jicama mucked [5d 9d]
Seat 6: Leslee_Blueberry mucked [7s Th]
Seat 7: Jasmine_Mango (button) showed [9h Kh] and won (1080) with a pair of Kings
Seat 8: Ozie_Raspberry (small blind) mucked [5c 4d]
Seat 9: Laurel_Olive (big blind) mucked [7d Qd]



PokerStars Hand #3661271006: Tournament #21391319, $20+$2 - Hold'em No Limit (40/80) - 2018/04/06 22:22:02
Table '#18' Seat #8 is the button
Seat 1: Trenton_Peppers (9,667 in chips)
Seat 2: Rod_Soy (9,890 in chips)
Seat 3: Hero (10,010 in chips)
Seat 4: Fran_Spinach (8,232 in chips)
Seat 5: Morgan_Celeriac (9,800 in chips)
Seat 6: Sol_Figs (9,880 in chips)
Seat 7: Cheyenne_Pumpkins (10,415 in chips)
Seat 8: Dana_Jackfruit (14,485 in chips)
Seat 9: Thanh_Sweetcorn (12,520 in chips)
Thanh_Sweetcorn: posts small blind 40
Trenton_Peppers: posts big blind 80
*** HOLE CARDS ***
Dealt to Hero [As 2c]
Rod_Soy: folds
Hero: folds
Fran_Spinach: folds
Morgan_Celeriac: folds
Sol_Figs: folds
Cheyenne_Pumpkins: calls 80 
Dana_Jackfruit: folds
Thanh_Sweetcorn: folds
Trenton_Peppers: checks
*** FLOP *** [Js Th 6d]
Trenton_Peppers: checks
Cheyenne_Pumpkins: checks
*** TURN *** [Js Th 6d] [Ah]
Trenton_Peppers: checks
Cheyenne_Pumpkins: checks
*** RIVER *** [Js Th 6d Ah] [4c]
Trenton_Peppers: checks
Cheyenne_Pumpkins: checks
*** SHOW DOWN ***
Trenton_Peppers: shows [3d 8h] (high card Ace)
Cheyenne_Pumpkins: Mucks [7d 2s] (High Card)
Trenton_Peppers collected 200 from pot
*** SUMMARY ***
Total pot 200 | Rake 0
Board [Js Th 6d Ah 4c]
Seat 1: Trenton_Peppers (big blind) showed [3d 8h] and won (200) with high card Ace
Seat 2: Rod_Soy mucked [Jh Qd]
Seat 3: Hero mucked [As 2c]
Seat 4: Fran_Spinach mucked [Ts 3s]
Seat 5: Morgan_Celeriac mucked [7c 4s]
Seat 6: Sol_Figs mucked [Ad Qs]
Seat 7: Cheyenne_Pumpkins mucked [7d 2s]
Seat 8: Dana_Jackfruit (button) mucked [2d 3c]
Seat 9: Thanh_Sweetcorn (small blind) mucked [3h 9d]



PokerStars Hand #3661271715: Tournament #21391319, $20+$2 - Hold'em No Limit (40/80) - 2018/04/06 22:23:05
Table '#18' Seat #9 is the button
Seat 1: Noelia_Soursop (9,787 in chips)
Seat 2: Odilia_Melon (9,890 in chips)
Seat 3: Hero (10,010 in chips)
Seat 4: Lizabeth_Yams (8,232 in chips)
Seat 5: Curtis_Fennel (9,800 in chips)
Seat 6: Timothy_Pears (9,880 in chips)
Seat 7: Carman_Olive (10,335 in chips)
Seat 8: Junita_Carrots (14,485 in chips)
Seat 9: Angelika_Cucumber (12,480 in chips)
Noelia_Soursop: posts small blind 40
Odilia_Melon: posts big blind 80
*** HOLE CARDS ***
Dealt to Hero [Ts 8s]
Hero: raises 180 to 180
Lizabeth_Yams: calls 180 
Curtis_Fennel: calls 180 
Timothy_Pears: folds
Carman_Olive: folds
Junita_Carrots: calls 180 
Angelika_Cucumber: folds
Noelia_Soursop: folds
Odilia_Melon: calls 100 
*** FLOP *** [9h Qc 6s]
Odilia_Melon: checks
Hero: bets 500 
Lizabeth_Yams: raises 1000 to 1000
Curtis_Fennel: folds
Junita_Carrots: folds
Odilia_Melon: raises 2500 to 2500
Hero: folds
Lizabeth_Yams: raises 7052 to 8052 and is all-in
Odilia_Melon: calls 5552 
*** TURN *** [9h Qc 6s] [5h]
*** RIVER *** [9h Qc 6s 5h] [Kc]
*** SHOW DOWN ***
Odilia_Melon: shows [9d 6d] (two pair, Nines and Sixes)
Lizabeth_Yams: shows [Js Jc] (a pair of Jacks)
Odilia_Melon collected 17544 from pot
Lizabeth_Yams finished the tournament in 102nd place
*** SUMMARY ***
Total pot 17544 | Rake 0
Board [9h Qc 6s 5h Kc]
Seat 1: Noelia_Soursop (small blind) mucked [8d 3c]
Seat 2: Odilia_Melon (big blind) showed [9d 6d] and won (17544) with two pair, Nines and Sixes
Seat 3: Hero mucked [Ts 8s]
Seat 4: Lizabeth_Yams showed [Js Jc] and lost with a pair of Jacks
Seat 5: Curtis_Fennel mucked [Tc Ah]
Seat 6: Timothy_Pears mucked [4h Ks]
Seat 7: Carman_Olive mucked [3h 5c]
Seat 8: Junita_Carrots mucked [9s 8c]
Seat 9: Angelika_Cucumber (button) mucked [2c 5s]



PokerStars Hand #3661273462: Tournament #21391319, $20+$2 - Hold'em No Limit (50/100) - 2018/04/06 22:25:44
Table '#18' Seat #1 is the button
Seat 1: Anjanette_Onions (9,747 in chips)
Seat 2: Letty_Chives (19,202 in chips)
Seat 3: Hero (9,330 in chips)
Seat 4: Claudio_Asparagus (9,620 in chips)
Seat 5: Minna_Pomegranate (9,880 in chips)
Seat 6: Cory_Clementine (10,335 in chips)
Seat 7: Shanice_Tat Soi (14,305 in chips)
Seat 8: Marion_Leek (12,480 in chips)
Letty_Chives: posts small blind 50
Hero: posts big blind 100
*** HOLE CARDS ***
Dealt to Hero [3d 8c]
Claudio_Asparagus: folds
Minna_Pomegranate: folds
Cory_Clementine: folds
Shanice_Tat Soi: folds
Marion_Leek: folds
Anjanette_Onions: calls 100 
Letty_Chives: calls 50 
Hero: checks
*** FLOP *** [Ks Ah Qs]
Letty_Chives: bets 150 
Hero: folds
Anjanette_Onions: calls 150 
*** TURN *** [Ks Ah Qs] [4c]
Letty_Chives: checks
Anjanette_Onions: checks
*** RIVER *** [Ks Ah Qs 4c] [9d]
Letty_Chives: bets 150 
Anjanette_Onions: folds
Uncalled bet (150) returned to Letty_Chives
Letty_Chives: doesn't show hand
Letty_Chives collected 600 from pot
*** SUMMARY ***
Total pot 600 | Rake 0
Board [Ks Ah Qs 4c 9d]
Seat 1: Anjanette_Onions (button) mucked [Js 6s]
Seat 2: Letty_Chives (small blind) showed [Jh Ad] and won (600)
Seat 3: Hero (big blind) mucked [3d 8c]
Seat 4: Claudio_Asparagus mucked [Jc 3c]
Seat 5: Minna_Pomegranate mucked [Qd 6d]
Seat 6: Cory_Clementine mucked [Td 6h]
Seat 7: Shanice_Tat Soi mucked [8s 2c]
Seat 8: Marion_Leek mucked [9h 4h]



PokerStars Hand #3661274519: Tournament #21391319, $20+$2 - Hold'em No Limit (50/100) - 2018/04/06 22:27:17
Table '#18' Seat #2 is the button
Seat 1: Christa_Pineapple (9,497 in chips)
Seat 2: Jenniffer_Ginger (19,552 in chips)
Seat 3: Hero (9,230 in chips)
Seat 4: Winter_Apples (9,620 in chips)
Seat 5: Marquis_Carrots (9,880 in chips)
Seat 6: Sierra_Mango (10,335 in chips)
Seat 7: Sheryll_Soursop (14,305 in chips)
Seat 8: Adrian_Prunes (12,480 in chips)
Hero: posts small blind 50
Winter_Apples: posts big blind 100
*** HOLE CARDS ***
Dealt to Hero [Qs 7c]
Marquis_Carrots: folds
Sierra_Mango: raises 200 to 200
Sheryll_Soursop: folds
Adrian_Prunes: folds
Christa_Pineapple: calls 200 
Jenniffer_Ginger: folds
Hero: folds
Winter_Apples: calls 100 
*** FLOP *** [4s 5h Ks]
Winter_Apples: checks
Sierra_Mango: bets 797 
Christa_Pineapple: folds
Winter_Apples: calls 797 
*** TURN *** [4s 5h Ks] [7d]
Winter_Apples: checks
Sierra_Mango: bets 930 
Winter_Apples: calls 930 
*** RIVER *** [4s 5h Ks 7d] [Ah]
Winter_Apples: checks
Sierra_Mango: checks
*** SHOW DOWN ***
Winter_Apples: shows [2h Kh] (a pair of Kings)
Sierra_Mango: shows [Jh Kc] (a pair of Kings)
Sierra_Mango collected 4104 from pot
*** SUMMARY ***
Total pot 4104 | Rake 0
Board [4s 5h Ks 7d Ah]
Seat 1: Christa_Pineapple mucked [Qc Ts]
Seat 2: Jenniffer_Ginger (button) mucked [3c 9d]
Seat 3: Hero (small blind) mucked [Qs 7c]
Seat 4: Winter_Apples (big blind) showed [2h Kh] and lost with a pair of Kings
Seat 5: Marquis_Carrots mucked [9c 8c]
Seat 6: Sierra_Mango showed [Jh Kc] and won (4104) with a pair of Kings
Seat 7: Sheryll_Soursop mucked [5s 4d]
Seat 8: Adrian_Prunes mucked [2c 3d]



PokerStars Hand #3661275691: Tournament #21391319, $20+$2 - Hold'em No Limit (50/100) - 2018/04/06 22:29:02
Table '#18' Seat #3 is the button
Seat 1: Sydney_Turnips (9,297 in chips)
Seat 2: Geraldo_Strawberry (19,552 in chips)
Seat 3: Hero (9,180 in chips)
Seat 4: Annetta_Oregano (7,693 in chips)
Seat 5: Malia_Cabbage (9,880 in chips)
Seat 6: Howard_Tat Soi (12,512 in chips)
Seat 7: Ilona_Cucumber (14,305 in chips)
Seat 8: Salena_Pinto (12,480 in chips)
Annetta_Oregano: posts small blind 50
Malia_Cabbage: posts big blind 100
*** HOLE CARDS ***
Dealt to Hero [8s 5d]
Howard_Tat Soi: calls 100 
Ilona_Cucumber: raises 400 to 400
Salena_Pinto: folds
Sydney_Turnips: calls 400 
Geraldo_Strawberry: folds
Hero: folds
Annetta_Oregano: folds
Malia_Cabbage: folds
Howard_Tat Soi: calls 300 
*** FLOP *** [9s 2s 6s]
Howard_Tat Soi: bets 538 
Ilona_Cucumber: folds
Sydney_Turnips: calls 538 
*** TURN *** [9s 2s 6s] [7d]
Howard_Tat Soi: bets 1143 
Sydney_Turnips: calls 1143 
*** RIVER *** [9s 2s 6s 7d] [3h]
Howard_Tat Soi: bets 1554 
Sydney_Turnips: calls 1554 
*** SHOW DOWN ***
Howard_Tat Soi: shows [4h 9h] (a pair of Nines)
Sydney_Turnips: shows [Kc 9c] (a pair of Nines)
Sydney_Turnips collected 7820 from pot
*** SUMMARY ***
Total pot 7820 | Rake 0
Board [9s 2s 6s 7d 3h]
Seat 1: Sydney_Turnips showed [Kc 9c] and won (7820) with a pair of Nines
Seat 2: Geraldo_Strawberry mucked [Qs Th]
Seat 3: Hero (button) mucked [8s 5d]
Seat 4: Annetta_Oregano (small blind) mucked [5h 2d]
Seat 5: Malia_Cabbage (big blind) mucked [Qc Jc]
Seat 6: Howard_Tat Soi showed [4h 9h] and lost with a pair of Nines
Seat 7: Ilona_Cucumber mucked [Kd Jh]
Seat 8: Salena_Pinto mucked [Ks 8c]



PokerStars Hand #3661276545: Tournament #21391319, $20+$2 - Hold'em No Limit (50/100) - 2018/04/06 22:30:20
Table '#18' Seat #4 is the button
Seat 1: Nicolas_Melon (13,482 in chips)
Seat 2: Jeni_Basil (19,552 in chips)
Seat 3: Hero (9,180 in chips)
Seat 4: Doria_Turnips (7,643 in chips)
Seat 5: Marcelino_Basil (9,780 in chips)
Seat 6: Julianne_Nectarine (8,877 in chips)
Seat 7: Ariane_Bok Choy (13,905 in chips)
Seat 8: Annabell_Pomelo (12,480 in chips)
Marcelino_Basil: posts small blind 50
Julianne_Nectarine: posts big blind 100
*** HOLE CARDS ***
Dealt to Hero [7s 4s]
Ariane_Bok Choy: folds
Annabell_Pomelo: folds
Nicolas_Melon: folds
Jeni_Basil: raises 300 to 300
Hero: folds
Doria_Turnips: calls 300 
Marcelino_Basil: folds
Julianne_Nectarine: folds
*** FLOP *** [Jc Td 7h]
Jeni_Basil: bets 300 
Doria_Turnips: calls 300 
*** TURN *** [Jc Td 7h] [As]
Jeni_Basil: checks
Doria_Turnips: checks
*** RIVER *** [Jc Td 7h As] [Jh]
Jeni_Basil: bets 420 
Doria_Turnips: calls 420 
*** SHOW DOWN ***
Jeni_Basil: shows [Kc Qs] (a straight, Ten to Ace)
Doria_Turnips: Mucks [Tc Kh] (Two pair)
Jeni_Basil collected 2190 from pot
*** SUMMARY ***
Total pot 2190 | Rake 0
Board [Jc Td 7h As Jh]
Seat 1: Nicolas_Melon mucked [3s 9s]
Seat 2: Jeni_Basil showed [Kc Qs] and won (2190) with a straight, Ten to Ace
Seat 3: Hero mucked [7s 4s]
Seat 4: Doria_Turnips (button) mucked [Tc Kh]
Seat 5: Marcelino_Basil (small blind) mucked [Qc 4d]
Seat 6: Julianne_Nectarine (big blind) mucked [9c 5h]
Seat 7: Ariane_Bok Choy mucked [Th Jd]
Seat 8: Annabell_Pomelo mucked [5c 8d]



PokerStars Hand #3661277240: Tournament #21391319, $20+$2 - Hold'em No Limit (50/100) - 2018/04/06 22:31:23
Table '#18' Seat #5 is the button
Seat 1: Jan_Radicchio (13,482 in chips)
Seat 2: Tiny_Chard (20,722 in chips)
Seat 3: Hero (9,180 in chips)
Seat 4: Carlo_Jicama (6,623 in chips)
Seat 5: Yolanda_Rhubarb (9,730 in chips)
Seat 6: Taina_Persimmon (8,777 in chips)
Seat 7: Evelin_Chives (13,905 in chips)
Seat 8: Karly_Lychee (12,480 in chips)
Taina_Persimmon: posts small blind 50
Evelin_Chives: posts big blind 100
*** HOLE CARDS ***
Dealt to Hero [8c Ks]
Karly_Lychee: folds
Jan_Radicchio: folds
Tiny_Chard: folds
Hero: folds
Carlo_Jicama: folds
Yolanda_Rhubarb: folds
Taina_Persimmon: folds
Evelin_Chives: doesn't show hand
Uncalled bet (100) returned to Evelin_Chives
Evelin_Chives collected 50 from pot
*** SUMMARY ***
Total pot 50 | Rake 0
Seat 1: Jan_Radicchio mucked [Ah Kh]
Seat 2: Tiny_Chard mucked [4s Qd]
Seat 3: Hero mucked [8c Ks]
Seat 4: Carlo_Jicama mucked [6s 4h]
Seat 5: Yolanda_Rhubarb (button) mucked [Qs 5c]
Seat 6: Taina_Persimmon (small blind) mucked [2c 7d]
Seat 7: Evelin_Chives (big blind) showed [Jc Qh] and won (50)
Seat 8: Karly_Lychee mucked [Kc 2h]



PokerStars Hand #3661277747: Tournament #21391319, $20+$2 - Hold'em No Limit (50/100) - 2018/04/06 22:32:11
Table '#18' Seat #6 is the button
Seat 1: Juanita_Butternut (13,482 in chips)
Seat 2: Carole_Ugli (20,722 in chips)
Seat 3: Hero (9,180 in chips)
Seat 4: Timmy_Cauliflower (6,623 in chips)
Seat 5: Billye_Eggplants (9,730 in chips)
Seat 6: Muoi_Spinach (8,727 in chips)
Seat 7: Audie_Oregano (13,955 in chips)
Seat 8: Larue_Strawberry (12,480 in chips)
Audie_Oregano: posts small blind 50
Larue_Strawberry: posts big blind 100
*** HOLE CARDS ***
Dealt to Hero [As Jh]
Juanita_Butternut: folds
Carole_Ugli: folds
Hero: raises 300 to 300
Timmy_Cauliflower: folds
Billye_Eggplants: folds
Muoi_Spinach: folds
Audie_Oregano: calls 250 
Larue_Strawberry: folds
*** FLOP *** [5h 5d 7c]
Audie_Oregano: checks
Hero: checks
*** TURN *** [5h 5d 7c] [6c]
Audie_Oregano: bets 300 
Hero: calls 300 
*** RIVER *** [5h 5d 7c 6c] [4h]
Audie_Oregano: bets 1000 
Hero: folds
Uncalled bet (1000) returned to Audie_Oregano
Audie_Oregano: doesn't show hand
Audie_Oregano collected 1300 from pot
*** SUMMARY ***
Total pot 1300 | Rake 0
Board [5h 5d 7c 6c 4h]
Seat 1: Juanita_Butternut mucked [9h Kc]
Seat 2: Carole_Ugli mucked [3h 7s]
Seat 3: Hero mucked [As Jh]
Seat 4: Timmy_Cauliflower mucked [4c 6s]
Seat 5: Billye_Eggplants mucked [9d 4s]
Seat 6: Muoi_Spinach (button) mucked [Qs 2d]
Seat 7: Audie_Oregano (small blind) showed [Ts Ad] and won (1300)
Seat 8: Larue_Strawberry (big blind) mucked [Ks Th]



PokerStars Hand #3661278554: Tournament #21391319, $20+$2 - Hold'em No Limit (50/100) - 2018/04/06 22:33:26
Table '#18' Seat #7 is the button
Seat 1: Katie_Arugula (13,482 in chips)
Seat 2: Doreatha_Yams (20,722 in chips)
Seat 3: Hero (8,580 in chips)
Seat 4: Gary_Topinambur (6,623 in chips)
Seat 5: Gene_Nettles (9,730 in chips)
Seat 6: Annie_Dates (8,727 in chips)
Seat 7: Daniel_Radish (14,655 in chips)
Seat 8: Liberty_Kohlrabi (12,380 in chips)
Liberty_Kohlrabi: posts small blind 50
Katie_Arugula: posts big blind 100
*** HOLE CARDS ***
Dealt to Hero [9d 4s]
Doreatha_Yams: folds
Hero: folds
Gary_Topinambur: folds
Gene_Nettles: folds
Annie_Dates: calls 100 
Daniel_Radish: calls 100 
Liberty_Kohlrabi: folds
Katie_Arugula: folds
*** FLOP *** [9h 5d 9c]
Annie_Dates: bets 100 
Daniel_Radish: calls 100 
*** TURN *** [9h 5d 9c] [6h]
Annie_Dates: bets 100 
Daniel_Radish: raises 500 to 500
Annie_Dates: folds
Uncalled bet (400) returned to Daniel_Radish
Daniel_Radish: doesn't show hand
Daniel_Radish collected 750 from pot
*** SUMMARY ***
Total pot 750 | Rake 0
Board [9h 5d 9c 6h]
Seat 1: Katie_Arugula (big blind) mucked [Ad Qs]
Seat 2: Doreatha_Yams mucked [7c As]
Seat 3: Hero mucked [9d 4s]
Seat 4: Gary_Topinambur mucked [Ah 2d]
Seat 5: Gene_Nettles mucked [Js Jh]
Seat 6: Annie_Dates mucked [8d Jc]
Seat 7: Daniel_Radish (button) showed [8c 9s] and won (750)
Seat 8: Liberty_Kohlrabi (small blind) mucked [3d Jd]



PokerStars Hand #3661279293: Tournament #21391319, $20+$2 - Hold'em No Limit (50/100) - 2018/04/06 22:34:32
Table '#18' Seat #9 is the button
Seat 1: Allene_Topinambur (13,382 in chips)
Seat 2: Roxann_Cauliflower (20,722 in chips)
Seat 3: Hero (8,580 in chips)
Seat 4: Hortense_Boysenberry (10,000 in chips)
Seat 5: Yuko_Soy (6,623 in chips)
Seat 6: Mariel_Grapes (9,730 in chips)
Seat 7: Bao_Raisins (8,427 in chips)
Seat 8: Floretta_Paprika (15,105 in chips)
Seat 9: Pilar_Figs (12,330 in chips)
Allene_Topinambur: posts small blind 50
Roxann_Cauliflower: posts big blind 100
*** HOLE CARDS ***
Dealt to Hero [6c Ah]
Hero: folds
Hortense_Boysenberry: folds
Yuko_Soy: raises 300 to 300
Mariel_Grapes: folds
Bao_Raisins: calls 300 
Floretta_Paprika: folds
Pilar_Figs: folds
Allene_Topinambur: folds
Roxann_Cauliflower: folds
*** FLOP *** [As Kh Jc]
Yuko_Soy: bets 200 
Bao_Raisins: folds
Uncalled bet (200) returned to Yuko_Soy
Yuko_Soy: doesn't show hand
Yuko_Soy collected 750 from pot
*** SUMMARY ***
Total pot 750 | Rake 0
Board [As Kh Jc]
Seat 1: Allene_Topinambur (small blind) mucked [3h 9s]
Seat 2: Roxann_Cauliflower (big blind) mucked [3s Js]
Seat 3: Hero mucked [6c Ah]
Seat 4: Hortense_Boysenberry mucked [5s Td]
Seat 5: Yuko_Soy showed [Ad Ks] and won (750)
Seat 6: Mariel_Grapes mucked [8d 6s]
Seat 7: Bao_Raisins mucked [5c 4s]
Seat 8: Floretta_Paprika mucked [2s Ac]
Seat 9: Pilar_Figs (button) mucked [8s 9d]



PokerStars Hand #3661280038: Tournament #21391319, $20+$2 - Hold'em No Limit (75/150) - 2018/04/06 22:35:35
Table '#18' Seat #1 is the button
Seat 1: Lacie_Nettles (13,332 in chips)
Seat 2: Salvador_Spinach (20,622 in chips)
Seat 3: Hero (8,580 in chips)
Seat 4: Carlotta_Quince (10,000 in chips)
Seat 5: Sol_Eggplants (7,073 in chips)
Seat 6: Phung_Mango (9,730 in chips)
Seat 7: Sylvie_Pineapple (8,127 in chips)
Seat 8: Danial_Horseradish (15,105 in chips)
Seat 9: Sommer_Cilantro (12,330 in chips)
Salvador_Spinach: posts small blind 75
Hero: posts big blind 150
*** HOLE CARDS ***
Dealt to Hero [Qs 7d]
Carlotta_Quince: folds
Sol_Eggplants: raises 450 to 450
Phung_Mango: folds
Sylvie_Pineapple: folds
Danial_Horseradish: folds
Sommer_Cilantro: folds
Lacie_Nettles: folds
Salvador_Spinach: folds
Hero: folds
Uncalled bet (300) returned to Sol_Eggplants
Sol_Eggplants: doesn't show hand
Sol_Eggplants collected 375 from pot
*** SUMMARY ***
Total pot 375 | Rake 0
Seat 1: Lacie_Nettles (button) mucked [5c 8h]
Seat 2: Salvador_Spinach (small blind) mucked [4c 9s]
Seat 3: Hero (big blind) mucked [Qs 7d]
Seat 4: Carlotta_Quince mucked [Qd 2s]
Seat 5: Sol_Eggplants showed [Ac 9h] and won (375)
Seat 6: Phung_Mango mucked [Jd 8s]
Seat 7: Sylvie_Pineapple mucked [4s Kh]
Seat 8: Danial_Horseradish mucked [Ks 3s]
Seat 9: Sommer_Cilantro mucked [3d 4d]



PokerStars Hand #3661280543: Tournament #21391319, $20+$2 - Hold'em No Limit (75/150) - 2018/04/06 22:36:20
Table '#18' Seat #2 is the button
Seat 1: Hortense_Rutabaga (13,332 in chips)
Seat 2: Tracy_Blueberry (20,547 in chips)
Seat 3: Hero (8,430 in chips)
Seat 4: Elizabet_Bananas (10,000 in chips)
Seat 5: Le_Onions (7,298 in chips)
Seat 6: Minna_Lavender (9,730 in chips)
Seat 7: Jill_Strawberry (15,105 in chips)
Seat 8: Carolyne_Papaya (12,330 in chips)
Hero: posts small blind 75
Elizabet_Bananas: posts big blind 150
*** HOLE CARDS ***
Dealt to Hero [Td 8d]
Le_Onions: calls 150 
Minna_Lavender: folds
Jill_Strawberry: folds
Carolyne_Papaya: folds
Hortense_Rutabaga: folds
Tracy_Blueberry: folds
Hero: calls 75 
Elizabet_Bananas: checks
*** FLOP *** [9h 5h Js]
Hero: bets 300 
Elizabet_Bananas: calls 300 
Le_Onions: calls 300 
*** TURN *** [9h 5h Js] [Ac]
Hero: bets 1000 
Elizabet_Bananas: calls 1000 
Le_Onions: folds
*** RIVER *** [9h 5h Js Ac] [2d]
Hero: bets 3000 
Elizabet_Bananas: folds
Uncalled bet (3000) returned to Hero
Hero: doesn't show hand
Hero collected 3350 from pot
*** SUMMARY ***
Total pot 3350 | Rake 0
Board [9h 5h Js Ac 2d]
Seat 1: Hortense_Rutabaga mucked [5c 2h]
Seat 2: Tracy_Blueberry (button) mucked [2c Qs]
Seat 3: Hero (small blind) showed [Td 8d] and won (3350)
Seat 4: Elizabet_Bananas (big blind) mucked [Ts Qd]
Seat 5: Le_Onions mucked [Kc Jh]
Seat 6: Minna_Lavender mucked [7d 6d]
Seat 7: Jill_Strawberry mucked [6s Jd]
Seat 8: Carolyne_Papaya mucked [4h 3d]



PokerStars Hand #3661281886: Tournament #21391319, $20+$2 - Hold'em No Limit (75/150) - 2018/04/06 22:38:20
Table '#18' Seat #3 is the button
Seat 1: Carmelita_Elderberry (13,332 in chips)
Seat 2: Rochell_Cayenne (20,547 in chips)
Seat 3: Hero (10,330 in chips)
Seat 4: Cierra_Rosemary (8,550 in chips)
Seat 5: Bertha_Fennel (6,848 in chips)
Seat 6: Weston_Soursop (9,730 in chips)
Seat 7: Victor_Pomegranate (15,105 in chips)
Seat 8: Alisa_Mulberry (12,330 in chips)
Cierra_Rosemary: posts small blind 75
Bertha_Fennel: posts big blind 150
*** HOLE CARDS ***
Dealt to Hero [9h 5s]
Weston_Soursop: folds
Victor_Pomegranate: folds
Alisa_Mulberry: folds
Carmelita_Elderberry: folds
Rochell_Cayenne: raises 350 to 350
Hero: folds
Cierra_Rosemary: calls 275 
Bertha_Fennel: folds
*** FLOP *** [8d 2c 5h]
Cierra_Rosemary: checks
Rochell_Cayenne: checks
*** TURN *** [8d 2c 5h] [6s]
Cierra_Rosemary: bets 425 
Rochell_Cayenne: folds
Uncalled bet (425) returned to Cierra_Rosemary
Cierra_Rosemary: doesn't show hand
Cierra_Rosemary collected 850 from pot
*** SUMMARY ***
Total pot 850 | Rake 0
Board [8d 2c 5h 6s]
Seat 1: Carmelita_Elderberry mucked [Td 8c]
Seat 2: Rochell_Cayenne mucked [Jc Qd]
Seat 3: Hero (button) mucked [9h 5s]
Seat 4: Cierra_Rosemary (small blind) showed [5c Ac] and won (850)
Seat 5: Bertha_Fennel (big blind) mucked [Tc 3d]
Seat 6: Weston_Soursop mucked [2h 4s]
Seat 7: Victor_Pomegranate mucked [Jd 2d]
Seat 8: Alisa_Mulberry mucked [3c Jh]



PokerStars Hand #3661282910: Tournament #21391319, $20+$2 - Hold'em No Limit (75/150) - 2018/04/06 22:39:50
Table '#18' Seat #4 is the button
Seat 1: Rosendo_Cayenne (13,332 in chips)
Seat 2: Zane_Plum (20,197 in chips)
Seat 3: Hero (10,330 in chips)
Seat 4: Shalanda_Chard (9,050 in chips)
Seat 5: Concetta_Grapes (6,698 in chips)
Seat 6: Ivan_Peppers (9,730 in chips)
Seat 7: Evan_Marjoram (15,105 in chips)
Seat 8: Sharlene_Rhubarb (12,330 in chips)
Concetta_Grapes: posts small blind 75
Ivan_Peppers: posts big blind 150
*** HOLE CARDS ***
Dealt to Hero [Ah Kd]
Evan_Marjoram: folds
Sharlene_Rhubarb: folds
Rosendo_Cayenne: folds
Zane_Plum: folds
Hero: raises 400 to 400
Shalanda_Chard: folds
Concetta_Grapes: folds
Ivan_Peppers: folds
Uncalled bet (250) returned to Hero
Hero: doesn't show hand
Hero collected 375 from pot
*** SUMMARY ***
Total pot 375 | Rake 0
Seat 1: Rosendo_Cayenne mucked [5s 6h]
Seat 2: Zane_Plum mucked [Qs 3d]
Seat 3: Hero showed [Ah Kd] and won (375)
Seat 4: Shalanda_Chard (button) mucked [Qd 6c]
Seat 5: Concetta_Grapes (small blind) mucked [As 7d]
Seat 6: Ivan_Peppers (big blind) mucked [Jd 8c]
Seat 7: Evan_Marjoram mucked [Jh 9d]
Seat 8: Sharlene_Rhubarb mucked [6d 9c]



PokerStars Hand #3661283352: Tournament #21391319, $20+$2 - Hold'em No Limit (75/150) - 2018/04/06 22:40:29
Table '#18' Seat #5 is the button
Seat 1: Celesta_Plum (13,332 in chips)
Seat 2: Aimee_Tangerine (20,197 in chips)
Seat 3: Hero (10,555 in chips)
Seat 4: Tia_Cabbage (9,050 in chips)
Seat 5: Mandy_Shallot (6,623 in chips)
Seat 6: Patrina_Lentils (9,580 in chips)
Seat 7: Reed_Chives (10,000 in chips)
Seat 8: Leeanna_Blackberry (15,105 in chips)
Seat 9: Willa_Figs (12,330 in chips)
Patrina_Lentils: posts small blind 75
Reed_Chives: posts big blind 150
*** HOLE CARDS ***
Dealt to Hero [Qc 5c]
Leeanna_Blackberry: folds
Willa_Figs: folds
Celesta_Plum: folds
Aimee_Tangerine: folds
Hero: folds
Tia_Cabbage: folds
Mandy_Shallot: raises 450 to 450
Patrina_Lentils: folds
Reed_Chives: folds
Uncalled bet (300) returned to Mandy_Shallot
Mandy_Shallot: doesn't show hand
Mandy_Shallot collected 375 from pot
*** SUMMARY ***
Total pot 375 | Rake 0
Seat 1: Celesta_Plum mucked [Td Kh]
Seat 2: Aimee_Tangerine mucked [Ad 5s]
Seat 3: Hero mucked [Qc 5c]
Seat 4: Tia_Cabbage mucked [Tc 8d]
Seat 5: Mandy_Shallot (button) showed [7d 7c] and won (375)
Seat 6: Patrina_Lentils (small blind) mucked [8s 3h]
Seat 7: Reed_Chives (big blind) mucked [4h 6d]
Seat 8: Leeanna_Blackberry mucked [4s Jc]
Seat 9: Willa_Figs mucked [2h Kc]



PokerStars Hand #3661283849: Tournament #21391319, $20+$2 - Hold'em No Limit (75/150) - 2018/04/06 22:41:14
Table '#18' Seat #6 is the button
Seat 1: Newton_Butternut (13,332 in chips)
Seat 2: Alberto_Basil (20,197 in chips)
Seat 3: Hero (10,555 in chips)
Seat 4: Anita_Shallot (9,050 in chips)
Seat 5: Qiana_Watermelon (6,848 in chips)
Seat 6: Brandon_Plantain (9,505 in chips)
Seat 7: Ned_Marionberry (9,850 in chips)
Seat 8: Lawana_Prunes (15,105 in chips)
Seat 9: Kortney_Potatos (12,330 in chips)
Ned_Marionberry: posts small blind 75
Lawana_Prunes: posts big blind 150
*** HOLE CARDS ***
Dealt to Hero [3c 5h]
Kortney_Potatos: folds
Newton_Butternut: folds
Alberto_Basil: raises 350 to 350
Hero: folds
Anita_Shallot: folds
Qiana_Watermelon: folds
Brandon_Plantain: folds
Ned_Marionberry: folds
Lawana_Prunes: calls 200 
*** FLOP *** [8d 6h Qc]
Lawana_Prunes: checks
Alberto_Basil: bets 325 
Lawana_Prunes: calls 325 
*** TURN *** [8d 6h Qc] [Qs]
Lawana_Prunes: checks
Alberto_Basil: bets 600 
Lawana_Prunes: folds
Uncalled bet (600) returned to Alberto_Basil
Alberto_Basil: doesn't show hand
Alberto_Basil collected 1425 from pot
*** SUMMARY ***
Total pot 1425 | Rake 0
Board [8d 6h Qc Qs]
Seat 1: Newton_Butternut mucked [Kc 7h]
Seat 2: Alberto_Basil showed [Kh Qd] and won (1425)
Seat 3: Hero mucked [3c 5h]
Seat 4: Anita_Shallot mucked [Jh 4d]
Seat 5: Qiana_Watermelon mucked [9c Js]
Seat 6: Brandon_Plantain (button) mucked [3d 6c]
Seat 7: Ned_Marionberry (small blind) mucked [3s 4h]
Seat 8: Lawana_Prunes (big blind) mucked [7c 9h]
Seat 9: Kortney_Potatos mucked [2d 8c]



PokerStars Hand #3661284499: Tournament #21391319, $20+$2 - Hold'em No Limit (75/150) - 2018/04/06 22:42:11
Table '#18' Seat #7 is the button
Seat 1: Man_Cabbage (13,332 in chips)
Seat 2: Alfredo_Figs (20,947 in chips)
Seat 3: Hero (10,555 in chips)
Seat 4: Claudio_Sage (9,050 in chips)
Seat 5: Karma_Persimmon (6,848 in chips)
Seat 6: Tanja_Lentils (9,505 in chips)
Seat 7: Leroy_Plantain (9,775 in chips)
Seat 8: Marquerite_Lime (14,430 in chips)
Seat 9: Ali_Lettuce (12,330 in chips)
Marquerite_Lime: posts small blind 75
Ali_Lettuce: posts big blind 150
*** HOLE CARDS ***
Dealt to Hero [2d Ah]
Man_Cabbage: folds
Alfredo_Figs: folds
Hero: folds
Claudio_Sage: folds
Karma_Persimmon: folds
Tanja_Lentils: folds
Leroy_Plantain: folds
Marquerite_Lime: raises 375 to 450
Ali_Lettuce: folds
Uncalled bet (300) returned to Marquerite_Lime
Marquerite_Lime: doesn't show hand
Marquerite_Lime collected 300 from pot
*** SUMMARY ***
Total pot 300 | Rake 0
Seat 1: Man_Cabbage mucked [2c Jh]
Seat 2: Alfredo_Figs mucked [8c Js]
Seat 3: Hero mucked [2d Ah]
Seat 4: Claudio_Sage mucked [7d Ts]
Seat 5: Karma_Persimmon mucked [4s 8h]
Seat 6: Tanja_Lentils mucked [9d 5s]
Seat 7: Leroy_Plantain (button) mucked [3h 9s]
Seat 8: Marquerite_Lime (small blind) showed [Kd 6d] and won (300)
Seat 9: Ali_Lettuce (big blind) mucked [3s Ac]



PokerStars Hand #3661284950: Tournament #21391319, $20+$2 - Hold'em No Limit (75/150) - 2018/04/06 22:42:53
Table '#18' Seat #8 is the button
Seat 1: Santa_Paprika (13,332 in chips)
Seat 2: Hong_Rhubarb (20,947 in chips)
Seat 3: Hero (10,555 in chips)
Seat 4: Kathleen_Juniper (9,050 in chips)
Seat 5: Devora_Garlic (6,848 in chips)
Seat 6: Marna_Basil (9,505 in chips)
Seat 7: Claudie_Eggplants (9,775 in chips)
Seat 8: Annmarie_Topinambur (14,580 in chips)
Seat 9: Harris_Boysenberry (12,180 in chips)
Harris_Boysenberry: posts small blind 75
Santa_Paprika: posts big blind 150
*** HOLE CARDS ***
Dealt to Hero [7s 5d]
Hong_Rhubarb: folds
Hero: folds
Kathleen_Juniper: folds
Devora_Garlic: folds
Marna_Basil: raises 300 to 300
Claudie_Eggplants: folds
Annmarie_Topinambur: folds
Harris_Boysenberry: folds
Santa_Paprika: folds
Uncalled bet (150) returned to Marna_Basil
Marna_Basil: doesn't show hand
Marna_Basil collected 375 from pot
*** SUMMARY ***
Total pot 375 | Rake 0
Seat 1: Santa_Paprika (big blind) mucked [5h 2c]
Seat 2: Hong_Rhubarb mucked [9s Ah]
Seat 3: Hero mucked [7s 5d]
Seat 4: Kathleen_Juniper mucked [Td 7h]
Seat 5: Devora_Garlic mucked [4h 2h]
Seat 6: Marna_Basil showed [Ad 7d] and won (375)
Seat 7: Claudie_Eggplants mucked [9h 4c]
Seat 8: Annmarie_Topinambur (button) mucked [2d Qc]
Seat 9: Harris_Boysenberry (small blind) mucked [9c Tc]



PokerStars Hand #3661285701: Tournament #21391319, $20+$2 - Hold'em No Limit (75/150) - 2018/04/06 22:43:59
Table '#18' Seat #8 is the button
Seat 1: Elijah_Dates (13,182 in chips)
Seat 2: Johnna_Paprika (20,947 in chips)
Seat 3: Hero (10,555 in chips)
Seat 4: Rachael_Orange (9,050 in chips)
Seat 5: Dominica_Redcurrant (6,848 in chips)
Seat 6: Lorraine_Yuzu (9,730 in chips)
Seat 7: Brenna_Bilberry (14,580 in chips)
Seat 8: Shaunna_Peppers (12,105 in chips)
Elijah_Dates: posts small blind 75
Johnna_Paprika: posts big blind 150
*** HOLE CARDS ***
Dealt to Hero [3c 7d]
Hero: folds
Rachael_Orange: folds
Dominica_Redcurrant: folds
Lorraine_Yuzu: folds
Brenna_Bilberry: raises 450 to 450
Shaunna_Peppers: folds
Elijah_Dates: calls 375 
Johnna_Paprika: calls 300 
*** FLOP *** [2s 2d 5c]
Elijah_Dates: checks
Johnna_Paprika: bets 350 
Brenna_Bilberry: folds
Elijah_Dates: calls 350 
*** TURN *** [2s 2d 5c] [5s]
Elijah_Dates: bets 500 
Johnna_Paprika: calls 500 
*** RIVER *** [2s 2d 5c 5s] [8s]
Elijah_Dates: bets 500 
Johnna_Paprika: raises 1750 to 1750
Elijah_Dates: folds
Uncalled bet (1250) returned to Johnna_Paprika
Johnna_Paprika: doesn't show hand
Johnna_Paprika collected 4050 from pot
*** SUMMARY ***
Total pot 4050 | Rake 0
Board [2s 2d 5c 5s 8s]
Seat 1: Elijah_Dates (small blind) mucked [Ad Qh]
Seat 2: Johnna_Paprika (big blind) showed [Qs Td] and won (4050)
Seat 3: Hero mucked [3c 7d]
Seat 4: Rachael_Orange mucked [4c 5h]
Seat 5: Dominica_Redcurrant mucked [7h Qd]
Seat 6: Lorraine_Yuzu mucked [7c 6c]
Seat 7: Brenna_Bilberry mucked [4s 7s]
Seat 8: Shaunna_Peppers (button) mucked [Jh As]



PokerStars Hand #3661290922: Tournament #21391319, $20+$2 - Hold'em No Limit (100/200) - 2018/04/06 22:51:32
Table '#18' Seat #1 is the button
Seat 1: Priscila_Cayenne (11,382 in chips)
Seat 2: Tad_Passionfruit (23,197 in chips)
Seat 3: Hero (10,555 in chips)
Seat 4: Caryl_Sprouts (9,050 in chips)
Seat 5: Peter_Tubers (6,848 in chips)
Seat 6: Paris_Peach (9,730 in chips)
Seat 7: Cori_Marjoram (10,000 in chips)
Seat 8: Marylyn_Chili (14,130 in chips)
Seat 9: Freddie_Raspberry (12,105 in chips)
Tad_Passionfruit: posts small blind 100
Hero: posts big blind 200
*** HOLE CARDS ***
Dealt to Hero [3d 4h]
Caryl_Sprouts: raises 600 to 600
Peter_Tubers: folds
Paris_Peach: folds
Cori_Marjoram: calls 600 
Marylyn_Chili: folds
Freddie_Raspberry: folds
Priscila_Cayenne: calls 600 
Tad_Passionfruit: folds
Hero: folds
*** FLOP *** [8c 8h Ac]
Caryl_Sprouts: bets 1050 
Cori_Marjoram: calls 1050 
Priscila_Cayenne: folds
*** TURN *** [8c 8h Ac] [As]
Caryl_Sprouts: checks
Cori_Marjoram: checks
*** RIVER *** [8c 8h Ac As] [3h]
Caryl_Sprouts: bets 3400 
Cori_Marjoram: raises 8350 to 8350 and is all-in
Caryl_Sprouts: folds
Uncalled bet (4950) returned to Cori_Marjoram
Cori_Marjoram: doesn't show hand
Cori_Marjoram collected 11000 from pot
*** SUMMARY ***
Total pot 11000 | Rake 0
Board [8c 8h Ac As 3h]
Seat 1: Priscila_Cayenne (button) mucked [Td Kc]
Seat 2: Tad_Passionfruit (small blind) mucked [5d 6h]
Seat 3: Hero (big blind) mucked [3d 4h]
Seat 4: Caryl_Sprouts mucked [7d 7s]
Seat 5: Peter_Tubers mucked [9c 8d]
Seat 6: Paris_Peach mucked [2s 3c]
Seat 7: Cori_Marjoram showed [Ah Tc] and won (11000)
Seat 8: Marylyn_Chili mucked [6s Js]
Seat 9: Freddie_Raspberry mucked [Jc Ks]



PokerStars Hand #3661291903: Tournament #21391319, $20+$2 - Hold'em No Limit (100/200) - 2018/04/06 22:52:56
Table '#18' Seat #2 is the button
Seat 1: Delmar_Shallot (10,782 in chips)
Seat 2: Earlie_Plantain (23,097 in chips)
Seat 3: Hero (10,355 in chips)
Seat 4: Kasi_Juniper (4,000 in chips)
Seat 5: Wenona_Broccoli (6,848 in chips)
Seat 6: Robin_Daikon (9,730 in chips)
Seat 7: Kieth_Daikon (15,950 in chips)
Seat 8: Carrol_Huckleberry (14,130 in chips)
Seat 9: Bree_Parsley (12,105 in chips)
Hero: posts small blind 100
Kasi_Juniper: posts big blind 200
*** HOLE CARDS ***
Dealt to Hero [7d Ad]
Wenona_Broccoli: folds
Robin_Daikon: folds
Kieth_Daikon: folds
Carrol_Huckleberry: folds
Bree_Parsley: folds
Delmar_Shallot: calls 200 
Earlie_Plantain: folds
Hero: raises 700 to 800
Kasi_Juniper: calls 600 
Delmar_Shallot: calls 600 
*** FLOP *** [3c 6h 7c]
Hero: bets 1500 
Kasi_Juniper: raises 3200 to 3200 and is all-in
Delmar_Shallot: folds
Hero: calls 1700 
*** TURN *** [3c 6h 7c] [9c]
*** RIVER *** [3c 6h 7c 9c] [Js]
*** SHOW DOWN ***
Hero: shows [7d Ad] (a pair of Sevens)
Kasi_Juniper: shows [2d 3d] (a pair of Threes)
Hero collected 8800 from pot
Kasi_Juniper finished the tournament in 134th place
*** SUMMARY ***
Total pot 8800 | Rake 0
Board [3c 6h 7c 9c Js]
Seat 1: Delmar_Shallot mucked [8c Qc]
Seat 2: Earlie_Plantain (button) mucked [3s Ah]
Seat 3: Hero (small blind) showed [7d Ad] and won (8800) with a pair of Sevens
Seat 4: Kasi_Juniper (big blind) showed [2d 3d] and lost with a pair of Threes
Seat 5: Wenona_Broccoli mucked [7s 9s]
Seat 6: Robin_Daikon mucked [4c Ks]
Seat 7: Kieth_Daikon mucked [Jd 6c]
Seat 8: Carrol_Huckleberry mucked [2h As]
Seat 9: Bree_Parsley mucked [Kc 2c]



PokerStars Hand #3661292973: Tournament #21391319, $20+$2 - Hold'em No Limit (100/200) - 2018/04/06 22:54:38
Table '#18' Seat #3 is the button
Seat 1: Thea_Celeriac (9,982 in chips)
Seat 2: Magen_Cucumber (23,097 in chips)
Seat 3: Hero (15,155 in chips)
Seat 4: Jarred_Clementine (6,848 in chips)
Seat 5: Patty_Melon (9,730 in chips)
Seat 6: Adah_Lychee (15,950 in chips)
Seat 7: Perla_Collard (14,130 in chips)
Seat 8: Malorie_Raisins (12,105 in chips)
Jarred_Clementine: posts big blind 200
*** HOLE CARDS ***
Dealt to Hero [6d Ts]
Patty_Melon: folds
Adah_Lychee: folds
Perla_Collard: folds
Malorie_Raisins: raises 600 to 600
Thea_Celeriac: folds
Magen_Cucumber: folds
Hero: folds
Jarred_Clementine: calls 400 
*** FLOP *** [9h 8s Qc]
Jarred_Clementine: checks
Malorie_Raisins: bets 600 
Jarred_Clementine: folds
Uncalled bet (600) returned to Malorie_Raisins
Malorie_Raisins: doesn't show hand
Malorie_Raisins collected 1200 from pot
*** SUMMARY ***
Total pot 1200 | Rake 0
Board [9h 8s Qc]
Seat 1: Thea_Celeriac mucked [9d 2s]
Seat 2: Magen_Cucumber mucked [3c Ks]
Seat 3: Hero (button) mucked [6d Ts]
Seat 4: Jarred_Clementine (big blind) mucked [4d 4h]
Seat 5: Patty_Melon mucked [Qh 5s]
Seat 6: Adah_Lychee mucked [Tc 3d]
Seat 7: Perla_Collard mucked [4s Ah]
Seat 8: Malorie_Raisins showed [8h 8d] and won (1200)



PokerStars Hand #3661293586: Tournament #21391319, $20+$2 - Hold'em No Limit (100/200) - 2018/04/06 22:55:35
Table '#18' Seat #4 is the button
Seat 1: Rebbecca_Melon (9,982 in chips)
Seat 2: Danielle_Coconuts (23,097 in chips)
Seat 3: Hero (15,155 in chips)
Seat 4: Bradford_Grapefruit (10,000 in chips)
Seat 5: Ranae_Skirret (6,248 in chips)
Seat 6: Annamarie_Radish (9,730 in chips)
Seat 7: Deja_Fennel (15,950 in chips)
Seat 8: Lacy_Beets (14,130 in chips)
Seat 9: Cathleen_Nectarine (12,705 in chips)
Ranae_Skirret: posts small blind 100
Annamarie_Radish: posts big blind 200
*** HOLE CARDS ***
Dealt to Hero [As 7s]
Deja_Fennel: calls 200 
Lacy_Beets: folds
Cathleen_Nectarine: folds
Rebbecca_Melon: raises 600 to 600
Danielle_Coconuts: folds
Hero: folds
Bradford_Grapefruit: calls 600 
Ranae_Skirret: folds
Annamarie_Radish: folds
Deja_Fennel: calls 400 
*** FLOP *** [5d 8d 5h]
Deja_Fennel: checks
Rebbecca_Melon: bets 600 
Bradford_Grapefruit: folds
Deja_Fennel: folds
*** SHOW DOWN ***
Rebbecca_Melon: shows [Ad 7d] (a pair of Fives)
Uncalled bet (600) returned to Rebbecca_Melon
Rebbecca_Melon collected 2100 from pot
*** SUMMARY ***
Total pot 2100 | Rake 0
Board [5d 8d 5h]
Seat 1: Rebbecca_Melon showed [Ad 7d] and won (2100) with a pair of Fives
Seat 2: Danielle_Coconuts mucked [6s Jh]
Seat 3: Hero mucked [As 7s]
Seat 4: Bradford_Grapefruit (button) mucked [Th Qh]
Seat 5: Ranae_Skirret (small blind) mucked [5c Kc]
Seat 6: Annamarie_Radish (big blind) mucked [9c 4s]
Seat 7: Deja_Fennel mucked [Qs Ks]
Seat 8: Lacy_Beets mucked [6c 3d]
Seat 9: Cathleen_Nectarine mucked [Qc 7c]



PokerStars Hand #3661294337: Tournament #21391319, $20+$2 - Hold'em No Limit (100/200) - 2018/04/06 22:56:47
Table '#18' Seat #5 is the button
Seat 1: Jeremy_Rosemary (11,482 in chips)
Seat 2: Jesica_Alfalfa (23,097 in chips)
Seat 3: Hero (15,155 in chips)
Seat 4: Ivory_Radicchio (9,400 in chips)
Seat 5: Ayanna_Broccoli (6,148 in chips)
Seat 6: Janise_Grapes (9,530 in chips)
Seat 7: Miyoko_Boysenberry (15,350 in chips)
Seat 8: Roselee_Parsley (14,130 in chips)
Seat 9: Angelic_Tubers (12,705 in chips)
Janise_Grapes: posts small blind 100
Miyoko_Boysenberry: posts big blind 200
*** HOLE CARDS ***
Dealt to Hero [Qd Ts]
Roselee_Parsley: folds
Angelic_Tubers: folds
Jeremy_Rosemary: folds
Jesica_Alfalfa: folds
Hero: folds
Ivory_Radicchio: folds
Ayanna_Broccoli: folds
Janise_Grapes: folds
Miyoko_Boysenberry: doesn't show hand
Uncalled bet (200) returned to Miyoko_Boysenberry
Miyoko_Boysenberry collected 100 from pot
*** SUMMARY ***
Total pot 100 | Rake 0
Seat 1: Jeremy_Rosemary mucked [5h 4s]
Seat 2: Jesica_Alfalfa mucked [Ad 6c]
Seat 3: Hero mucked [Qd Ts]
Seat 4: Ivory_Radicchio mucked [7s 9s]
Seat 5: Ayanna_Broccoli (button) mucked [7c 3d]
Seat 6: Janise_Grapes (small blind) mucked [8d Ks]
Seat 7: Miyoko_Boysenberry (big blind) showed [2s 9h] and won (100)
Seat 8: Roselee_Parsley mucked [2c Js]
Seat 9: Angelic_Tubers mucked [2d Jh]



PokerStars Hand #3661294653: Tournament #21391319, $20+$2 - Hold'em No Limit (100/200) - 2018/04/06 22:57:17
Table '#18' Seat #6 is the button
Seat 1: Roni_Celeriac (11,482 in chips)
Seat 2: Sheba_Cayenne (23,097 in chips)
Seat 3: Hero (15,155 in chips)
Seat 4: Waldo_Pomegranate (9,400 in chips)
Seat 5: Dong_Honeyberry (6,148 in chips)
Seat 6: Jina_Lavender (9,430 in chips)
Seat 7: Chaya_Yuzu (15,450 in chips)
Seat 8: Jenny_Blackberry (14,130 in chips)
Seat 9: Toya_Papaya (12,705 in chips)
Chaya_Yuzu: posts small blind 100
Jenny_Blackberry: posts big blind 200
*** HOLE CARDS ***
Dealt to Hero [6c 4d]
Toya_Papaya: folds
Roni_Celeriac: folds
Sheba_Cayenne: folds
Hero: folds
Waldo_Pomegranate: folds
Dong_Honeyberry: folds
Jina_Lavender: folds
Chaya_Yuzu: folds
Jenny_Blackberry: doesn't show hand
Uncalled bet (200) returned to Jenny_Blackberry
Jenny_Blackberry collected 100 from pot
*** SUMMARY ***
Total pot 100 | Rake 0
Seat 1: Roni_Celeriac mucked [Qh 9d]
Seat 2: Sheba_Cayenne mucked [Qd Jc]
Seat 3: Hero mucked [6c 4d]
Seat 4: Waldo_Pomegranate mucked [Tc 6s]
Seat 5: Dong_Honeyberry mucked [5c Th]
Seat 6: Jina_Lavender (button) mucked [3d 6d]
Seat 7: Chaya_Yuzu (small blind) mucked [5h 3c]
Seat 8: Jenny_Blackberry (big blind) showed [3h Kh] and won (100)
Seat 9: Toya_Papaya mucked [4c 8h]



PokerStars Hand #3661295035: Tournament #21391319, $20+$2 - Hold'em No Limit (100/200) - 2018/04/06 22:57:53
Table '#18' Seat #7 is the button
Seat 1: Lazaro_Turnips (11,482 in chips)
Seat 2: Tifany_Eggplants (23,097 in chips)
Seat 3: Hero (15,155 in chips)
Seat 4: Jacquelynn_Bilberry (9,400 in chips)
Seat 5: Jarrod_Watermelon (6,148 in chips)
Seat 6: Enola_Tat Soi (9,430 in chips)
Seat 7: Sherill_Raisins (15,350 in chips)
Seat 8: Demetrice_Garlic (14,230 in chips)
Seat 9: Loyce_Quinoa (12,705 in chips)
Demetrice_Garlic: posts small blind 100
Loyce_Quinoa: posts big blind 200
*** HOLE CARDS ***
Dealt to Hero [Ks 4h]
Lazaro_Turnips: folds
Tifany_Eggplants: folds
Hero: folds
Jacquelynn_Bilberry: folds
Jarrod_Watermelon: folds
Enola_Tat Soi: folds
Sherill_Raisins: folds
Demetrice_Garlic: calls 100 
Loyce_Quinoa: checks
*** FLOP *** [Ac 7c 6s]
Demetrice_Garlic: bets 200 
Loyce_Quinoa: folds
Uncalled bet (200) returned to Demetrice_Garlic
Demetrice_Garlic: doesn't show hand
Demetrice_Garlic collected 400 from pot
*** SUMMARY ***
Total pot 400 | Rake 0
Board [Ac 7c 6s]
Seat 1: Lazaro_Turnips mucked [9h 2d]
Seat 2: Tifany_Eggplants mucked [Jc Qs]
Seat 3: Hero mucked [Ks 4h]
Seat 4: Jacquelynn_Bilberry mucked [8s Td]
Seat 5: Jarrod_Watermelon mucked [5d 7s]
Seat 6: Enola_Tat Soi mucked [Jh 5c]
Seat 7: Sherill_Raisins (button) mucked [3d Qd]
Seat 8: Demetrice_Garlic (small blind) showed [Th 3h] and won (400)
Seat 9: Loyce_Quinoa (big blind) mucked [8d Qh]



PokerStars Hand #3661295390: Tournament #21391319, $20+$2 - Hold'em No Limit (100/200) - 2018/04/06 22:58:26
Table '#18' Seat #8 is the button
Seat 1: Emma_Squash (11,482 in chips)
Seat 2: Magda_Chives (23,097 in chips)
Seat 3: Hero (15,155 in chips)
Seat 4: Carolann_Cabbage (9,400 in chips)
Seat 5: Lionel_Goji (6,148 in chips)
Seat 6: Pamela_Turnips (9,430 in chips)
Seat 7: Wm_Cantaloupe (15,350 in chips)
Seat 8: Li_Butternut (14,430 in chips)
Seat 9: Valeria_Wasabi (12,505 in chips)
Valeria_Wasabi: posts small blind 100
Emma_Squash: posts big blind 200
*** HOLE CARDS ***
Dealt to Hero [6h 7c]
Magda_Chives: folds
Hero: folds
Carolann_Cabbage: raises 700 to 700
Lionel_Goji: folds
Pamela_Turnips: folds
Wm_Cantaloupe: folds
Li_Butternut: folds
Valeria_Wasabi: folds
Emma_Squash: folds
Uncalled bet (500) returned to Carolann_Cabbage
Carolann_Cabbage: doesn't show hand
Carolann_Cabbage collected 500 from pot
*** SUMMARY ***
Total pot 500 | Rake 0
Seat 1: Emma_Squash (big blind) mucked [4h 5c]
Seat 2: Magda_Chives mucked [Qd 8c]
Seat 3: Hero mucked [6h 7c]
Seat 4: Carolann_Cabbage showed [Ah Ad] and won (500)
Seat 5: Lionel_Goji mucked [Kh 2c]
Seat 6: Pamela_Turnips mucked [Td 6c]
Seat 7: Wm_Cantaloupe mucked [Jh Tc]
Seat 8: Li_Butternut (button) mucked [3s 8d]
Seat 9: Valeria_Wasabi (small blind) mucked [7s 2d]



PokerStars Hand #3661295703: Tournament #21391319, $20+$2 - Hold'em No Limit (100/200) - 2018/04/06 22:58:56
Table '#18' Seat #9 is the button
Seat 1: Alden_Jackfruit (11,282 in chips)
Seat 2: Wally_Leek (23,097 in chips)
Seat 3: Hero (15,155 in chips)
Seat 4: Kelsi_Sprouts (9,700 in chips)
Seat 5: Caroyln_Lettuce (6,148 in chips)
Seat 6: Willena_Mulberry (9,430 in chips)
Seat 7: Kathi_Cucumber (15,350 in chips)
Seat 8: Garry_Salmonberry (14,430 in chips)
Seat 9: Junko_Pomelo (12,405 in chips)
Alden_Jackfruit: posts small blind 100
Wally_Leek: posts big blind 200
*** HOLE CARDS ***
Dealt to Hero [4s Jh]
Hero: folds
Kelsi_Sprouts: folds
Caroyln_Lettuce: raises 600 to 600
Willena_Mulberry: folds
Kathi_Cucumber: folds
Garry_Salmonberry: folds
Junko_Pomelo: folds
Alden_Jackfruit: calls 500 
Wally_Leek: folds
*** FLOP *** [Tc Kc 3d]
Alden_Jackfruit: checks
Caroyln_Lettuce: bets 400 
Alden_Jackfruit: raises 1200 to 1200
Caroyln_Lettuce: raises 5148 to 5548 and is all-in
Alden_Jackfruit: calls 4348 
*** TURN *** [Tc Kc 3d] [Qh]
*** RIVER *** [Tc Kc 3d Qh] [6d]
*** SHOW DOWN ***
Alden_Jackfruit: shows [Kd Td] (two pair, Kings and Tens)
Caroyln_Lettuce: shows [Th Ad] (a pair of Tens)
Alden_Jackfruit collected 12496 from pot
Caroyln_Lettuce finished the tournament in 135th place
*** SUMMARY ***
Total pot 12496 | Rake 0
Board [Tc Kc 3d Qh 6d]
Seat 1: Alden_Jackfruit (small blind) showed [Kd Td] and won (12496) with two pair, Kings and Tens
Seat 2: Wally_Leek (big blind) mucked [8h Jc]
Seat 3: Hero mucked [4s Jh]
Seat 4: Kelsi_Sprouts mucked [5h 9s]
Seat 5: Caroyln_Lettuce showed [Th Ad] and lost with a pair of Tens
Seat 6: Willena_Mulberry mucked [Js Qd]
Seat 7: Kathi_Cucumber mucked [9c 2d]
Seat 8: Garry_Salmonberry mucked [Ac 4d]
Seat 9: Junko_Pomelo (button) mucked [6s 5s]



PokerStars Hand #3661296440: Tournament #21391319, $20+$2 - Hold'em No Limit (100/200) - 2018/04/06 22:59:56
Table '#18' Seat #1 is the button
Seat 1: Annmarie_Chestnuts (17,630 in chips)
Seat 2: Deirdre_Spinach (22,897 in chips)
Seat 3: Hero (15,155 in chips)
Seat 4: Bettyann_Beets (9,700 in chips)
Seat 5: Reiko_Jabuticaba (9,430 in chips)
Seat 6: Anika_Onions (15,350 in chips)
Seat 7: Roscoe_Zuchinis (14,430 in chips)
Seat 8: Lera_Raspberry (12,405 in chips)
Deirdre_Spinach: posts small blind 100
Hero: posts big blind 200
*** HOLE CARDS ***
Dealt to Hero [9h 5d]
Bettyann_Beets: folds
Reiko_Jabuticaba: folds
Anika_Onions: folds
Roscoe_Zuchinis: folds
Lera_Raspberry: calls 200 
Annmarie_Chestnuts: folds
Deirdre_Spinach: folds
Hero: checks
*** FLOP *** [3d 5s Ks]
Hero: checks
Lera_Raspberry: checks
*** TURN *** [3d 5s Ks] [Th]
Hero: checks
Lera_Raspberry: checks
*** RIVER *** [3d 5s Ks Th] [Ah]
Hero: checks
Lera_Raspberry: bets 250 
Hero: folds
Uncalled bet (250) returned to Lera_Raspberry
Lera_Raspberry: doesn't show hand
Lera_Raspberry collected 500 from pot
*** SUMMARY ***
Total pot 500 | Rake 0
Board [3d 5s Ks Th Ah]
Seat 1: Annmarie_Chestnuts (button) mucked [4c Kd]
Seat 2: Deirdre_Spinach (small blind) mucked [7s 5h]
Seat 3: Hero (big blind) mucked [9h 5d]
Seat 4: Bettyann_Beets mucked [Kc 9d]
Seat 5: Reiko_Jabuticaba mucked [8s 4d]
Seat 6: Anika_Onions mucked [Jd 6c]
Seat 7: Roscoe_Zuchinis mucked [5c Qd]
Seat 8: Lera_Raspberry showed [Ad 2d] and won (500)



PokerStars Hand #3661297399: Tournament #21391319, $20+$2 - Hold'em No Limit (100/200) - 2018/04/06 23:01:20
Table '#18' Seat #2 is the button
Seat 1: Mallory_Wasabi (17,630 in chips)
Seat 2: Benjamin_Tomatoes (22,797 in chips)
Seat 3: Hero (14,955 in chips)
Seat 4: Shira_Habanero (9,700 in chips)
Seat 5: Ethyl_Cantaloupe (10,000 in chips)
Seat 6: Traci_Chamomile (9,430 in chips)
Seat 7: Austin_Skirret (15,350 in chips)
Seat 8: Dierdre_Watermelon (14,430 in chips)
Seat 9: Krystle_Chard (12,705 in chips)
Hero: posts small blind 100
Shira_Habanero: posts big blind 200
*** HOLE CARDS ***
Dealt to Hero [4s 2s]
Ethyl_Cantaloupe: raises 600 to 600
Traci_Chamomile: folds
Austin_Skirret: folds
Dierdre_Watermelon: folds
Krystle_Chard: folds
Mallory_Wasabi: folds
Benjamin_Tomatoes: folds
Hero: folds
Shira_Habanero: folds
Uncalled bet (400) returned to Ethyl_Cantaloupe
Ethyl_Cantaloupe: doesn't show hand
Ethyl_Cantaloupe collected 500 from pot
*** SUMMARY ***
Total pot 500 | Rake 0
Seat 1: Mallory_Wasabi mucked [7d 9c]
Seat 2: Benjamin_Tomatoes (button) mucked [Jh 7h]
Seat 3: Hero (small blind) mucked [4s 2s]
Seat 4: Shira_Habanero (big blind) mucked [2h Th]
Seat 5: Ethyl_Cantaloupe showed [Jc Tc] and won (500)
Seat 6: Traci_Chamomile mucked [2c 7s]
Seat 7: Austin_Skirret mucked [As 6d]
Seat 8: Dierdre_Watermelon mucked [Js 4c]
Seat 9: Krystle_Chard mucked [6s Ah]



PokerStars Hand #3661298112: Tournament #21391319, $20+$2 - Hold'em No Limit (125/250) - 2018/04/06 23:02:23
Table '#18' Seat #3 is the button
Seat 1: Elke_Artichoke (17,630 in chips)
Seat 2: Antone_Lentils (22,797 in chips)
Seat 3: Hero (14,855 in chips)
Seat 4: Regan_Spinach (9,500 in chips)
Seat 5: Creola_Passionfruit (10,300 in chips)
Seat 6: Nakisha_Cucumber (9,430 in chips)
Seat 7: Doris_Jicama (15,350 in chips)
Seat 8: Sana_Pomelo (14,430 in chips)
Seat 9: Leilani_Tangerine (12,705 in chips)
Elke_Artichoke: posts the ante 25
Antone_Lentils: posts the ante 25
Hero: posts the ante 25
Regan_Spinach: posts the ante 25
Creola_Passionfruit: posts the ante 25
Nakisha_Cucumber: posts the ante 25
Doris_Jicama: posts the ante 25
Sana_Pomelo: posts the ante 25
Leilani_Tangerine: posts the ante 25
Regan_Spinach: posts small blind 125
Creola_Passionfruit: posts big blind 250
*** HOLE CARDS ***
Dealt to Hero [3s Tc]
Nakisha_Cucumber: folds
Doris_Jicama: folds
Sana_Pomelo: folds
Leilani_Tangerine: folds
Elke_Artichoke: folds
Antone_Lentils: raises 575 to 575
Hero: folds
Regan_Spinach: calls 450 
Creola_Passionfruit: calls 325 
*** FLOP *** [6s 8s Ac]
Regan_Spinach: checks
Creola_Passionfruit: checks
Antone_Lentils: bets 1325 
Regan_Spinach: folds
Creola_Passionfruit: calls 1325 
*** TURN *** [6s 8s Ac] [4s]
Creola_Passionfruit: checks
Antone_Lentils: checks
*** RIVER *** [6s 8s Ac 4s] [Kc]
Creola_Passionfruit: bets 2027 
Antone_Lentils: calls 2027 
*** SHOW DOWN ***
Creola_Passionfruit: shows [5s 5d] (a pair of Fives)
Antone_Lentils: shows [9h Ad] (a pair of Aces)
Antone_Lentils collected 8654 from pot
*** SUMMARY ***
Total pot 8654 | Rake 0
Board [6s 8s Ac 4s Kc]
Seat 1: Elke_Artichoke mucked [Ts 8d]
Seat 2: Antone_Lentils showed [9h Ad] and won (8654) with a pair of Aces
Seat 3: Hero (button) mucked [3s Tc]
Seat 4: Regan_Spinach (small blind) mucked [Qs Th]
Seat 5: Creola_Passionfruit (big blind) showed [5s 5d] and lost with a pair of Fives
Seat 6: Nakisha_Cucumber mucked [Kh Jh]
Seat 7: Doris_Jicama mucked [7c 3h]
Seat 8: Sana_Pomelo mucked [Js 4c]
Seat 9: Leilani_Tangerine mucked [Kd 7h]



PokerStars Hand #3661299338: Tournament #21391319, $20+$2 - Hold'em No Limit (125/250) - 2018/04/06 23:04:11
Table '#18' Seat #3 is the button
Seat 1: Reatha_Dates (17,605 in chips)
Seat 2: Hero (14,830 in chips)
Seat 3: Colette_Alfalfa (8,900 in chips)
Seat 4: Cherelle_Blueberry (6,348 in chips)
Seat 5: Dianna_Plum (9,405 in chips)
Seat 6: Hilde_Pinto (15,325 in chips)
Seat 7: Clark_Raisins (14,405 in chips)
Seat 8: Dulcie_Pumpkins (12,680 in chips)
Reatha_Dates: posts the ante 25
Hero: posts the ante 25
Colette_Alfalfa: posts the ante 25
Cherelle_Blueberry: posts the ante 25
Dianna_Plum: posts the ante 25
Hilde_Pinto: posts the ante 25
Clark_Raisins: posts the ante 25
Dulcie_Pumpkins: posts the ante 25
Cherelle_Blueberry: posts small blind 125
Dianna_Plum: posts big blind 250
*** HOLE CARDS ***
Dealt to Hero [4c 8h]
Hilde_Pinto: folds
Clark_Raisins: raises 500 to 500
Dulcie_Pumpkins: folds
Reatha_Dates: folds
Hero: folds
Colette_Alfalfa: folds
Cherelle_Blueberry: folds
Dianna_Plum: folds
Uncalled bet (250) returned to Clark_Raisins
Clark_Raisins: doesn't show hand
Clark_Raisins collected 825 from pot
*** SUMMARY ***
Total pot 825 | Rake 0
Seat 1: Reatha_Dates mucked [8s Qh]
Seat 2: Hero mucked [4c 8h]
Seat 3: Colette_Alfalfa (button) mucked [4s Ah]
Seat 4: Cherelle_Blueberry (small blind) mucked [Jh 2s]
Seat 5: Dianna_Plum (big blind) mucked [3d Td]
Seat 6: Hilde_Pinto mucked [8d 3h]
Seat 7: Clark_Raisins showed [5h 5c] and won (825)
Seat 8: Dulcie_Pumpkins mucked [6s Qc]



PokerStars Hand #3661299816: Tournament #21391319, $20+$2 - Hold'em No Limit (125/250) - 2018/04/06 23:04:53
Table '#18' Seat #4 is the button
Seat 1: Page_Mushrooms (17,580 in chips)
Seat 2: Hero (14,805 in chips)
Seat 3: Jaye_Peppers (8,875 in chips)
Seat 4: Arletha_Rhubarb (6,198 in chips)
Seat 5: Lauren_Jabuticaba (9,130 in chips)
Seat 6: Gaston_Juniper (15,300 in chips)
Seat 7: Milagros_Bananas (14,955 in chips)
Seat 8: Carina_Quinoa (12,655 in chips)
Page_Mushrooms: posts the ante 25
Hero: posts the ante 25
Jaye_Peppers: posts the ante 25
Arletha_Rhubarb: posts the ante 25
Lauren_Jabuticaba: posts the ante 25
Gaston_Juniper: posts the ante 25
Milagros_Bananas: posts the ante 25
Carina_Quinoa: posts the ante 25
Lauren_Jabuticaba: posts small blind 125
Gaston_Juniper: posts big blind 250
*** HOLE CARDS ***
Dealt to Hero [9d 7d]
Milagros_Bananas: folds
Carina_Quinoa: folds
Page_Mushrooms: folds
Hero: raises 600 to 600
Jaye_Peppers: raises 2375 to 2375
Arletha_Rhubarb: folds
Lauren_Jabuticaba: folds
Gaston_Juniper: folds
Hero: folds
Uncalled bet (1775) returned to Jaye_Peppers
Jaye_Peppers: doesn't show hand
Jaye_Peppers collected 1775 from pot
*** SUMMARY ***
Total pot 1775 | Rake 0
Seat 1: Page_Mushrooms mucked [5d 2s]
Seat 2: Hero mucked [9d 7d]
Seat 3: Jaye_Peppers showed [Js Jh] and won (1775)
Seat 4: Arletha_Rhubarb (button) mucked [4h 6d]
Seat 5: Lauren_Jabuticaba (small blind) mucked [Td 3s]
Seat 6: Gaston_Juniper (big blind) mucked [Th Kd]
Seat 7: Milagros_Bananas mucked [3c 8s]
Seat 8: Carina_Quinoa mucked [7s Qs]



PokerStars Hand #3661300682: Tournament #21391319, $20+$2 - Hold'em No Limit (125/250) - 2018/04/06 23:06:08
Table '#18' Seat #5 is the button
Seat 1: Kimbra_Cabbage (17,555 in chips)
Seat 2: Hero (14,180 in chips)
Seat 3: Eugene_Onions (10,025 in chips)
Seat 4: Leda_Mulberry (6,173 in chips)
Seat 5: Vikki_Onions (8,980 in chips)
Seat 6: Charleen_Rhubarb (15,025 in chips)
Seat 7: Shanae_Sweetcorn (14,930 in chips)
Seat 8: Allan_Jujube (12,630 in chips)
Kimbra_Cabbage: posts the ante 25
Hero: posts the ante 25
Eugene_Onions: posts the ante 25
Leda_Mulberry: posts the ante 25
Vikki_Onions: posts the ante 25
Charleen_Rhubarb: posts the ante 25
Shanae_Sweetcorn: posts the ante 25
Allan_Jujube: posts the ante 25
Charleen_Rhubarb: posts small blind 125
Shanae_Sweetcorn: posts big blind 250
*** HOLE CARDS ***
Dealt to Hero [2c Qh]
Allan_Jujube: folds
Kimbra_Cabbage: folds
Hero: folds
Eugene_Onions: folds
Leda_Mulberry: raises 716 to 716
Vikki_Onions: folds
Charleen_Rhubarb: folds
Shanae_Sweetcorn: calls 466 
*** FLOP *** [8h 2h 6s]
Shanae_Sweetcorn: bets 1574 
Leda_Mulberry: raises 5432 to 5432 and is all-in
Shanae_Sweetcorn: calls 3858 
*** TURN *** [8h 2h 6s] [9h]
*** RIVER *** [8h 2h 6s 9h] [4d]
*** SHOW DOWN ***
Leda_Mulberry: shows [Qd Ac] (high card Ace)
Shanae_Sweetcorn: shows [9c 7c] (a pair of Nines)
Shanae_Sweetcorn collected 12621 from pot
Leda_Mulberry finished the tournament in 138th place
*** SUMMARY ***
Total pot 12621 | Rake 0
Board [8h 2h 6s 9h 4d]
Seat 1: Kimbra_Cabbage mucked [6c Ts]
Seat 2: Hero mucked [2c Qh]
Seat 3: Eugene_Onions mucked [8s 3c]
Seat 4: Leda_Mulberry showed [Qd Ac] and lost with high card Ace
Seat 5: Vikki_Onions (button) mucked [5d 7d]
Seat 6: Charleen_Rhubarb (small blind) mucked [Tc Qs]
Seat 7: Shanae_Sweetcorn (big blind) showed [9c 7c] and won (12621) with a pair of Nines
Seat 8: Allan_Jujube mucked [6d 3h]



PokerStars Hand #3661301471: Tournament #21391319, $20+$2 - Hold'em No Limit (125/250) - 2018/04/06 23:07:20
Table '#18' Seat #6 is the button
Seat 1: Cecil_Zuchinis (17,530 in chips)
Seat 2: Renay_Parsley (10,000 in chips)
Seat 3: Hero (14,155 in chips)
Seat 4: Letty_Parsley (10,000 in chips)
Seat 5: Monika_Grapes (8,955 in chips)
Seat 6: Stephaine_Rutabaga (14,875 in chips)
Seat 7: Tania_Peppers (21,378 in chips)
Seat 8: Loralee_Chili (12,605 in chips)
Cecil_Zuchinis: posts the ante 25
Renay_Parsley: posts the ante 25
Hero: posts the ante 25
Letty_Parsley: posts the ante 25
Monika_Grapes: posts the ante 25
Stephaine_Rutabaga: posts the ante 25
Tania_Peppers: posts the ante 25
Loralee_Chili: posts the ante 25
Tania_Peppers: posts small blind 125
Loralee_Chili: posts big blind 250
*** HOLE CARDS ***
Dealt to Hero [Js Kc]
Cecil_Zuchinis: calls 250 
Renay_Parsley: folds
Hero: folds
Letty_Parsley: folds
Monika_Grapes: folds
Stephaine_Rutabaga: folds
Tania_Peppers: folds
Loralee_Chili: checks
*** FLOP *** [4c 7c Kh]
Loralee_Chili: checks
Cecil_Zuchinis: checks
*** TURN *** [4c 7c Kh] [Qd]
Loralee_Chili: checks
Cecil_Zuchinis: bets 450 
Loralee_Chili: folds
Uncalled bet (450) returned to Cecil_Zuchinis
Cecil_Zuchinis: doesn't show hand
Cecil_Zuchinis collected 825 from pot
*** SUMMARY ***
Total pot 825 | Rake 0
Board [4c 7c Kh Qd]
Seat 1: Cecil_Zuchinis showed [Ah 8s] and won (825)
Seat 2: Renay_Parsley mucked [8d 9d]
Seat 3: Hero mucked [Js Kc]
Seat 4: Letty_Parsley mucked [5d 9c]
Seat 5: Monika_Grapes mucked [As 5c]
Seat 6: Stephaine_Rutabaga (button) mucked [Qs 9s]
Seat 7: Tania_Peppers (small blind) mucked [Jh 5s]
Seat 8: Loralee_Chili (big blind) mucked [7d Th]



PokerStars Hand #3661302332: Tournament #21391319, $20+$2 - Hold'em No Limit (125/250) - 2018/04/06 23:08:38
Table '#18' Seat #8 is the button
Seat 1: Arleen_Dragonfruits (18,080 in chips)
Seat 2: Loria_Beets (9,975 in chips)
Seat 3: Hero (14,130 in chips)
Seat 4: Kyra_Tomatoes (9,975 in chips)
Seat 5: Tamiko_Pears (10,000 in chips)
Seat 6: Cicely_Olive (8,930 in chips)
Seat 7: Gaylord_Pomelo (14,850 in chips)
Seat 8: Clayton_Rambutan (21,228 in chips)
Seat 9: Racquel_Onions (12,330 in chips)
Arleen_Dragonfruits: posts the ante 25
Loria_Beets: posts the ante 25
Hero: posts the ante 25
Kyra_Tomatoes: posts the ante 25
Tamiko_Pears: posts the ante 25
Cicely_Olive: posts the ante 25
Gaylord_Pomelo: posts the ante 25
Clayton_Rambutan: posts the ante 25
Racquel_Onions: posts the ante 25
Racquel_Onions: posts small blind 125
Arleen_Dragonfruits: posts big blind 250
*** HOLE CARDS ***
Dealt to Hero [Ac 8d]
Loria_Beets: folds
Hero: folds
Kyra_Tomatoes: folds
Tamiko_Pears: folds
Cicely_Olive: raises 750 to 750
Gaylord_Pomelo: calls 750 
Clayton_Rambutan: folds
Racquel_Onions: folds
Arleen_Dragonfruits: calls 500 
*** FLOP *** [2d Jc 6c]
Arleen_Dragonfruits: checks
Cicely_Olive: checks
Gaylord_Pomelo: checks
*** TURN *** [2d Jc 6c] [Td]
Arleen_Dragonfruits: checks
Cicely_Olive: checks
Gaylord_Pomelo: bets 3607 
Arleen_Dragonfruits: folds
Cicely_Olive: folds
Uncalled bet (3607) returned to Gaylord_Pomelo
Gaylord_Pomelo: doesn't show hand
Gaylord_Pomelo collected 2600 from pot
*** SUMMARY ***
Total pot 2600 | Rake 0
Board [2d Jc 6c Td]
Seat 1: Arleen_Dragonfruits (big blind) mucked [Kc Qs]
Seat 2: Loria_Beets mucked [4d 7c]
Seat 3: Hero mucked [Ac 8d]
Seat 4: Kyra_Tomatoes mucked [Tc Jh]
Seat 5: Tamiko_Pears mucked [2s 4c]
Seat 6: Cicely_Olive mucked [5c 5s]
Seat 7: Gaylord_Pomelo showed [6s 6d] and won (2600)
Seat 8: Clayton_Rambutan (button) mucked [Jd 7d]
Seat 9: Racquel_Onions (small blind) mucked [2h Ah]



PokerStars Hand #3661303270: Tournament #21391319, $20+$2 - Hold'em No Limit (125/250) - 2018/04/06 23:09:59
Table '#18' Seat #9 is the button
Seat 1: Tiffaney_Oregano (17,305 in chips)
Seat 2: Melony_Jalapeño (9,950 in chips)
Seat 3: Hero (14,105 in chips)
Seat 4: Meridith_Anise (9,950 in chips)
Seat 5: Audrie_Lychee (9,975 in chips)
Seat 6: Sherrill_Beans (8,155 in chips)
Seat 7: Enda_Dill (16,675 in chips)
Seat 8: Jami_Papaya (21,203 in chips)
Seat 9: Lenora_Satsuma (12,180 in chips)
Tiffaney_Oregano: posts the ante 25
Melony_Jalapeño: posts the ante 25
Hero: posts the ante 25
Meridith_Anise: posts the ante 25
Audrie_Lychee: posts the ante 25
Sherrill_Beans: posts the ante 25
Enda_Dill: posts the ante 25
Jami_Papaya: posts the ante 25
Lenora_Satsuma: posts the ante 25
Tiffaney_Oregano: posts small blind 125
Melony_Jalapeño: posts big blind 250
*** HOLE CARDS ***
Dealt to Hero [Jd 9d]
Hero: raises 600 to 600
Meridith_Anise: raises 2400 to 2400
Audrie_Lychee: folds
Sherrill_Beans: folds
Enda_Dill: folds
Jami_Papaya: folds
Lenora_Satsuma: folds
Tiffaney_Oregano: folds
Melony_Jalapeño: folds
Hero: folds
Uncalled bet (1800) returned to Meridith_Anise
Meridith_Anise: doesn't show hand
Meridith_Anise collected 1800 from pot
*** SUMMARY ***
Total pot 1800 | Rake 0
Seat 1: Tiffaney_Oregano (small blind) mucked [4d 7s]
Seat 2: Melony_Jalapeño (big blind) mucked [4c Ac]
Seat 3: Hero mucked [Jd 9d]
Seat 4: Meridith_Anise showed [Kd As] and won (1800)
Seat 5: Audrie_Lychee mucked [6s 8s]
Seat 6: Sherrill_Beans mucked [Jc 6h]
Seat 7: Enda_Dill mucked [4h 2c]
Seat 8: Jami_Papaya mucked [Ah Td]
Seat 9: Lenora_Satsuma (button) mucked [5s 8c]



PokerStars Hand #3661304019: Tournament #21391319, $20+$2 - Hold'em No Limit (125/250) - 2018/04/06 23:11:08
Table '#18' Seat #1 is the button
Seat 1: Noel_Paprika (17,155 in chips)
Seat 2: Bao_Cabbage (9,675 in chips)
Seat 3: Hero (13,480 in chips)
Seat 4: Kip_Coconuts (11,125 in chips)
Seat 5: Jordon_Peach (9,950 in chips)
Seat 6: Marquis_Anise (8,130 in chips)
Seat 7: Alycia_Mango (16,650 in chips)
Seat 8: Kym_Kiwi (21,178 in chips)
Seat 9: Gretta_Satsuma (12,155 in chips)
Noel_Paprika: posts the ante 25
Bao_Cabbage: posts the ante 25
Hero: posts the ante 25
Kip_Coconuts: posts the ante 25
Jordon_Peach: posts the ante 25
Marquis_Anise: posts the ante 25
Alycia_Mango: posts the ante 25
Kym_Kiwi: posts the ante 25
Gretta_Satsuma: posts the ante 25
Bao_Cabbage: posts small blind 125
Hero: posts big blind 250
*** HOLE CARDS ***
Dealt to Hero [2d 9c]
Kip_Coconuts: folds
Jordon_Peach: folds
Marquis_Anise: folds
Alycia_Mango: folds
Kym_Kiwi: folds
Gretta_Satsuma: folds
Noel_Paprika: calls 250 
Bao_Cabbage: folds
Hero: checks
*** FLOP *** [4d Ts 8c]
Hero: checks
Noel_Paprika: checks
*** TURN *** [4d Ts 8c] [2s]
Hero: checks
Noel_Paprika: checks
*** RIVER *** [4d Ts 8c 2s] [3h]
Hero: checks
Noel_Paprika: checks
*** SHOW DOWN ***
Hero: shows [2d 9c] (a pair of Deuces)
Noel_Paprika: Mucks [Kc 9d] (High Card)
Hero collected 850 from pot
*** SUMMARY ***
Total pot 850 | Rake 0
Board [4d Ts 8c 2s 3h]
Seat 1: Noel_Paprika (button) mucked [Kc 9d]
Seat 2: Bao_Cabbage (small blind) mucked [5c 7h]
Seat 3: Hero (big blind) showed [2d 9c] and won (850) with a pair of Deuces
Seat 4: Kip_Coconuts mucked [5h Jd]
Seat 5: Jordon_Peach mucked [3c 7s]
Seat 6: Marquis_Anise mucked [Kd Js]
Seat 7: Alycia_Mango mucked [6h Qh]
Seat 8: Kym_Kiwi mucked [8d Jc]
Seat 9: Gretta_Satsuma mucked [6s Td]



PokerStars Hand #3661305229: Tournament #21391319, $20+$2 - Hold'em No Limit (150/300) - 2018/04/06 23:12:59
Table '#18' Seat #2 is the button
Seat 1: Louis_Salak (16,880 in chips)
Seat 2: Eusebio_Melon (9,525 in chips)
Seat 3: Hero (14,055 in chips)
Seat 4: Carleen_Chard (11,100 in chips)
Seat 5: Royce_Broccoli (9,925 in chips)
Seat 6: Kenda_Carrots (8,105 in chips)
Seat 7: Shanice_Raisins (16,625 in chips)
Seat 8: Jefferson_Lychee (21,153 in chips)
Seat 9: Trang_Salak (12,130 in chips)
Louis_Salak: posts the ante 30
Eusebio_Melon: posts the ante 30
Hero: posts the ante 30
Carleen_Chard: posts the ante 30
Royce_Broccoli: posts the ante 30
Kenda_Carrots: posts the ante 30
Shanice_Raisins: posts the ante 30
Jefferson_Lychee: posts the ante 30
Trang_Salak: posts the ante 30
Hero: posts small blind 150
Carleen_Chard: posts big blind 300
*** HOLE CARDS ***
Dealt to Hero [4c 2s]
Royce_Broccoli: folds
Kenda_Carrots: folds
Shanice_Raisins: folds
Jefferson_Lychee: folds
Trang_Salak: folds
Louis_Salak: folds
Eusebio_Melon: folds
Hero: folds
Carleen_Chard: doesn't show hand
Uncalled bet (300) returned to Carleen_Chard
Carleen_Chard collected 420 from pot
*** SUMMARY ***
Total pot 420 | Rake 0
Seat 1: Louis_Salak mucked [9s 3s]
Seat 2: Eusebio_Melon (button) mucked [9d Ts]
Seat 3: Hero (small blind) mucked [4c 2s]
Seat 4: Carleen_Chard (big blind) showed [8d 6c] and won (420)
Seat 5: Royce_Broccoli mucked [6s Kc]
Seat 6: Kenda_Carrots mucked [7h 9h]
Seat 7: Shanice_Raisins mucked [2h 9c]
Seat 8: Jefferson_Lychee mucked [6d Ac]
Seat 9: Trang_Salak mucked [8s 5s]



PokerStars Hand #3661305779: Tournament #21391319, $20+$2 - Hold'em No Limit (150/300) - 2018/04/06 23:13:50
Table '#18' Seat #3 is the button
Seat 1: Autumn_Nectarine (16,850 in chips)
Seat 2: Cara_Olive (9,495 in chips)
Seat 3: Hero (13,875 in chips)
Seat 4: Diann_Jabuticaba (11,490 in chips)
Seat 5: Grady_Radicchio (9,895 in chips)
Seat 6: Allan_Olive (8,075 in chips)
Seat 7: Adolfo_Beans (21,123 in chips)
Seat 8: Christi_Chickpeas (12,100 in chips)
Autumn_Nectarine: posts the ante 30
Cara_Olive: posts the ante 30
Hero: posts the ante 30
Diann_Jabuticaba: posts the ante 30
Grady_Radicchio: posts the ante 30
Allan_Olive: posts the ante 30
Adolfo_Beans: posts the ante 30
Christi_Chickpeas: posts the ante 30
Diann_Jabuticaba: posts small blind 150
Grady_Radicchio: posts big blind 300
*** HOLE CARDS ***
Dealt to Hero [6s 7d]
Allan_Olive: folds
Adolfo_Beans: folds
Christi_Chickpeas: folds
Autumn_Nectarine: calls 300 
Cara_Olive: folds
Hero: folds
Diann_Jabuticaba: calls 150 
Grady_Radicchio: checks
*** FLOP *** [4h Qh Qs]
Diann_Jabuticaba: checks
Grady_Radicchio: checks
Autumn_Nectarine: checks
*** TURN *** [4h Qh Qs] [4d]
Diann_Jabuticaba: checks
Grady_Radicchio: checks
Autumn_Nectarine: checks
*** RIVER *** [4h Qh Qs 4d] [3c]
Diann_Jabuticaba: checks
Grady_Radicchio: checks
Autumn_Nectarine: checks
*** SHOW DOWN ***
Diann_Jabuticaba: shows [9h Kd] (two pair, Queens and Fours)
Grady_Radicchio: Mucks [2s 7h] (Two pair)
Autumn_Nectarine: shows [7c Ad] (two pair, Queens and Fours)
Autumn_Nectarine collected 1140 from pot
*** SUMMARY ***
Total pot 1140 | Rake 0
Board [4h Qh Qs 4d 3c]
Seat 1: Autumn_Nectarine showed [7c Ad] and won (1140) with two pair, Queens and Fours
Seat 2: Cara_Olive mucked [Kh 2d]
Seat 3: Hero (button) mucked [6s 7d]
Seat 4: Diann_Jabuticaba (small blind) showed [9h Kd] and lost with two pair, Queens and Fours
Seat 5: Grady_Radicchio (big blind) mucked [2s 7h]
Seat 6: Allan_Olive mucked [Ac 8h]
Seat 7: Adolfo_Beans mucked [5d 8s]
Seat 8: Christi_Chickpeas mucked [3h 4c]



PokerStars Hand #3661307417: Tournament #21391319, $20+$2 - Hold'em No Limit (150/300) - 2018/04/06 23:16:14
Table '#18' Seat #4 is the button
Seat 1: Doris_Eggplants (17,660 in chips)
Seat 2: Cletus_Prunes (9,465 in chips)
Seat 3: Hero (13,845 in chips)
Seat 4: Tiesha_Blueberry (11,160 in chips)
Seat 5: Maranda_Apples (9,565 in chips)
Seat 6: Avril_Plantain (8,045 in chips)
Seat 7: Ming_Apples (10,000 in chips)
Seat 8: Evelia_Spinach (21,093 in chips)
Seat 9: Bernardine_Alfalfa (12,070 in chips)
Doris_Eggplants: posts the ante 30
Cletus_Prunes: posts the ante 30
Hero: posts the ante 30
Tiesha_Blueberry: posts the ante 30
Maranda_Apples: posts the ante 30
Avril_Plantain: posts the ante 30
Ming_Apples: posts the ante 30
Evelia_Spinach: posts the ante 30
Bernardine_Alfalfa: posts the ante 30
Maranda_Apples: posts small blind 150
Avril_Plantain: posts big blind 300
*** HOLE CARDS ***
Dealt to Hero [Ah 4h]
Ming_Apples: folds
Evelia_Spinach: folds
Bernardine_Alfalfa: folds
Doris_Eggplants: folds
Cletus_Prunes: raises 900 to 900
Hero: folds
Tiesha_Blueberry: folds
Maranda_Apples: folds
Avril_Plantain: folds
Uncalled bet (600) returned to Cletus_Prunes
Cletus_Prunes: doesn't show hand
Cletus_Prunes collected 1020 from pot
*** SUMMARY ***
Total pot 1020 | Rake 0
Seat 1: Doris_Eggplants mucked [7s 4d]
Seat 2: Cletus_Prunes showed [9s Ac] and won (1020)
Seat 3: Hero mucked [Ah 4h]
Seat 4: Tiesha_Blueberry (button) mucked [Ad 7c]
Seat 5: Maranda_Apples (small blind) mucked [2s 5c]
Seat 6: Avril_Plantain (big blind) mucked [5h Qc]
Seat 7: Ming_Apples mucked [Qs 8d]
Seat 8: Evelia_Spinach mucked [Tc 8c]
Seat 9: Bernardine_Alfalfa mucked [Td 9d]



PokerStars Hand #3661308142: Tournament #21391319, $20+$2 - Hold'em No Limit (150/300) - 2018/04/06 23:17:17
Table '#18' Seat #5 is the button
Seat 1: Agatha_Habanero (17,630 in chips)
Seat 2: Ines_Rosemary (10,155 in chips)
Seat 3: Hero (13,815 in chips)
Seat 4: Claudine_Grapes (11,130 in chips)
Seat 5: Rosena_Leek (9,385 in chips)
Seat 6: Bree_Sage (7,715 in chips)
Seat 7: Moises_Lentils (9,970 in chips)
Seat 8: Boris_Coconuts (21,063 in chips)
Seat 9: Keli_Lychee (12,040 in chips)
Agatha_Habanero: posts the ante 30
Ines_Rosemary: posts the ante 30
Hero: posts the ante 30
Claudine_Grapes: posts the ante 30
Rosena_Leek: posts the ante 30
Bree_Sage: posts the ante 30
Moises_Lentils: posts the ante 30
Boris_Coconuts: posts the ante 30
Keli_Lychee: posts the ante 30
Bree_Sage: posts small blind 150
Moises_Lentils: posts big blind 300
*** HOLE CARDS ***
Dealt to Hero [Kh 8s]
Boris_Coconuts: folds
Keli_Lychee: folds
Agatha_Habanero: folds
Ines_Rosemary: folds
Hero: folds
Claudine_Grapes: raises 1320 to 1320
Rosena_Leek: folds
Bree_Sage: folds
Moises_Lentils: folds
Uncalled bet (1020) returned to Claudine_Grapes
Claudine_Grapes: doesn't show hand
Claudine_Grapes collected 1020 from pot
*** SUMMARY ***
Total pot 1020 | Rake 0
Seat 1: Agatha_Habanero mucked [Qs 8c]
Seat 2: Ines_Rosemary mucked [6h 2d]
Seat 3: Hero mucked [Kh 8s]
Seat 4: Claudine_Grapes showed [Td Th] and won (1020)
Seat 5: Rosena_Leek (button) mucked [3d 4s]
Seat 6: Bree_Sage (small blind) mucked [5d 5c]
Seat 7: Moises_Lentils (big blind) mucked [Jh 5s]
Seat 8: Boris_Coconuts mucked [9h 6s]
Seat 9: Keli_Lychee mucked [6c Jc]



PokerStars Hand #3661308758: Tournament #21391319, $20+$2 - Hold'em No Limit (150/300) - 2018/04/06 23:18:11
Table '#18' Seat #6 is the button
Seat 1: Armando_Clementine (17,600 in chips)
Seat 2: Dawn_Onions (10,125 in chips)
Seat 3: Hero (13,785 in chips)
Seat 4: Marquita_Blackberry (11,820 in chips)
Seat 5: Taneka_Apples (9,355 in chips)
Seat 6: Carmela_Paprika (7,535 in chips)
Seat 7: Avis_Jalapeño (9,640 in chips)
Seat 8: Jade_Turnips (21,033 in chips)
Seat 9: Angeles_Ugli (12,010 in chips)
Armando_Clementine: posts the ante 30
Dawn_Onions: posts the ante 30
Hero: posts the ante 30
Marquita_Blackberry: posts the ante 30
Taneka_Apples: posts the ante 30
Carmela_Paprika: posts the ante 30
Avis_Jalapeño: posts the ante 30
Jade_Turnips: posts the ante 30
Angeles_Ugli: posts the ante 30
Avis_Jalapeño: posts small blind 150
Jade_Turnips: posts big blind 300
*** HOLE CARDS ***
Dealt to Hero [Js Jd]
Angeles_Ugli: folds
Armando_Clementine: folds
Dawn_Onions: folds
Hero: raises 700 to 700
Marquita_Blackberry: folds
Taneka_Apples: calls 700 
Carmela_Paprika: calls 700 
Avis_Jalapeño: folds
Jade_Turnips: folds
*** FLOP *** [Ac Qh 6d]
Hero: bets 999 
Taneka_Apples: folds
Carmela_Paprika: calls 999 
*** TURN *** [Ac Qh 6d] [Jh]
Hero: bets 2000 
Carmela_Paprika: raises 5806 to 5806 and is all-in
Hero: calls 3806 
*** RIVER *** [Ac Qh 6d Jh] [6h]
*** SHOW DOWN ***
Hero: shows [Js Jd] (a full house, Jacks full of Sixes)
Carmela_Paprika: shows [Qd Ah] (two pair, Aces and Queens)
Hero collected 16430 from pot
Carmela_Paprika finished the tournament in 149th place
*** SUMMARY ***
Total pot 16430 | Rake 0
Board [Ac Qh 6d Jh 6h]
Seat 1: Armando_Clementine mucked [Th 7h]
Seat 2: Dawn_Onions mucked [Ks 2s]
Seat 3: Hero showed [Js Jd] and won (16430) with a full house, Jacks full of Sixes
Seat 4: Marquita_Blackberry mucked [4c 8h]
Seat 5: Taneka_Apples mucked [3s 4s]
Seat 6: Carmela_Paprika (button) showed [Qd Ah] and lost with two pair, Aces and Queens
Seat 7: Avis_Jalapeño (small blind) mucked [4h Qs]
Seat 8: Jade_Turnips (big blind) mucked [6c Kh]
Seat 9: Angeles_Ugli mucked [8d 7s]



PokerStars Hand #3661309899: Tournament #21391319, $20+$2 - Hold'em No Limit (150/300) - 2018/04/06 23:19:50
Table '#18' Seat #6 is the button
Seat 1: James_Cucumber (17,570 in chips)
Seat 2: Dyan_Persimmon (10,095 in chips)
Seat 3: Hero (22,680 in chips)
Seat 4: Lupe_Shallot (11,790 in chips)
Seat 5: Levi_Figs (8,625 in chips)
Seat 6: Shanna_Coriander (9,460 in chips)
Seat 7: Greg_Soursop (20,703 in chips)
Seat 8: Romelia_Apples (11,980 in chips)
James_Cucumber: posts the ante 30
Dyan_Persimmon: posts the ante 30
Hero: posts the ante 30
Lupe_Shallot: posts the ante 30
Levi_Figs: posts the ante 30
Shanna_Coriander: posts the ante 30
Greg_Soursop: posts the ante 30
Romelia_Apples: posts the ante 30
Greg_Soursop: posts small blind 150
Romelia_Apples: posts big blind 300
*** HOLE CARDS ***
Dealt to Hero [5c 9h]
James_Cucumber: folds
Dyan_Persimmon: folds
Hero: folds
Lupe_Shallot: folds
Levi_Figs: folds
Shanna_Coriander: raises 1200 to 1200
Greg_Soursop: raises 20523 to 20673 and is all-in
Romelia_Apples: folds
Shanna_Coriander: calls 8230 and is all-in
*** FLOP *** [Kc 2d Ks]
*** TURN *** [Kc 2d Ks] [8c]
*** RIVER *** [Kc 2d Ks 8c] [4c]
*** SHOW DOWN ***
Shanna_Coriander: shows [Qd Jc] (a pair of Kings)
Greg_Soursop: shows [9d Kd] (three of a kind, Kings)
Uncalled bet (11243) returned to Greg_Soursop
Greg_Soursop collected 19400 from pot
Shanna_Coriander finished the tournament in 148th place
*** SUMMARY ***
Total pot 19400 | Rake 0
Board [Kc 2d Ks 8c 4c]
Seat 1: James_Cucumber mucked [9c As]
Seat 2: Dyan_Persimmon mucked [2c 8d]
Seat 3: Hero mucked [5c 9h]
Seat 4: Lupe_Shallot mucked [7s 6d]
Seat 5: Levi_Figs mucked [Jd 5h]
Seat 6: Shanna_Coriander (button) showed [Qd Jc] and lost with a pair of Kings
Seat 7: Greg_Soursop (small blind) showed [9d Kd] and won (19400) with three of a kind, Kings
Seat 8: Romelia_Apples (big blind) mucked [Jh Td]



PokerStars Hand #3661310670: Tournament #21391319, $20+$2 - Hold'em No Limit (150/300) - 2018/04/06 23:20:56
Table '#18' Seat #6 is the button
Seat 1: Carmon_Celeriac (17,540 in chips)
Seat 2: Jay_Fennel (10,065 in chips)
Seat 3: Hero (22,650 in chips)
Seat 4: Evon_Tomatoes (11,760 in chips)
Seat 5: Tyrell_Potatos (8,595 in chips)
Seat 6: Vernie_Horseradish (30,643 in chips)
Seat 7: Magan_Jabuticaba (11,650 in chips)
Carmon_Celeriac: posts the ante 30
Jay_Fennel: posts the ante 30
Hero: posts the ante 30
Evon_Tomatoes: posts the ante 30
Tyrell_Potatos: posts the ante 30
Vernie_Horseradish: posts the ante 30
Magan_Jabuticaba: posts the ante 30
Magan_Jabuticaba: posts small blind 150
Carmon_Celeriac: posts big blind 300
*** HOLE CARDS ***
Dealt to Hero [3c 2h]
Jay_Fennel: folds
Hero: folds
Evon_Tomatoes: folds
Tyrell_Potatos: folds
Vernie_Horseradish: folds
Magan_Jabuticaba: raises 750 to 900
Carmon_Celeriac: folds
Uncalled bet (600) returned to Magan_Jabuticaba
Magan_Jabuticaba: doesn't show hand
Magan_Jabuticaba collected 810 from pot
*** SUMMARY ***
Total pot 810 | Rake 0
Seat 1: Carmon_Celeriac (big blind) mucked [4c 2c]
Seat 2: Jay_Fennel mucked [4d 4h]
Seat 3: Hero mucked [3c 2h]
Seat 4: Evon_Tomatoes mucked [6d Jh]
Seat 5: Tyrell_Potatos mucked [8c Qd]
Seat 6: Vernie_Horseradish (button) mucked [2d 9c]
Seat 7: Magan_Jabuticaba (small blind) showed [Tc Td] and won (810)



PokerStars Hand #3661311473: Tournament #21391319, $20+$2 - Hold'em No Limit (200/400) - 2018/04/06 23:22:08
Table '#18' Seat #8 is the button
Seat 1: Lashaunda_Salmonberry (17,210 in chips)
Seat 2: Yi_Melon (10,035 in chips)
Seat 3: Hero (22,620 in chips)
Seat 4: Briana_Butternut (11,730 in chips)
Seat 5: Jutta_Ugli (8,565 in chips)
Seat 6: Luis_Jabuticaba (10,000 in chips)
Seat 7: Herma_Spinach (30,613 in chips)
Seat 8: Rufina_Celeriac (12,130 in chips)
Lashaunda_Salmonberry: posts the ante 40
Yi_Melon: posts the ante 40
Hero: posts the ante 40
Briana_Butternut: posts the ante 40
Jutta_Ugli: posts the ante 40
Luis_Jabuticaba: posts the ante 40
Herma_Spinach: posts the ante 40
Rufina_Celeriac: posts the ante 40
Lashaunda_Salmonberry: posts small blind 200
Yi_Melon: posts big blind 400
*** HOLE CARDS ***
Dealt to Hero [2d 5c]
Hero: folds
Briana_Butternut: folds
Jutta_Ugli: folds
Luis_Jabuticaba: folds
Herma_Spinach: raises 800 to 800
Rufina_Celeriac: folds
Lashaunda_Salmonberry: folds
Yi_Melon: folds
Uncalled bet (400) returned to Herma_Spinach
Herma_Spinach: doesn't show hand
Herma_Spinach collected 1320 from pot
*** SUMMARY ***
Total pot 1320 | Rake 0
Seat 1: Lashaunda_Salmonberry (small blind) mucked [Qc 7h]
Seat 2: Yi_Melon (big blind) mucked [6c 2c]
Seat 3: Hero mucked [2d 5c]
Seat 4: Briana_Butternut mucked [8h Qd]
Seat 5: Jutta_Ugli mucked [Ks 6h]
Seat 6: Luis_Jabuticaba mucked [3h 9c]
Seat 7: Herma_Spinach showed [5h 5s] and won (1320)
Seat 8: Rufina_Celeriac (button) mucked [Kd Td]



PokerStars Hand #3661311997: Tournament #21391319, $20+$2 - Hold'em No Limit (200/400) - 2018/04/06 23:22:59
Table '#18' Seat #1 is the button
Seat 1: Reyna_Daikon (16,970 in chips)
Seat 2: Santo_Peas (9,595 in chips)
Seat 3: Hero (22,580 in chips)
Seat 4: Sharee_Quince (11,690 in chips)
Seat 5: Lee_Yams (8,525 in chips)
Seat 6: Lesha_Apples (9,960 in chips)
Seat 7: Daniela_Fennel (10,000 in chips)
Seat 8: Ermelinda_Cranberry (31,493 in chips)
Seat 9: Filiberto_Kiwi (12,090 in chips)
Reyna_Daikon: posts the ante 40
Santo_Peas: posts the ante 40
Hero: posts the ante 40
Sharee_Quince: posts the ante 40
Lee_Yams: posts the ante 40
Lesha_Apples: posts the ante 40
Daniela_Fennel: posts the ante 40
Ermelinda_Cranberry: posts the ante 40
Filiberto_Kiwi: posts the ante 40
Santo_Peas: posts small blind 200
Hero: posts big blind 400
*** HOLE CARDS ***
Dealt to Hero [2d 5d]
Sharee_Quince: folds
Lee_Yams: calls 400 
Lesha_Apples: folds
Daniela_Fennel: raises 2800 to 2800
Ermelinda_Cranberry: folds
Filiberto_Kiwi: folds
Reyna_Daikon: folds
Santo_Peas: folds
Hero: folds
Lee_Yams: folds
*** SHOW DOWN ***
Daniela_Fennel: shows [Ac Kc] (high card Ace)
Uncalled bet (2400) returned to Daniela_Fennel
Daniela_Fennel collected 1760 from pot
*** SUMMARY ***
Total pot 1760 | Rake 0
Seat 1: Reyna_Daikon (button) mucked [7d Ah]
Seat 2: Santo_Peas (small blind) mucked [5c 2s]
Seat 3: Hero (big blind) mucked [2d 5d]
Seat 4: Sharee_Quince mucked [Jd 8s]
Seat 5: Lee_Yams mucked [8c 6c]
Seat 6: Lesha_Apples mucked [2h 9d]
Seat 7: Daniela_Fennel showed [Ac Kc] and won (1760) with high card Ace
Seat 8: Ermelinda_Cranberry mucked [5h 3s]
Seat 9: Filiberto_Kiwi mucked [Qc 4h]



PokerStars Hand #3661312735: Tournament #21391319, $20+$2 - Hold'em No Limit (200/400) - 2018/04/06 23:24:05
Table '#18' Seat #2 is the button
Seat 1: Julio_Elderberry (16,930 in chips)
Seat 2: Catarina_Apples (9,355 in chips)
Seat 3: Hero (22,140 in chips)
Seat 4: Larue_Tat Soi (11,650 in chips)
Seat 5: Vito_Carrots (8,085 in chips)
Seat 6: Kirby_Plantain (9,920 in chips)
Seat 7: Meghan_Plum (11,320 in chips)
Seat 8: Kathi_Marionberry (31,453 in chips)
Seat 9: Leeann_Honeyberry (12,050 in chips)
Julio_Elderberry: posts the ante 40
Catarina_Apples: posts the ante 40
Hero: posts the ante 40
Larue_Tat Soi: posts the ante 40
Vito_Carrots: posts the ante 40
Kirby_Plantain: posts the ante 40
Meghan_Plum: posts the ante 40
Kathi_Marionberry: posts the ante 40
Leeann_Honeyberry: posts the ante 40
Hero: posts small blind 200
Larue_Tat Soi: posts big blind 400
*** HOLE CARDS ***
Dealt to Hero [8c Kh]
Vito_Carrots: calls 400 
Kirby_Plantain: calls 400 
Meghan_Plum: folds
Kathi_Marionberry: raises 1600 to 1600
Leeann_Honeyberry: folds
Julio_Elderberry: folds
Catarina_Apples: folds
Hero: folds
Larue_Tat Soi: folds
Vito_Carrots: calls 1200 
Kirby_Plantain: calls 1200 
*** FLOP *** [As 4d 3h]
Vito_Carrots: checks
Kirby_Plantain: checks
Kathi_Marionberry: bets 1961 
Vito_Carrots: calls 1961 
Kirby_Plantain: calls 1961 
*** TURN *** [As 4d 3h] [6c]
Vito_Carrots: checks
Kirby_Plantain: bets 400 
Kathi_Marionberry: folds
Vito_Carrots: raises 2400 to 2400
Kirby_Plantain: calls 2000 
*** RIVER *** [As 4d 3h 6c] [9h]
Vito_Carrots: bets 2084 and is all-in
Kirby_Plantain: folds
Uncalled bet (2084) returned to Vito_Carrots
Vito_Carrots: doesn't show hand
Vito_Carrots collected 16443 from pot
*** SUMMARY ***
Total pot 16443 | Rake 0
Board [As 4d 3h 6c 9h]
Seat 1: Julio_Elderberry mucked [7s Qd]
Seat 2: Catarina_Apples (button) mucked [5s 2d]
Seat 3: Hero (small blind) mucked [8c Kh]
Seat 4: Larue_Tat Soi (big blind) mucked [3c Kc]
Seat 5: Vito_Carrots showed [6d 6s] and won (16443)
Seat 6: Kirby_Plantain mucked [Qh 5h]
Seat 7: Meghan_Plum mucked [6h 7c]
Seat 8: Kathi_Marionberry mucked [Kd Jd]
Seat 9: Leeann_Honeyberry mucked [Qc 7h]



PokerStars Hand #3661314035: Tournament #21391319, $20+$2 - Hold'em No Limit (200/400) - 2018/04/06 23:26:02
Table '#18' Seat #3 is the button
Seat 1: Adolph_Radish (16,890 in chips)
Seat 2: Theola_Beans (9,315 in chips)
Seat 3: Hero (21,900 in chips)
Seat 4: Lala_Jujube (11,210 in chips)
Seat 5: Isidro_Arugula (18,527 in chips)
Seat 6: Keven_Arugula (3,919 in chips)
Seat 7: Isa_Cauliflower (11,280 in chips)
Seat 8: Sheryl_Bok Choy (27,852 in chips)
Seat 9: Bryan_Dill (12,010 in chips)
Adolph_Radish: posts the ante 40
Theola_Beans: posts the ante 40
Hero: posts the ante 40
Lala_Jujube: posts the ante 40
Isidro_Arugula: posts the ante 40
Keven_Arugula: posts the ante 40
Isa_Cauliflower: posts the ante 40
Sheryl_Bok Choy: posts the ante 40
Bryan_Dill: posts the ante 40
Lala_Jujube: posts small blind 200
Isidro_Arugula: posts big blind 400
*** HOLE CARDS ***
Dealt to Hero [3d As]
Keven_Arugula: folds
Isa_Cauliflower: calls 400 
Sheryl_Bok Choy: folds
Bryan_Dill: folds
Adolph_Radish: folds
Theola_Beans: folds
Hero: folds
Lala_Jujube: calls 200 
Isidro_Arugula: checks
*** FLOP *** [4h 4s Qc]
Lala_Jujube: checks
Isidro_Arugula: checks
Isa_Cauliflower: bets 1560 
Lala_Jujube: folds
Isidro_Arugula: folds
Uncalled bet (1560) returned to Isa_Cauliflower
Isa_Cauliflower: doesn't show hand
Isa_Cauliflower collected 1560 from pot
*** SUMMARY ***
Total pot 1560 | Rake 0
Board [4h 4s Qc]
Seat 1: Adolph_Radish mucked [8h 3h]
Seat 2: Theola_Beans mucked [Ah 7s]
Seat 3: Hero (button) mucked [3d As]
Seat 4: Lala_Jujube (small blind) mucked [Ks 5d]
Seat 5: Isidro_Arugula (big blind) mucked [Th 2h]
Seat 6: Keven_Arugula mucked [4c Jd]
Seat 7: Isa_Cauliflower showed [Tc Qs] and won (1560)
Seat 8: Sheryl_Bok Choy mucked [5s Ad]
Seat 9: Bryan_Dill mucked [3c Kd]



PokerStars Hand #3661315176: Tournament #21391319, $20+$2 - Hold'em No Limit (200/400) - 2018/04/06 23:27:44
Table '#18' Seat #3 is the button
Seat 1: Darin_Daikon (16,850 in chips)
Seat 2: Hero (21,860 in chips)
Seat 3: Joya_Bananas (10,770 in chips)
Seat 4: Bernarda_Cucumber (18,087 in chips)
Seat 5: Nada_Sage (3,879 in chips)
Seat 6: Kathi_Quinoa (12,400 in chips)
Seat 7: Lynette_Alfalfa (27,812 in chips)
Seat 8: Jean_Strawberry (11,970 in chips)
Darin_Daikon: posts the ante 40
Hero: posts the ante 40
Joya_Bananas: posts the ante 40
Bernarda_Cucumber: posts the ante 40
Nada_Sage: posts the ante 40
Kathi_Quinoa: posts the ante 40
Lynette_Alfalfa: posts the ante 40
Jean_Strawberry: posts the ante 40
Bernarda_Cucumber: posts small blind 200
Nada_Sage: posts big blind 400
*** HOLE CARDS ***
Dealt to Hero [Ad Tc]
Kathi_Quinoa: folds
Lynette_Alfalfa: folds
Jean_Strawberry: folds
Darin_Daikon: calls 400 
Hero: calls 400 
Joya_Bananas: calls 400 
Bernarda_Cucumber: folds
Nada_Sage: raises 3439 to 3839 and is all-in
Darin_Daikon: calls 3439 
Hero: folds
Joya_Bananas: folds
*** FLOP *** [6s Td Qs]
*** TURN *** [6s Td Qs] [8d]
*** RIVER *** [6s Td Qs 8d] [6d]
*** SHOW DOWN ***
Darin_Daikon: shows [9c 9d] (two pair, Nines and Sixes)
Nada_Sage: shows [6c Ah] (three of a kind, Sixes)
Nada_Sage collected 8998 from pot
*** SUMMARY ***
Total pot 8998 | Rake 0
Board [6s Td Qs 8d 6d]
Seat 1: Darin_Daikon showed [9c 9d] and lost with two pair, Nines and Sixes
Seat 2: Hero mucked [Ad Tc]
Seat 3: Joya_Bananas (button) mucked [Qh Kc]
Seat 4: Bernarda_Cucumber (small blind) mucked [Th 2d]
Seat 5: Nada_Sage (big blind) showed [6c Ah] and won (8998) with three of a kind, Sixes
Seat 6: Kathi_Quinoa mucked [2h 3s]
Seat 7: Lynette_Alfalfa mucked [8s 9s]
Seat 8: Jean_Strawberry mucked [4s Qd]



PokerStars Hand #3661316172: Tournament #21391319, $20+$2 - Hold'em No Limit (200/400) - 2018/04/06 23:29:17
Table '#18' Seat #5 is the button
Seat 1: Laura_Shallot (12,971 in chips)
Seat 2: Shanae_Eggplants (10,000 in chips)
Seat 3: Hero (21,420 in chips)
Seat 4: Otha_Rambutan (10,330 in chips)
Seat 5: Vinnie_Carrots (17,847 in chips)
Seat 6: Johnnie_Eggplants (8,998 in chips)
Seat 7: Laverne_Kohlrabi (12,360 in chips)
Seat 8: Katherine_Goji (27,772 in chips)
Seat 9: Marry_Broccoli (11,930 in chips)
Laura_Shallot: posts the ante 40
Shanae_Eggplants: posts the ante 40
Hero: posts the ante 40
Otha_Rambutan: posts the ante 40
Vinnie_Carrots: posts the ante 40
Johnnie_Eggplants: posts the ante 40
Laverne_Kohlrabi: posts the ante 40
Katherine_Goji: posts the ante 40
Marry_Broccoli: posts the ante 40
Johnnie_Eggplants: posts small blind 200
Laverne_Kohlrabi: posts big blind 400
*** HOLE CARDS ***
Dealt to Hero [Ks Ah]
Katherine_Goji: folds
Marry_Broccoli: folds
Laura_Shallot: folds
Shanae_Eggplants: folds
Hero: raises 999 to 999
Otha_Rambutan: folds
Vinnie_Carrots: calls 999 
Johnnie_Eggplants: calls 799 
Laverne_Kohlrabi: calls 599 
*** FLOP *** [Th Qd Kh]
Johnnie_Eggplants: checks
Laverne_Kohlrabi: checks
Hero: checks
Vinnie_Carrots: checks
*** TURN *** [Th Qd Kh] [8s]
Johnnie_Eggplants: bets 400 
Laverne_Kohlrabi: raises 1600 to 1600
Hero: calls 1600 
Vinnie_Carrots: folds
Johnnie_Eggplants: calls 1200 
*** RIVER *** [Th Qd Kh 8s] [Kc]
Johnnie_Eggplants: checks
Laverne_Kohlrabi: bets 9156 
Hero: calls 9156 
Johnnie_Eggplants: folds
*** SHOW DOWN ***
Laverne_Kohlrabi: shows [Jh 9c] (a straight, Nine to King)
Hero: Mucks [Ks Ah] (Three of a kind)
Laverne_Kohlrabi collected 27468 from pot
*** SUMMARY ***
Total pot 27468 | Rake 0
Board [Th Qd Kh 8s Kc]
Seat 1: Laura_Shallot mucked [3c As]
Seat 2: Shanae_Eggplants mucked [7s 4h]
Seat 3: Hero mucked [Ks Ah]
Seat 4: Otha_Rambutan mucked [6h Ac]
Seat 5: Vinnie_Carrots (button) mucked [5c 4c]
Seat 6: Johnnie_Eggplants (small blind) mucked [3s Ts]
Seat 7: Laverne_Kohlrabi (big blind) showed [Jh 9c] and won (27468) with a straight, Nine to King
Seat 8: Katherine_Goji mucked [2c 5s]
Seat 9: Marry_Broccoli mucked [Js 9h]



PokerStars Hand #3661317943: Tournament #21391319, $20+$2 - Hold'em No Limit (250/500) - 2018/04/06 23:31:56
Table '#18' Seat #6 is the button
Seat 1: Nicolas_Garlic (12,931 in chips)
Seat 2: Glenn_Papaya (9,960 in chips)
Seat 3: Hero (9,625 in chips)
Seat 4: Crista_Broccoli (10,290 in chips)
Seat 5: Sage_Tabasco (16,808 in chips)
Seat 6: Felipa_Basil (6,359 in chips)
Seat 7: Milly_Radish (28,033 in chips)
Seat 8: Angelena_Broccoli (27,732 in chips)
Seat 9: Mitchell_Jabuticaba (11,890 in chips)
Nicolas_Garlic: posts the ante 50
Glenn_Papaya: posts the ante 50
Hero: posts the ante 50
Crista_Broccoli: posts the ante 50
Sage_Tabasco: posts the ante 50
Felipa_Basil: posts the ante 50
Milly_Radish: posts the ante 50
Angelena_Broccoli: posts the ante 50
Mitchell_Jabuticaba: posts the ante 50
Milly_Radish: posts small blind 250
Angelena_Broccoli: posts big blind 500
*** HOLE CARDS ***
Dealt to Hero [Ad Ac]
Mitchell_Jabuticaba: folds
Nicolas_Garlic: folds
Glenn_Papaya: folds
Hero: raises 1222 to 1222
Crista_Broccoli: folds
Sage_Tabasco: folds
Felipa_Basil: calls 1222 
Milly_Radish: calls 972 
Angelena_Broccoli: folds
*** FLOP *** [4d 2d 6s]
Milly_Radish: checks
Hero: bets 2333 
Felipa_Basil: folds
Milly_Radish: folds
Uncalled bet (2333) returned to Hero
Hero: doesn't show hand
Hero collected 4616 from pot
*** SUMMARY ***
Total pot 4616 | Rake 0
Board [4d 2d 6s]
Seat 1: Nicolas_Garlic mucked [Qs 2c]
Seat 2: Glenn_Papaya mucked [7c 5d]
Seat 3: Hero showed [Ad Ac] and won (4616)
Seat 4: Crista_Broccoli mucked [3h 7s]
Seat 5: Sage_Tabasco mucked [3c Jh]
Seat 6: Felipa_Basil (button) mucked [8s Qd]
Seat 7: Milly_Radish (small blind) mucked [As Tc]
Seat 8: Angelena_Broccoli (big blind) mucked [3s 9d]
Seat 9: Mitchell_Jabuticaba mucked [4c Js]



PokerStars Hand #3661319421: Tournament #21391319, $20+$2 - Hold'em No Limit (250/500) - 2018/04/06 23:34:08
Table '#18' Seat #7 is the button
Seat 1: Shante_Parsley (12,881 in chips)
Seat 2: Voncile_Beets (9,910 in chips)
Seat 3: Hero (12,969 in chips)
Seat 4: Tashia_Garlic (10,240 in chips)
Seat 5: Yvonne_Rosemary (16,758 in chips)
Seat 6: Shane_Goji (5,087 in chips)
Seat 7: Nikole_Nettles (26,761 in chips)
Seat 8: Ludivina_Tamarillo (27,182 in chips)
Seat 9: Leon_Cranberry (11,840 in chips)
Shante_Parsley: posts the ante 50
Voncile_Beets: posts the ante 50
Hero: posts the ante 50
Tashia_Garlic: posts the ante 50
Yvonne_Rosemary: posts the ante 50
Shane_Goji: posts the ante 50
Nikole_Nettles: posts the ante 50
Ludivina_Tamarillo: posts the ante 50
Leon_Cranberry: posts the ante 50
Ludivina_Tamarillo: posts small blind 250
Leon_Cranberry: posts big blind 500
*** HOLE CARDS ***
Dealt to Hero [Ad Ts]
Shante_Parsley: calls 500 
Voncile_Beets: folds
Hero: folds
Tashia_Garlic: folds
Yvonne_Rosemary: folds
Shane_Goji: raises 1000 to 1000
Nikole_Nettles: folds
Ludivina_Tamarillo: folds
Leon_Cranberry: raises 2500 to 3000
Shante_Parsley: folds
Shane_Goji: calls 2000 
*** FLOP *** [4d Th Kd]
Leon_Cranberry: bets 7200 
Shane_Goji: bets 2037 and is all-in
*** TURN *** [4d Th Kd] [3s]
*** RIVER *** [4d Th Kd 3s] [7d]
*** SHOW DOWN ***
Shane_Goji: shows [Ks Qs] (a pair of Kings)
Leon_Cranberry: shows [3d 3c] (three of a kind, Threes)
Uncalled bet (5163) returned to Leon_Cranberry
Leon_Cranberry collected 11274 from pot
Shane_Goji finished the tournament in 157th place
*** SUMMARY ***
Total pot 11274 | Rake 0
Board [4d Th Kd 3s 7d]
Seat 1: Shante_Parsley mucked [Kc 2c]
Seat 2: Voncile_Beets mucked [Tc 4h]
Seat 3: Hero mucked [Ad Ts]
Seat 4: Tashia_Garlic mucked [6s 7c]
Seat 5: Yvonne_Rosemary mucked [Js 4c]
Seat 6: Shane_Goji showed [Ks Qs] and lost with a pair of Kings
Seat 7: Nikole_Nettles (button) mucked [Qc 9h]
Seat 8: Ludivina_Tamarillo (small blind) mucked [6h 5h]
Seat 9: Leon_Cranberry (big blind) showed [3d 3c] and won (11274) with three of a kind, Threes



PokerStars Hand #3661320640: Tournament #21391319, $20+$2 - Hold'em No Limit (250/500) - 2018/04/06 23:36:02
Table '#18' Seat #7 is the button
Seat 1: Miriam_Tangerine (12,331 in chips)
Seat 2: Brad_Honeydew (9,860 in chips)
Seat 3: Hero (12,919 in chips)
Seat 4: Amiee_Caraway (10,190 in chips)
Seat 5: Brianna_Sage (16,708 in chips)
Seat 6: Rashad_Cabbage (26,711 in chips)
Seat 7: Lesia_Tamarind (26,882 in chips)
Seat 8: Karen_Cilantro (18,027 in chips)
Miriam_Tangerine: posts the ante 50
Brad_Honeydew: posts the ante 50
Hero: posts the ante 50
Amiee_Caraway: posts the ante 50
Brianna_Sage: posts the ante 50
Rashad_Cabbage: posts the ante 50
Lesia_Tamarind: posts the ante 50
Karen_Cilantro: posts the ante 50
Karen_Cilantro: posts small blind 250
Miriam_Tangerine: posts big blind 500
*** HOLE CARDS ***
Dealt to Hero [3d 6d]
Brad_Honeydew: folds
Hero: folds
Amiee_Caraway: folds
Brianna_Sage: calls 500 
Rashad_Cabbage: folds
Lesia_Tamarind: folds
Karen_Cilantro: folds
Miriam_Tangerine: checks
*** FLOP *** [Js 8s 8c]
Miriam_Tangerine: checks
Brianna_Sage: checks
*** TURN *** [Js 8s 8c] [Th]
Miriam_Tangerine: checks
Brianna_Sage: bets 1351 
Miriam_Tangerine: folds
Uncalled bet (1351) returned to Brianna_Sage
Brianna_Sage: doesn't show hand
Brianna_Sage collected 1650 from pot
*** SUMMARY ***
Total pot 1650 | Rake 0
Board [Js 8s 8c Th]
Seat 1: Miriam_Tangerine (big blind) mucked [Kd 2s]
Seat 2: Brad_Honeydew mucked [Qs 5c]
Seat 3: Hero mucked [3d 6d]
Seat 4: Amiee_Caraway mucked [Td 2c]
Seat 5: Brianna_Sage showed [8d Ad] and won (1650)
Seat 6: Rashad_Cabbage mucked [9c 7d]
Seat 7: Lesia_Tamarind (button) mucked [Tc 3c]
Seat 8: Karen_Cilantro (small blind) mucked [3h 9d]



PokerStars Hand #3661321808: Tournament #21391319, $20+$2 - Hold'em No Limit (250/500) - 2018/04/06 23:37:50
Table '#18' Seat #8 is the button
Seat 1: Casandra_Chili (11,781 in chips)
Seat 2: Nickie_Grapes (9,810 in chips)
Seat 3: Hero (12,869 in chips)
Seat 4: Elida_Raspberry (10,140 in chips)
Seat 5: Majorie_Marionberry (17,808 in chips)
Seat 6: Lurlene_Dill (26,661 in chips)
Seat 7: Raelene_Passionfruit (26,832 in chips)
Seat 8: Lizzie_Onions (17,727 in chips)
Casandra_Chili: posts the ante 50
Nickie_Grapes: posts the ante 50
Hero: posts the ante 50
Elida_Raspberry: posts the ante 50
Majorie_Marionberry: posts the ante 50
Lurlene_Dill: posts the ante 50
Raelene_Passionfruit: posts the ante 50
Lizzie_Onions: posts the ante 50
Casandra_Chili: posts small blind 250
Nickie_Grapes: posts big blind 500
*** HOLE CARDS ***
Dealt to Hero [4h 6s]
Hero: folds
Elida_Raspberry: folds
Majorie_Marionberry: folds
Lurlene_Dill: calls 500 
Raelene_Passionfruit: raises 2650 to 2650
Lizzie_Onions: folds
Casandra_Chili: calls 2400 
Nickie_Grapes: folds
Lurlene_Dill: folds
*** FLOP *** [7s 4c 8s]
Casandra_Chili: bets 1200 
Raelene_Passionfruit: raises 10780 to 10780
Casandra_Chili: calls 7881 and is all-in
*** TURN *** [7s 4c 8s] [Qd]
*** RIVER *** [7s 4c 8s Qd] [2d]
*** SHOW DOWN ***
Casandra_Chili: shows [Ks Js] (high card King)
Raelene_Passionfruit: shows [8h Ah] (a pair of Eights)
Uncalled bet (1699) returned to Raelene_Passionfruit
Raelene_Passionfruit collected 24862 from pot
Casandra_Chili finished the tournament in 155th place
*** SUMMARY ***
Total pot 24862 | Rake 0
Board [7s 4c 8s Qd 2d]
Seat 1: Casandra_Chili (small blind) showed [Ks Js] and lost with high card King
Seat 2: Nickie_Grapes (big blind) mucked [7h Ac]
Seat 3: Hero mucked [4h 6s]
Seat 4: Elida_Raspberry mucked [Th 2s]
Seat 5: Majorie_Marionberry mucked [Kd 3c]
Seat 6: Lurlene_Dill mucked [As 9d]
Seat 7: Raelene_Passionfruit showed [8h Ah] and won (24862) with a pair of Eights
Seat 8: Lizzie_Onions (button) mucked [Ts 5c]



PokerStars Hand #3661322864: Tournament #21391319, $20+$2 - Hold'em No Limit (250/500) - 2018/04/06 23:39:26
Table '#18' Seat #1 is the button
Seat 1: Devora_Oregano (10,000 in chips)
Seat 2: Cathy_Rosemary (9,260 in chips)
Seat 3: Hero (12,819 in chips)
Seat 4: Janett_Honeyberry (10,090 in chips)
Seat 5: Octavio_Kiwi (17,758 in chips)
Seat 6: Charleen_Tangerine (26,111 in chips)
Seat 7: Elanor_Raisins (39,913 in chips)
Seat 8: Elayne_Lemon (17,677 in chips)
Devora_Oregano: posts the ante 50
Cathy_Rosemary: posts the ante 50
Hero: posts the ante 50
Janett_Honeyberry: posts the ante 50
Octavio_Kiwi: posts the ante 50
Charleen_Tangerine: posts the ante 50
Elanor_Raisins: posts the ante 50
Elayne_Lemon: posts the ante 50
Cathy_Rosemary: posts small blind 250
Hero: posts big blind 500
*** HOLE CARDS ***
Dealt to Hero [Qh 6c]
Janett_Honeyberry: folds
Octavio_Kiwi: calls 500 
Charleen_Tangerine: folds
Elanor_Raisins: folds
Elayne_Lemon: folds
Devora_Oregano: calls 500 
Cathy_Rosemary: raises 8960 to 9210 and is all-in
Hero: folds
Octavio_Kiwi: folds
Devora_Oregano: folds
Uncalled bet (8710) returned to Cathy_Rosemary
Cathy_Rosemary: doesn't show hand
Cathy_Rosemary collected 2400 from pot
*** SUMMARY ***
Total pot 2400 | Rake 0
Seat 1: Devora_Oregano (button) mucked [3d 3c]
Seat 2: Cathy_Rosemary (small blind) showed [5h Kh] and won (2400)
Seat 3: Hero (big blind) mucked [Qh 6c]
Seat 4: Janett_Honeyberry mucked [2d 6h]
Seat 5: Octavio_Kiwi mucked [Qc Js]
Seat 6: Charleen_Tangerine mucked [2s 5c]
Seat 7: Elanor_Raisins mucked [3h 9d]
Seat 8: Elayne_Lemon mucked [3s 6d]



PokerStars Hand #3661323928: Tournament #21391319, $20+$2 - Hold'em No Limit (250/500) - 2018/04/06 23:41:05
Table '#18' Seat #2 is the button
Seat 1: Yessenia_Mango (9,450 in chips)
Seat 2: Lorita_Salmonberry (11,110 in chips)
Seat 3: Hero (12,269 in chips)
Seat 4: Jamel_Cabbage (10,040 in chips)
Seat 5: Berniece_Arugula (17,208 in chips)
Seat 6: Agnes_Mango (26,061 in chips)
Seat 7: Veta_Watermelon (39,863 in chips)
Seat 8: Anette_Satsuma (17,627 in chips)
Yessenia_Mango: posts the ante 50
Lorita_Salmonberry: posts the ante 50
Hero: posts the ante 50
Jamel_Cabbage: posts the ante 50
Berniece_Arugula: posts the ante 50
Agnes_Mango: posts the ante 50
Veta_Watermelon: posts the ante 50
Anette_Satsuma: posts the ante 50
Hero: posts small blind 250
Jamel_Cabbage: posts big blind 500
*** HOLE CARDS ***
Dealt to Hero [2s Qs]
Berniece_Arugula: folds
Agnes_Mango: folds
Veta_Watermelon: folds
Anette_Satsuma: folds
Yessenia_Mango: folds
Lorita_Salmonberry: bets 11060 and is all-in
Hero: folds
Jamel_Cabbage: folds
Uncalled bet (10560) returned to Lorita_Salmonberry
Lorita_Salmonberry: doesn't show hand
Lorita_Salmonberry collected 1650 from pot
*** SUMMARY ***
Total pot 1650 | Rake 0
Seat 1: Yessenia_Mango mucked [9h Kd]
Seat 2: Lorita_Salmonberry (button) showed [6d Ah] and won (1650)
Seat 3: Hero (small blind) mucked [2s Qs]
Seat 4: Jamel_Cabbage (big blind) mucked [7s 3h]
Seat 5: Berniece_Arugula mucked [7c 8s]
Seat 6: Agnes_Mango mucked [6c 9c]
Seat 7: Veta_Watermelon mucked [Jh 8h]
Seat 8: Anette_Satsuma mucked [5d 8d]



PokerStars Hand #3661324554: Tournament #21391319, $20+$2 - Hold'em No Limit (300/600) - 2018/04/06 23:42:02
Table '#18' Seat #3 is the button
Seat 1: Cinthia_Skirret (9,400 in chips)
Seat 2: Lou_Tat Soi (12,210 in chips)
Seat 3: Hero (11,969 in chips)
Seat 4: Asia_Lentils (9,490 in chips)
Seat 5: Elayne_Shallot (17,158 in chips)
Seat 6: Alex_Chard (26,011 in chips)
Seat 7: Kathrin_Mango (39,813 in chips)
Seat 8: Clarine_Lettuce (17,577 in chips)
Cinthia_Skirret: posts the ante 60
Lou_Tat Soi: posts the ante 60
Hero: posts the ante 60
Asia_Lentils: posts the ante 60
Elayne_Shallot: posts the ante 60
Alex_Chard: posts the ante 60
Kathrin_Mango: posts the ante 60
Clarine_Lettuce: posts the ante 60
Asia_Lentils: posts small blind 300
Elayne_Shallot: posts big blind 600
*** HOLE CARDS ***
Dealt to Hero [Js 8h]
Alex_Chard: folds
Kathrin_Mango: folds
Clarine_Lettuce: folds
Cinthia_Skirret: folds
Lou_Tat Soi: folds
Hero: raises 1500 to 1500
Asia_Lentils: folds
Elayne_Shallot: calls 900 
*** FLOP *** [7c Ac 2d]
Elayne_Shallot: checks
Hero: bets 1900 
Elayne_Shallot: raises 9480 to 9480
Hero: folds
Uncalled bet (7580) returned to Elayne_Shallot
Elayne_Shallot: doesn't show hand
Elayne_Shallot collected 7580 from pot
*** SUMMARY ***
Total pot 7580 | Rake 0
Board [7c Ac 2d]
Seat 1: Cinthia_Skirret mucked [Qs Th]
Seat 2: Lou_Tat Soi mucked [8d 5h]
Seat 3: Hero (button) mucked [Js 8h]
Seat 4: Asia_Lentils (small blind) mucked [8c 3d]
Seat 5: Elayne_Shallot (big blind) showed [6c Qc] and won (7580)
Seat 6: Alex_Chard mucked [4h 6s]
Seat 7: Kathrin_Mango mucked [Qd 2c]
Seat 8: Clarine_Lettuce mucked [6h Jh]



PokerStars Hand #3661325232: Tournament #21391319, $20+$2 - Hold'em No Limit (300/600) - 2018/04/06 23:43:05
Table '#18' Seat #4 is the button
Seat 1: Jillian_Tangerine (9,340 in chips)
Seat 2: Janelle_Figs (12,150 in chips)
Seat 3: Hero (8,509 in chips)
Seat 4: Jerrod_Tamarillo (9,130 in chips)
Seat 5: Brittani_Plum (21,278 in chips)
Seat 6: Loreen_Honeydew (25,951 in chips)
Seat 7: Jani_Rosemary (39,753 in chips)
Seat 8: Zelda_Passionfruit (17,517 in chips)
Jillian_Tangerine: posts the ante 60
Janelle_Figs: posts the ante 60
Hero: posts the ante 60
Jerrod_Tamarillo: posts the ante 60
Brittani_Plum: posts the ante 60
Loreen_Honeydew: posts the ante 60
Jani_Rosemary: posts the ante 60
Zelda_Passionfruit: posts the ante 60
Brittani_Plum: posts small blind 300
Loreen_Honeydew: posts big blind 600
*** HOLE CARDS ***
Dealt to Hero [2s Ah]
Jani_Rosemary: folds
Zelda_Passionfruit: folds
Jillian_Tangerine: folds
Janelle_Figs: folds
Hero: folds
Jerrod_Tamarillo: folds
Brittani_Plum: folds
Loreen_Honeydew: doesn't show hand
Uncalled bet (600) returned to Loreen_Honeydew
Loreen_Honeydew collected 780 from pot
*** SUMMARY ***
Total pot 780 | Rake 0
Seat 1: Jillian_Tangerine mucked [6c 2h]
Seat 2: Janelle_Figs mucked [Qh 5h]
Seat 3: Hero mucked [2s Ah]
Seat 4: Jerrod_Tamarillo (button) mucked [5d 8h]
Seat 5: Brittani_Plum (small blind) mucked [5c 3d]
Seat 6: Loreen_Honeydew (big blind) showed [4h 8d] and won (780)
Seat 7: Jani_Rosemary mucked [Tc 7c]
Seat 8: Zelda_Passionfruit mucked [Jh 7s]



PokerStars Hand #3661325977: Tournament #21391319, $20+$2 - Hold'em No Limit (300/600) - 2018/04/06 23:44:14
Table '#18' Seat #5 is the button
Seat 1: Bobby_Melon (9,280 in chips)
Seat 2: Jarrett_Rosemary (12,090 in chips)
Seat 3: Hero (8,449 in chips)
Seat 4: Suellen_Avocados (9,070 in chips)
Seat 5: Alvin_Cucumber (20,918 in chips)
Seat 6: Rickie_Pinto (26,671 in chips)
Seat 7: Debby_Kale (39,693 in chips)
Seat 8: Kelle_Asparagus (17,457 in chips)
Bobby_Melon: posts the ante 60
Jarrett_Rosemary: posts the ante 60
Hero: posts the ante 60
Suellen_Avocados: posts the ante 60
Alvin_Cucumber: posts the ante 60
Rickie_Pinto: posts the ante 60
Debby_Kale: posts the ante 60
Kelle_Asparagus: posts the ante 60
Rickie_Pinto: posts small blind 300
Debby_Kale: posts big blind 600
*** HOLE CARDS ***
Dealt to Hero [6s 9c]
Kelle_Asparagus: folds
Bobby_Melon: folds
Jarrett_Rosemary: folds
Hero: folds
Suellen_Avocados: raises 2580 to 2580
Alvin_Cucumber: folds
Rickie_Pinto: raises 10860 to 11160
Debby_Kale: folds
Suellen_Avocados: calls 6430 and is all-in
*** FLOP *** [Qc 9s Jh]
*** TURN *** [Qc 9s Jh] [8h]
*** RIVER *** [Qc 9s Jh 8h] [7h]
*** SHOW DOWN ***
Suellen_Avocados: shows [Jc Jd] (three of a kind, Jacks)
Rickie_Pinto: shows [Ts As] (a straight, Eight to Queen)
Uncalled bet (2150) returned to Rickie_Pinto
Rickie_Pinto collected 19100 from pot
Suellen_Avocados finished the tournament in 148th place
*** SUMMARY ***
Total pot 19100 | Rake 0
Board [Qc 9s Jh 8h 7h]
Seat 1: Bobby_Melon mucked [7d Tc]
Seat 2: Jarrett_Rosemary mucked [Kh 4h]
Seat 3: Hero mucked [6s 9c]
Seat 4: Suellen_Avocados showed [Jc Jd] and lost with three of a kind, Jacks
Seat 5: Alvin_Cucumber (button) mucked [3h Kc]
Seat 6: Rickie_Pinto (small blind) showed [Ts As] and won (19100) with a straight, Eight to Queen
Seat 7: Debby_Kale (big blind) mucked [Ac 9h]
Seat 8: Kelle_Asparagus mucked [5c 8s]



PokerStars Hand #3661326713: Tournament #21391319, $20+$2 - Hold'em No Limit (300/600) - 2018/04/06 23:45:23
Table '#18' Seat #5 is the button
Seat 1: Kallie_Jicama (9,220 in chips)
Seat 2: Kay_Passionfruit (12,030 in chips)
Seat 3: Hero (8,389 in chips)
Seat 4: Jose_Peach (20,858 in chips)
Seat 5: Alona_Carrots (36,701 in chips)
Seat 6: Dewayne_Pears (39,033 in chips)
Seat 7: Dot_Chamomile (17,397 in chips)
Kallie_Jicama: posts the ante 60
Kay_Passionfruit: posts the ante 60
Hero: posts the ante 60
Jose_Peach: posts the ante 60
Alona_Carrots: posts the ante 60
Dewayne_Pears: posts the ante 60
Dot_Chamomile: posts the ante 60
Dewayne_Pears: posts small blind 300
Dot_Chamomile: posts big blind 600
*** HOLE CARDS ***
Dealt to Hero [9h 2c]
Kallie_Jicama: folds
Kay_Passionfruit: folds
Hero: folds
Jose_Peach: calls 600 
Alona_Carrots: folds
Dewayne_Pears: calls 300 
Dot_Chamomile: checks
*** FLOP *** [Ac 7c 3c]
Dewayne_Pears: checks
Dot_Chamomile: checks
Jose_Peach: checks
*** TURN *** [Ac 7c 3c] [Ah]
Dewayne_Pears: checks
Dot_Chamomile: checks
Jose_Peach: checks
*** RIVER *** [Ac 7c 3c Ah] [Jd]
Dewayne_Pears: checks
Dot_Chamomile: checks
Jose_Peach: checks
*** SHOW DOWN ***
Dewayne_Pears: shows [6s Ts] (a pair of Aces)
Dot_Chamomile: shows [3s 8c] (two pair, Aces and Threes)
Jose_Peach: Mucks [5h 6h] (One pair)
Dot_Chamomile collected 2220 from pot
*** SUMMARY ***
Total pot 2220 | Rake 0
Board [Ac 7c 3c Ah Jd]
Seat 1: Kallie_Jicama mucked [Kc 2s]
Seat 2: Kay_Passionfruit mucked [6d Qh]
Seat 3: Hero mucked [9h 2c]
Seat 4: Jose_Peach mucked [5h 6h]
Seat 5: Alona_Carrots (button) mucked [5d Qs]
Seat 6: Dewayne_Pears (small blind) showed [6s Ts] and lost with a pair of Aces
Seat 7: Dot_Chamomile (big blind) showed [3s 8c] and won (2220) with two pair, Aces and Threes



PokerStars Hand #3661327504: Tournament #21391319, $20+$2 - Hold'em No Limit (300/600) - 2018/04/06 23:46:35
Table '#18' Seat #7 is the button
Seat 1: Yen_Pears (9,160 in chips)
Seat 2: Jefferey_Rutabaga (11,970 in chips)
Seat 3: Hero (8,329 in chips)
Seat 4: Lavenia_Okra (10,000 in chips)
Seat 5: Lizette_Thyme (20,198 in chips)
Seat 6: Krystin_Shallot (36,641 in chips)
Seat 7: Halley_Celeriac (38,373 in chips)
Seat 8: Shasta_Alfalfa (18,957 in chips)
Yen_Pears: posts the ante 60
Jefferey_Rutabaga: posts the ante 60
Hero: posts the ante 60
Lavenia_Okra: posts the ante 60
Lizette_Thyme: posts the ante 60
Krystin_Shallot: posts the ante 60
Halley_Celeriac: posts the ante 60
Shasta_Alfalfa: posts the ante 60
Shasta_Alfalfa: posts small blind 300
Yen_Pears: posts big blind 600
*** HOLE CARDS ***
Dealt to Hero [3s 5s]
Jefferey_Rutabaga: folds
Hero: folds
Lavenia_Okra: folds
Lizette_Thyme: folds
Krystin_Shallot: calls 600 
Halley_Celeriac: raises 3011 to 3011
Shasta_Alfalfa: folds
Yen_Pears: folds
Krystin_Shallot: folds
Uncalled bet (2411) returned to Halley_Celeriac
Halley_Celeriac: doesn't show hand
Halley_Celeriac collected 2580 from pot
*** SUMMARY ***
Total pot 2580 | Rake 0
Seat 1: Yen_Pears (big blind) mucked [Td 9s]
Seat 2: Jefferey_Rutabaga mucked [Js Qd]
Seat 3: Hero mucked [3s 5s]
Seat 4: Lavenia_Okra mucked [2s Tc]
Seat 5: Lizette_Thyme mucked [4d Ah]
Seat 6: Krystin_Shallot mucked [7s Qs]
Seat 7: Halley_Celeriac (button) showed [Qh Jh] and won (2580)
Seat 8: Shasta_Alfalfa (small blind) mucked [2c 5c]



PokerStars Hand #3661328383: Tournament #21391319, $20+$2 - Hold'em No Limit (300/600) - 2018/04/06 23:47:59
Table '#18' Seat #9 is the button
Seat 1: Alfonso_Jackfruit (8,500 in chips)
Seat 2: Danika_Pears (11,910 in chips)
Seat 3: Hero (8,269 in chips)
Seat 4: Sol_Apricots (9,940 in chips)
Seat 5: Francesco_Redcurrant (20,138 in chips)
Seat 6: Lia_Grapefruit (10,000 in chips)
Seat 7: Arnetta_Boysenberry (35,981 in chips)
Seat 8: Shizuko_Topinambur (40,293 in chips)
Seat 9: Shakita_Topinambur (18,597 in chips)
Alfonso_Jackfruit: posts the ante 60
Danika_Pears: posts the ante 60
Hero: posts the ante 60
Sol_Apricots: posts the ante 60
Francesco_Redcurrant: posts the ante 60
Lia_Grapefruit: posts the ante 60
Arnetta_Boysenberry: posts the ante 60
Shizuko_Topinambur: posts the ante 60
Shakita_Topinambur: posts the ante 60
Alfonso_Jackfruit: posts small blind 300
Danika_Pears: posts big blind 600
*** HOLE CARDS ***
Dealt to Hero [Qh 9h]
Hero: bets 8209 and is all-in
Sol_Apricots: folds
Francesco_Redcurrant: folds
Lia_Grapefruit: folds
Arnetta_Boysenberry: folds
Shizuko_Topinambur: calls 8209 
Shakita_Topinambur: folds
Alfonso_Jackfruit: folds
Danika_Pears: folds
*** FLOP *** [3s 2s Ah]
*** TURN *** [3s 2s Ah] [8s]
*** RIVER *** [3s 2s Ah 8s] [8d]
*** SHOW DOWN ***
Hero: shows [Qh 9h] (a pair of Eights)
Shizuko_Topinambur: shows [Ac Ad] (a full house, Aces full of Eights)
Shizuko_Topinambur collected 17858 from pot
Hero finished the tournament in 139th place
*** SUMMARY ***
Total pot 17858 | Rake 0
Board [3s 2s Ah 8s 8d]
Seat 1: Alfonso_Jackfruit (small blind) mucked [Th 5h]
Seat 2: Danika_Pears (big blind) mucked [Kc 5s]
Seat 3: Hero showed [Qh 9h] and lost with a pair of Eights
Seat 4: Sol_Apricots mucked [Tc Kh]
Seat 5: Francesco_Redcurrant mucked [2d 7d]
Seat 6: Lia_Grapefruit mucked [6s 3c]
Seat 7: Arnetta_Boysenberry mucked [Ks 9s]
Seat 8: Shizuko_Topinambur showed [Ac Ad] and won (17858) with a full house, Aces full of Eights
Seat 9: Shakita_Topinambur (button) mucked [4h Qc]




