PokerStars Hand #3591328376: Hold'em No Limit ($0.05/$0.10) - 2018/04/11 2:46:54
Table '#14913699' 6-max Seat #1 is the button
Seat 1: Player_bf611161 ($18.55 in chips)
Seat 2: Player_50616259 ($25.89 in chips)
Seat 3: Player_acb02231 ($2.90 in chips)
Seat 4: Player_d7d71537 ($10.88 in chips)
Seat 5: Hero ($10 in chips)
Seat 6: Player_bab21225 ($11.90 in chips)
Player_50616259: posts small blind $0.05
Player_acb02231: posts big blind $0.10
Hero: posts big blind $0.10
*** HOLE CARDS ***
Dealt to Hero [3d 2h]
Player_d7d71537: calls $0.10 
Hero: checks
Player_bab21225: calls $0.10 
Player_bf611161: raises $0.10 to $0.20
Player_50616259: calls $0.15 
Player_acb02231: calls $0.10 
Player_d7d71537: calls $0.10 
Hero: calls $0.10 
Player_bab21225: calls $0.10 
*** FLOP *** [Th As 3s]
Player_50616259: checks
Player_acb02231: checks
Player_d7d71537: checks
Hero: checks
Player_bab21225: checks
Player_bf611161: bets $0.20 
Player_50616259: folds
Player_acb02231: folds
Player_d7d71537: folds
Hero: calls $0.20 
Player_bab21225: folds
*** TURN *** [Th As 3s] [4s]
Hero: checks
Player_bf611161: bets $0.30 
Hero: calls $0.30 
*** RIVER *** [Th As 3s 4s] [Qd]
Hero: checks
Player_bf611161: checks
*** SHOW DOWN ***
Hero: shows [3d 2h] (a pair of Threes)
Player_bf611161: shows [Qs Jh] (a pair of Queens)
Player_bf611161 collected $2.09 from pot
*** SUMMARY ***
Total pot $2.20 | Rake $0.11
Board [Th As 3s 4s Qd]
Seat 1: Player_bf611161 (button) showed [Qs Jh] and won ($2.09) with a pair of Queens
Seat 2: Player_50616259 (small blind) mucked
Seat 3: Player_acb02231 (big blind) mucked
Seat 4: Player_d7d71537 mucked
Seat 5: Hero showed [3d 2h] and lost with a pair of Threes
Seat 6: Player_bab21225 mucked



PokerStars Hand #3591328733: Hold'em No Limit ($0.05/$0.10) - 2018/04/11 2:48:09
Table '#14913699' 6-max Seat #2 is the button
Seat 1: Player_b2be8dad ($19.94 in chips)
Seat 2: Player_efd36ae4 ($25.69 in chips)
Seat 3: Player_51b23733 ($2.70 in chips)
Seat 4: Player_530d66cf ($10.68 in chips)
Seat 5: Hero ($9.30 in chips)
Seat 6: Player_eaca26d8 ($11.70 in chips)
Player_51b23733: posts small blind $0.05
Player_530d66cf: posts big blind $0.10
*** HOLE CARDS ***
Dealt to Hero [Th Js]
Hero: folds
Player_eaca26d8: raises $0.20 to $0.30
Player_b2be8dad: folds
Player_efd36ae4: folds
Player_51b23733: calls $0.25 
Player_530d66cf: folds
*** FLOP *** [Qd 6s Ah]
Player_51b23733: checks
Player_eaca26d8: bets $0.30 
Player_51b23733: folds
Uncalled bet ($0.30) returned to Player_eaca26d8
Player_eaca26d8: doesn't show hand
Player_eaca26d8 collected $0.67 from pot
*** SUMMARY ***
Total pot $0.70 | Rake $0.03
Board [Qd 6s Ah]
Seat 1: Player_b2be8dad mucked
Seat 2: Player_efd36ae4 (button) mucked
Seat 3: Player_51b23733 (small blind) mucked
Seat 4: Player_530d66cf (big blind) mucked
Seat 5: Hero mucked
Seat 6: Player_eaca26d8 won ($0.67)



PokerStars Hand #3591328926: Hold'em No Limit ($0.05/$0.10) - 2018/04/11 2:48:49
Table '#14913699' 6-max Seat #3 is the button
Seat 1: Player_e967d399 ($19.94 in chips)
Seat 2: Player_4b192756 ($25.69 in chips)
Seat 3: Player_d3292c11 ($2.40 in chips)
Seat 4: Player_429040e7 ($10.58 in chips)
Seat 5: Hero ($9.30 in chips)
Seat 6: Player_8672f05b ($12.07 in chips)
Player_429040e7: posts small blind $0.05
Hero: posts big blind $0.10
*** HOLE CARDS ***
Dealt to Hero [3h 5d]
Player_8672f05b: raises $0.20 to $0.30
Player_e967d399: folds
Player_4b192756: folds
Player_d3292c11: folds
Player_429040e7: folds
Hero: calls $0.20 
*** FLOP *** [7s 6s 3c]
Hero: checks
Player_8672f05b: checks
*** TURN *** [7s 6s 3c] [2h]
Hero: bets $0.40 
Player_8672f05b: calls $0.40 
*** RIVER *** [7s 6s 3c 2h] [Kh]
Hero: checks
Player_8672f05b: bets $0.70 
Hero: calls $0.70 
*** SHOW DOWN ***
Player_8672f05b: shows [Kd Jd] (a pair of Kings)
Hero: Mucks [3h 5d] (One pair)
Player_8672f05b collected $2.71 from pot
*** SUMMARY ***
Total pot $2.85 | Rake $0.14
Board [7s 6s 3c 2h Kh]
Seat 1: Player_e967d399 mucked
Seat 2: Player_4b192756 mucked
Seat 3: Player_d3292c11 (button) mucked
Seat 4: Player_429040e7 (small blind) mucked
Seat 5: Hero (big blind) mucked [3h 5d]
Seat 6: Player_8672f05b showed [Kd Jd] and won ($2.71) with a pair of Kings



PokerStars Hand #3591329226: Hold'em No Limit ($0.05/$0.10) - 2018/04/11 2:49:54
Table '#14913699' 6-max Seat #4 is the button
Seat 1: Player_b1fa94ba ($19.94 in chips)
Seat 2: Player_88e3d27b ($25.69 in chips)
Seat 3: Player_3034e97d ($2.40 in chips)
Seat 4: Player_765909c8 ($10.53 in chips)
Seat 5: Hero ($7.90 in chips)
Seat 6: Player_ffe27620 ($13.38 in chips)
Hero: posts small blind $0.05
Player_ffe27620: posts big blind $0.10
*** HOLE CARDS ***
Dealt to Hero [Tc 5s]
Player_b1fa94ba: folds
Player_88e3d27b: raises $0.20 to $0.30
Player_3034e97d: calls $0.30 
Player_765909c8: folds
Hero: folds
Player_ffe27620: folds
*** FLOP *** [Jc 8c Kd]
Player_88e3d27b: bets $0.37 
Player_3034e97d: calls $0.37 
*** TURN *** [Jc 8c Kd] [Qs]
Player_88e3d27b: bets $0.74 
Player_3034e97d: calls $0.74 
*** RIVER *** [Jc 8c Kd Qs] [2h]
Player_88e3d27b: checks
Player_3034e97d: checks
*** SHOW DOWN ***
Player_88e3d27b: shows [Ac Ks] (a pair of Kings)
Player_3034e97d: Mucks [Js Ts] (One pair)
Player_88e3d27b collected $2.83 from pot
*** SUMMARY ***
Total pot $2.97 | Rake $0.14
Board [Jc 8c Kd Qs 2h]
Seat 1: Player_b1fa94ba mucked
Seat 2: Player_88e3d27b showed [Ac Ks] and won ($2.83) with a pair of Kings
Seat 3: Player_3034e97d mucked [Js Ts]
Seat 4: Player_765909c8 (button) mucked
Seat 5: Hero (small blind) mucked
Seat 6: Player_ffe27620 (big blind) mucked



PokerStars Hand #3591329548: Hold'em No Limit ($0.05/$0.10) - 2018/04/11 2:51:02
Table '#14913699' 6-max Seat #5 is the button
Seat 1: Player_2e7096bd ($19.94 in chips)
Seat 2: Player_9ef02182 ($27.11 in chips)
Seat 3: Player_1ac7e71a ($0.99 in chips)
Seat 4: Player_cb178c44 ($10.53 in chips)
Seat 5: Hero ($7.85 in chips)
Seat 6: Player_b8527fbb ($13.28 in chips)
Player_b8527fbb: posts small blind $0.05
Player_2e7096bd: posts big blind $0.10
*** HOLE CARDS ***
Dealt to Hero [5s 7h]
Player_9ef02182: folds
Player_1ac7e71a: folds
Player_cb178c44: calls $0.10 
Hero: folds
Player_b8527fbb: folds
Player_2e7096bd: checks
*** FLOP *** [5h Kh 2s]
Player_2e7096bd: bets $0.10 
Player_cb178c44: folds
Uncalled bet ($0.10) returned to Player_2e7096bd
Player_2e7096bd: doesn't show hand
Player_2e7096bd collected $0.24 from pot
*** SUMMARY ***
Total pot $0.25 | Rake $0.01
Board [5h Kh 2s]
Seat 1: Player_2e7096bd (big blind) won ($0.24)
Seat 2: Player_9ef02182 mucked
Seat 3: Player_1ac7e71a mucked
Seat 4: Player_cb178c44 mucked
Seat 5: Hero (button) mucked
Seat 6: Player_b8527fbb (small blind) mucked



PokerStars Hand #3591329694: Hold'em No Limit ($0.05/$0.10) - 2018/04/11 2:51:34
Table '#14913699' 6-max Seat #6 is the button
Seat 1: Player_7c8aeef4 ($20.08 in chips)
Seat 2: Player_8b5f27e9 ($27.11 in chips)
Seat 3: Player_f6539aff ($0.99 in chips)
Seat 4: Player_430e6ca0 ($10.43 in chips)
Seat 5: Hero ($7.85 in chips)
Seat 6: Player_88cbeb48 ($13.23 in chips)
Player_7c8aeef4: posts small blind $0.05
Player_8b5f27e9: posts big blind $0.10
*** HOLE CARDS ***
Dealt to Hero [Qd 3c]
Player_f6539aff: raises $0.89 to $0.99 and is all-in
Player_430e6ca0: folds
Hero: folds
Player_88cbeb48: folds
Player_7c8aeef4: folds
Player_8b5f27e9: calls $0.89 
*** FLOP *** [3h 6c Js]
*** TURN *** [3h 6c Js] [Qs]
*** RIVER *** [3h 6c Js Qs] [9s]
*** SHOW DOWN ***
Player_8b5f27e9: shows [3d 7h] (a pair of Threes)
Player_f6539aff: shows [Jh Jd] (three of a kind, Jacks)
Player_f6539aff collected $1.93 from pot
*** SUMMARY ***
Total pot $2.03 | Rake $0.10
Board [3h 6c Js Qs 9s]
Seat 1: Player_7c8aeef4 (small blind) mucked
Seat 2: Player_8b5f27e9 (big blind) showed [3d 7h] and lost with a pair of Threes
Seat 3: Player_f6539aff showed [Jh Jd] and won ($1.93) with three of a kind, Jacks
Seat 4: Player_430e6ca0 mucked
Seat 5: Hero mucked
Seat 6: Player_88cbeb48 (button) mucked



PokerStars Hand #3591329853: Hold'em No Limit ($0.05/$0.10) - 2018/04/11 2:52:03
Table '#14913699' 6-max Seat #6 is the button
Seat 2: Player_0bc0f00f ($26.12 in chips)
Seat 3: Player_4a5c3d2e ($1.93 in chips)
Seat 4: Player_8a9decaa ($10.43 in chips)
Seat 5: Hero ($7.85 in chips)
Seat 6: Player_d1e7529b ($13.23 in chips)
Player_0bc0f00f: posts small blind $0.05
Player_4a5c3d2e: posts big blind $0.10
*** HOLE CARDS ***
Dealt to Hero [4d Qd]
Player_8a9decaa: folds
Hero: folds
Player_d1e7529b: folds
Player_0bc0f00f: raises $0.20 to $0.30
Player_4a5c3d2e: folds
Uncalled bet ($0.20) returned to Player_0bc0f00f
Player_0bc0f00f: doesn't show hand
Player_0bc0f00f collected $0.20 from pot
*** SUMMARY ***
Total pot $0.20
Seat 2: Player_0bc0f00f (small blind) won ($0.20)
Seat 3: Player_4a5c3d2e (big blind) mucked
Seat 4: Player_8a9decaa mucked
Seat 5: Hero mucked
Seat 6: Player_d1e7529b mucked



PokerStars Hand #3591329970: Hold'em No Limit ($0.05/$0.10) - 2018/04/11 2:52:27
Table '#14913699' 6-max Seat #2 is the button
Seat 2: Player_4f383edb ($26.22 in chips)
Seat 3: Player_2d36a973 ($1.83 in chips)
Seat 4: Player_8ab03c8a ($10.43 in chips)
Seat 5: Hero ($7.85 in chips)
Seat 6: Player_75dcf5b7 ($13.23 in chips)
Player_2d36a973: posts small blind $0.05
Player_8ab03c8a: posts big blind $0.10
*** HOLE CARDS ***
Dealt to Hero [4d 4s]
Seat sit down
Hero: raises $0.20 to $0.30
Player_75dcf5b7: calls $0.30 
Player_4f383edb: folds
Player_2d36a973: folds
Player_8ab03c8a: calls $0.20 
*** FLOP *** [7s Ac 5d]
Player_8ab03c8a: checks
Hero: bets $0.60 
Player_75dcf5b7: folds
Player_8ab03c8a: folds
Uncalled bet ($0.60) returned to Hero
Hero: doesn't show hand
Hero collected $0.91 from pot
*** SUMMARY ***
Total pot $0.95 | Rake $0.04
Board [7s Ac 5d]
Seat 2: Player_4f383edb (button) mucked
Seat 3: Player_2d36a973 (small blind) mucked
Seat 4: Player_8ab03c8a (big blind) mucked
Seat 5: Hero won ($0.91)
Seat 6: Player_75dcf5b7 mucked



PokerStars Hand #3591330243: Hold'em No Limit ($0.05/$0.10) - 2018/04/11 2:53:25
Table '#14913699' 6-max Seat #3 is the button
Seat 2: Player_dad4a67e ($26.22 in chips)
Seat 3: Player_b0b7c65d ($1.78 in chips)
Seat 4: Player_52cff40c ($10.13 in chips)
Seat 5: Hero ($8.46 in chips)
Seat 6: Player_b7b27281 ($12.93 in chips)
Player_52cff40c: posts small blind $0.05
Hero: posts big blind $0.10
*** HOLE CARDS ***
Dealt to Hero [7s 2s]
Player_b7b27281: raises $0.20 to $0.30
Player_dad4a67e: folds
Player_b0b7c65d: calls $0.30 
Player_52cff40c: folds
Hero: folds
*** FLOP *** [3c 8d 8c]
Player_b7b27281: checks
Player_b0b7c65d: checks
*** TURN *** [3c 8d 8c] [8s]
Player_b7b27281: checks
Player_b0b7c65d: checks
*** RIVER *** [3c 8d 8c 8s] [9h]
Player_b7b27281: checks
Player_b0b7c65d: checks
*** SHOW DOWN ***
Player_b7b27281: shows [Ts Ks] (three of a kind, Eights)
Player_b0b7c65d: Mucks [Qh Jd] (Three of a kind)
Player_b7b27281 collected $0.72 from pot
*** SUMMARY ***
Total pot $0.75 | Rake $0.03
Board [3c 8d 8c 8s 9h]
Seat 2: Player_dad4a67e mucked
Seat 3: Player_b0b7c65d (button) mucked [Qh Jd]
Seat 4: Player_52cff40c (small blind) mucked
Seat 5: Hero (big blind) mucked
Seat 6: Player_b7b27281 showed [Ts Ks] and won ($0.72) with three of a kind, Eights



PokerStars Hand #3591330647: Hold'em No Limit ($0.05/$0.10) - 2018/04/11 2:54:44
Table '#14913699' 6-max Seat #4 is the button
Seat 2: Player_ed1a9432 ($26.22 in chips)
Seat 3: Player_b40a7086 ($1.48 in chips)
Seat 4: Player_d2390034 ($10.08 in chips)
Seat 5: Hero ($8.36 in chips)
Seat 6: Player_62b861da ($13.35 in chips)
Hero: posts small blind $0.05
Player_62b861da: posts big blind $0.10
*** HOLE CARDS ***
Dealt to Hero [6c 3c]
Player_ed1a9432: folds
Player_b40a7086: folds
Player_d2390034: calls $0.10 
Hero: calls $0.05 
Player_62b861da: checks
*** FLOP *** [4d 6d Ks]
Hero: checks
Player_62b861da: checks
Player_d2390034: bets $0.30 
Hero: calls $0.30 
Player_62b861da: folds
*** TURN *** [4d 6d Ks] [Js]
Hero: checks
Player_d2390034: bets $0.90 
Hero: folds
Uncalled bet ($0.90) returned to Player_d2390034
Player_d2390034: doesn't show hand
Player_d2390034 collected $0.86 from pot
*** SUMMARY ***
Total pot $0.90 | Rake $0.04
Board [4d 6d Ks Js]
Seat 2: Player_ed1a9432 mucked
Seat 3: Player_b40a7086 mucked
Seat 4: Player_d2390034 (button) won ($0.86)
Seat 5: Hero (small blind) mucked
Seat 6: Player_62b861da (big blind) mucked



PokerStars Hand #3591330855: Hold'em No Limit ($0.05/$0.10) - 2018/04/11 2:55:26
Table '#14913699' 6-max Seat #5 is the button
Seat 1: Player_f11190d6 ($10 in chips)
Seat 2: Player_2025b21b ($26.22 in chips)
Seat 3: Player_6bee966a ($1.48 in chips)
Seat 4: Player_ad852e6f ($10.54 in chips)
Seat 5: Hero ($7.96 in chips)
Seat 6: Player_51fe9cc0 ($13.25 in chips)
Player_51fe9cc0: posts small blind $0.05
Player_f11190d6: posts big blind $0.10
*** HOLE CARDS ***
Dealt to Hero [Qh Qs]
Player_2025b21b: raises $0.20 to $0.30
Player_6bee966a: calls $0.30 
Player_ad852e6f: calls $0.30 
Hero: raises $1.20 to $1.50
Player_51fe9cc0: folds
Player_f11190d6: folds
Player_2025b21b: folds
Player_6bee966a: calls $1.18 and is all-in
Player_ad852e6f: folds
*** FLOP *** [Qc 6h 5h]
*** TURN *** [Qc 6h 5h] [3d]
*** RIVER *** [Qc 6h 5h 3d] [4d]
*** SHOW DOWN ***
Player_6bee966a: shows [Jh Th] (high card Queen)
Hero: shows [Qh Qs] (three of a kind, Queens)
Uncalled bet ($0.02) returned to Hero
Hero collected $3.53 from pot
*** SUMMARY ***
Total pot $3.71 | Rake $0.18
Board [Qc 6h 5h 3d 4d]
Seat 1: Player_f11190d6 (big blind) mucked
Seat 2: Player_2025b21b mucked
Seat 3: Player_6bee966a showed [Jh Th] and lost with high card Queen
Seat 4: Player_ad852e6f mucked
Seat 5: Hero (button) showed [Qh Qs] and won ($3.53) with three of a kind, Queens
Seat 6: Player_51fe9cc0 (small blind) mucked



PokerStars Hand #3591331157: Hold'em No Limit ($0.05/$0.10) - 2018/04/11 2:56:27
Table '#14913699' 6-max Seat #6 is the button
Seat 1: Player_e2f449a4 ($9.90 in chips)
Seat 2: Player_c6cc290e ($25.92 in chips)
Seat 4: Player_f5080526 ($10.24 in chips)
Seat 5: Hero ($10.01 in chips)
Seat 6: Player_1c1cd346 ($13.20 in chips)
Player_e2f449a4: posts small blind $0.05
Player_c6cc290e: posts big blind $0.10
*** HOLE CARDS ***
Dealt to Hero [Qd 6d]
Player_f5080526: folds
Hero: raises $0.20 to $0.30
Player_1c1cd346: folds
Player_e2f449a4: folds
Player_c6cc290e: calls $0.20 
*** FLOP *** [2d 9d 8c]
Player_c6cc290e: checks
Hero: bets $0.33 
Player_c6cc290e: calls $0.33 
*** TURN *** [2d 9d 8c] [4c]
Player_c6cc290e: checks
Hero: checks
*** RIVER *** [2d 9d 8c 4c] [Td]
Player_c6cc290e: checks
Hero: bets $1 
Player_c6cc290e: calls $1 
*** SHOW DOWN ***
Hero: shows [Qd 6d] (a flush, Queen high)
Player_c6cc290e: Mucks [Kh 9c] (One pair)
Hero collected $3.15 from pot
*** SUMMARY ***
Total pot $3.31 | Rake $0.16
Board [2d 9d 8c 4c Td]
Seat 1: Player_e2f449a4 (small blind) mucked
Seat 2: Player_c6cc290e (big blind) mucked [Kh 9c]
Seat 4: Player_f5080526 mucked
Seat 5: Hero showed [Qd 6d] and won ($3.15) with a flush, Queen high
Seat 6: Player_1c1cd346 (button) mucked



PokerStars Hand #3591331488: Hold'em No Limit ($0.05/$0.10) - 2018/04/11 2:57:36
Table '#14913699' 6-max Seat #1 is the button
Seat 1: Player_880446ac ($9.85 in chips)
Seat 2: Player_cb6297f1 ($24.29 in chips)
Seat 3: Player_3e55b99c ($5 in chips)
Seat 4: Player_61367506 ($10.24 in chips)
Seat 5: Hero ($11.53 in chips)
Seat 6: Player_8e49d07b ($13.20 in chips)
Player_cb6297f1: posts small blind $0.05
Player_3e55b99c: posts big blind $0.10
*** HOLE CARDS ***
Dealt to Hero [9d Ks]
Player_61367506: calls $0.10 
Hero: folds
Player_8e49d07b: raises $0.20 to $0.30
Player_880446ac: folds
Player_cb6297f1: calls $0.25 
Player_3e55b99c: folds
Player_61367506: calls $0.20 
*** FLOP *** [Js Qh Ts]
Player_cb6297f1: checks
Player_61367506: checks
Player_8e49d07b: checks
*** TURN *** [Js Qh Ts] [Qs]
Player_cb6297f1: checks
Player_61367506: bets $1 
Player_8e49d07b: calls $1 
Player_cb6297f1: folds
*** RIVER *** [Js Qh Ts Qs] [7c]
Player_61367506: bets $8.94 and is all-in
Player_8e49d07b: folds
Uncalled bet ($8.94) returned to Player_61367506
Player_61367506: doesn't show hand
Player_61367506 collected $2.85 from pot
*** SUMMARY ***
Total pot $3 | Rake $0.15
Board [Js Qh Ts Qs 7c]
Seat 1: Player_880446ac (button) mucked
Seat 2: Player_cb6297f1 (small blind) mucked
Seat 3: Player_3e55b99c (big blind) mucked
Seat 4: Player_61367506 won ($2.85)
Seat 5: Hero mucked
Seat 6: Player_8e49d07b mucked



PokerStars Hand #3591331872: Hold'em No Limit ($0.05/$0.10) - 2018/04/11 2:58:56
Table '#14913699' 6-max Seat #2 is the button
Seat 1: Player_a7a597f4 ($9.85 in chips)
Seat 2: Player_09778b05 ($23.99 in chips)
Seat 3: Player_32dce06b ($4.90 in chips)
Seat 4: Player_8613c4b3 ($11.79 in chips)
Seat 5: Hero ($11.53 in chips)
Seat 6: Player_9173a8c5 ($11.90 in chips)
Player_32dce06b: posts small blind $0.05
Player_8613c4b3: posts big blind $0.10
*** HOLE CARDS ***
Dealt to Hero [Kh Ks]
Hero: raises $0.20 to $0.30
Player_9173a8c5: calls $0.30 
Player_a7a597f4: folds
Player_09778b05: calls $0.30 
Player_32dce06b: folds
Player_8613c4b3: calls $0.20 
*** FLOP *** [Th 9h Qs]
Player_8613c4b3: checks
Hero: checks
Player_9173a8c5: checks
Player_09778b05: checks
*** TURN *** [Th 9h Qs] [4h]
Player_8613c4b3: checks
Hero: bets $1 
Player_9173a8c5: folds
Player_09778b05: folds
Player_8613c4b3: folds
Uncalled bet ($1) returned to Hero
Hero: doesn't show hand
Hero collected $1.19 from pot
*** SUMMARY ***
Total pot $1.25 | Rake $0.06
Board [Th 9h Qs 4h]
Seat 1: Player_a7a597f4 mucked
Seat 2: Player_09778b05 (button) mucked
Seat 3: Player_32dce06b (small blind) mucked
Seat 4: Player_8613c4b3 (big blind) mucked
Seat 5: Hero won ($1.19)
Seat 6: Player_9173a8c5 mucked



PokerStars Hand #3591332220: Hold'em No Limit ($0.05/$0.10) - 2018/04/11 3:00:03
Table '#14913699' 6-max Seat #3 is the button
Seat 1: Player_ac7511de ($9.85 in chips)
Seat 2: Player_d1fdd06b ($23.69 in chips)
Seat 3: Player_ba3d4173 ($4.85 in chips)
Seat 4: Player_e87f8ff0 ($11.49 in chips)
Seat 5: Hero ($12.42 in chips)
Seat 6: Player_506df68b ($11.60 in chips)
Player_e87f8ff0: posts small blind $0.05
Hero: posts big blind $0.10
*** HOLE CARDS ***
Dealt to Hero [2h 7s]
Player_506df68b: raises $0.20 to $0.30
Player_ac7511de: folds
Player_d1fdd06b: folds
Player_ba3d4173: folds
Player_e87f8ff0: calls $0.25 
Hero: folds
*** FLOP *** [4s Jc Qc]
Player_e87f8ff0: checks
Player_506df68b: bets $0.43 
Player_e87f8ff0: folds
Uncalled bet ($0.43) returned to Player_506df68b
Player_506df68b: doesn't show hand
Player_506df68b collected $0.67 from pot
*** SUMMARY ***
Total pot $0.70 | Rake $0.03
Board [4s Jc Qc]
Seat 1: Player_ac7511de mucked
Seat 2: Player_d1fdd06b mucked
Seat 3: Player_ba3d4173 (button) mucked
Seat 4: Player_e87f8ff0 (small blind) mucked
Seat 5: Hero (big blind) mucked
Seat 6: Player_506df68b won ($0.67)



PokerStars Hand #3591332411: Hold'em No Limit ($0.05/$0.10) - 2018/04/11 3:00:44
Table '#14913699' 6-max Seat #4 is the button
Seat 1: Player_cf30f861 ($9.85 in chips)
Seat 2: Player_a1f16827 ($23.69 in chips)
Seat 3: Player_2b2e762f ($4.85 in chips)
Seat 4: Player_c32be14d ($11.19 in chips)
Seat 5: Hero ($12.32 in chips)
Seat 6: Player_fbe1ffdf ($11.97 in chips)
Hero: posts small blind $0.05
Player_fbe1ffdf: posts big blind $0.10
*** HOLE CARDS ***
Dealt to Hero [6h 9h]
Player_cf30f861: raises $0.20 to $0.30
Player_a1f16827: folds
Player_2b2e762f: calls $0.30 
Player_c32be14d: folds
Hero: calls $0.25 
Player_fbe1ffdf: calls $0.20 
*** FLOP *** [5c 7d 5d]
Hero: checks
Player_fbe1ffdf: checks
Player_cf30f861: checks
Player_2b2e762f: checks
*** TURN *** [5c 7d 5d] [6d]
Hero: checks
Player_fbe1ffdf: checks
Player_cf30f861: bets $0.70 
Player_2b2e762f: folds
Hero: calls $0.70 
Player_fbe1ffdf: folds
*** RIVER *** [5c 7d 5d 6d] [Kh]
Hero: checks
Player_cf30f861: bets $1.50 
Hero: calls $1.50 
*** SHOW DOWN ***
Player_cf30f861: shows [Ad 2d] (a flush, Ace high)
Hero: Mucks [6h 9h] (Two pair)
Player_cf30f861 collected $5.32 from pot
*** SUMMARY ***
Total pot $5.60 | Rake $0.28
Board [5c 7d 5d 6d Kh]
Seat 1: Player_cf30f861 showed [Ad 2d] and won ($5.32) with a flush, Ace high
Seat 2: Player_a1f16827 mucked
Seat 3: Player_2b2e762f mucked
Seat 4: Player_c32be14d (button) mucked
Seat 5: Hero (small blind) mucked [6h 9h]
Seat 6: Player_fbe1ffdf (big blind) mucked



PokerStars Hand #3591332801: Hold'em No Limit ($0.05/$0.10) - 2018/04/11 3:02:05
Table '#14913699' 6-max Seat #5 is the button
Seat 1: Player_6e457a1e ($12.67 in chips)
Seat 2: Player_7c717856 ($23.69 in chips)
Seat 3: Player_5594c450 ($4.55 in chips)
Seat 4: Player_84507ee9 ($11.19 in chips)
Seat 5: Hero ($9.82 in chips)
Seat 6: Player_bae08790 ($11.67 in chips)
Player_bae08790: posts small blind $0.05
Player_6e457a1e: posts big blind $0.10
*** HOLE CARDS ***
Dealt to Hero [2d As]
Player_7c717856: raises $0.20 to $0.30
Player_5594c450: folds
Player_84507ee9: folds
Hero: folds
Player_bae08790: folds
Player_6e457a1e: folds
Uncalled bet ($0.20) returned to Player_7c717856
Player_7c717856: doesn't show hand
Player_7c717856 collected $0.25 from pot
*** SUMMARY ***
Total pot $0.25
Seat 1: Player_6e457a1e (big blind) mucked
Seat 2: Player_7c717856 won ($0.25)
Seat 3: Player_5594c450 mucked
Seat 4: Player_84507ee9 mucked
Seat 5: Hero (button) mucked
Seat 6: Player_bae08790 (small blind) mucked



PokerStars Hand #3591332904: Hold'em No Limit ($0.05/$0.10) - 2018/04/11 3:02:27
Table '#14913699' 6-max Seat #6 is the button
Seat 1: Player_6ad16b1b ($12.57 in chips)
Seat 2: Player_d05ae977 ($23.84 in chips)
Seat 3: Player_2a12d1fb ($4.55 in chips)
Seat 4: Player_679a62b3 ($11.19 in chips)
Seat 5: Hero ($9.82 in chips)
Seat 6: Player_eee65f07 ($11.62 in chips)
Player_6ad16b1b: posts small blind $0.05
Player_d05ae977: posts big blind $0.10
*** HOLE CARDS ***
Dealt to Hero [5c 6c]
Player_2a12d1fb: folds
Player_679a62b3: folds
Hero: raises $0.23 to $0.33
Player_eee65f07: calls $0.33 
Player_6ad16b1b: folds
Player_d05ae977: calls $0.23 
*** FLOP *** [Ah 2h 2d]
Player_d05ae977: checks
Hero: checks
Player_eee65f07: checks
*** TURN *** [Ah 2h 2d] [Td]
Player_d05ae977: checks
Hero: checks
Player_eee65f07: checks
*** RIVER *** [Ah 2h 2d Td] [2c]
Player_d05ae977: checks
Hero: checks
Player_eee65f07: checks
*** SHOW DOWN ***
Player_d05ae977: shows [7c 6s] (three of a kind, Deuces)
Hero: shows [5c 6c] (three of a kind, Deuces)
Player_eee65f07: shows [Kd Qs] (three of a kind, Deuces)
Player_eee65f07 collected $0.99 from pot
*** SUMMARY ***
Total pot $1.04 | Rake $0.05
Board [Ah 2h 2d Td 2c]
Seat 1: Player_6ad16b1b (small blind) mucked
Seat 2: Player_d05ae977 (big blind) showed [7c 6s] and lost with three of a kind, Deuces
Seat 3: Player_2a12d1fb mucked
Seat 4: Player_679a62b3 mucked
Seat 5: Hero showed [5c 6c] and lost with three of a kind, Deuces
Seat 6: Player_eee65f07 (button) showed [Kd Qs] and won ($0.99) with three of a kind, Deuces



PokerStars Hand #3591333289: Hold'em No Limit ($0.05/$0.10) - 2018/04/11 3:03:54
Table '#14913699' 6-max Seat #1 is the button
Seat 1: Player_95599687 ($12.52 in chips)
Seat 2: Player_a038c81e ($23.51 in chips)
Seat 3: Player_32d2dc0b ($4.55 in chips)
Seat 4: Player_945d3dc7 ($11.19 in chips)
Seat 5: Hero ($9.49 in chips)
Seat 6: Player_c2cd3e4b ($12.28 in chips)
Player_a038c81e: posts small blind $0.05
Player_32d2dc0b: posts big blind $0.10
*** HOLE CARDS ***
Dealt to Hero [3s As]
Player_945d3dc7: folds
Hero: raises $0.25 to $0.35
Player_c2cd3e4b: calls $0.35 
Player_95599687: calls $0.35 
Player_a038c81e: folds
Player_32d2dc0b: calls $0.25 
*** FLOP *** [4d 6d 5h]
Player_32d2dc0b: checks
Hero: checks
Player_c2cd3e4b: bets $0.60 
Player_95599687: calls $0.60 
Player_32d2dc0b: folds
Hero: calls $0.60 
*** TURN *** [4d 6d 5h] [Qh]
Hero: checks
Player_c2cd3e4b: bets $2.01 
Player_95599687: folds
Hero: folds
Uncalled bet ($2.01) returned to Player_c2cd3e4b
Player_c2cd3e4b: doesn't show hand
Player_c2cd3e4b collected $3.09 from pot
*** SUMMARY ***
Total pot $3.25 | Rake $0.16
Board [4d 6d 5h Qh]
Seat 1: Player_95599687 (button) mucked
Seat 2: Player_a038c81e (small blind) mucked
Seat 3: Player_32d2dc0b (big blind) mucked
Seat 4: Player_945d3dc7 mucked
Seat 5: Hero mucked
Seat 6: Player_c2cd3e4b won ($3.09)



PokerStars Hand #3591333745: Hold'em No Limit ($0.05/$0.10) - 2018/04/11 3:05:28
Table '#14913699' 6-max Seat #2 is the button
Seat 1: Player_8b59a3d0 ($11.57 in chips)
Seat 2: Player_ec07eb75 ($23.46 in chips)
Seat 3: Player_3efbab53 ($4.20 in chips)
Seat 4: Player_f9da16d1 ($11.19 in chips)
Seat 5: Hero ($8.54 in chips)
Seat 6: Player_5d8d87d4 ($14.42 in chips)
Player_3efbab53: posts small blind $0.05
Player_f9da16d1: posts big blind $0.10
*** HOLE CARDS ***
Dealt to Hero [7c Js]
Hero: folds
Player_5d8d87d4: calls $0.10 
Player_8b59a3d0: calls $0.10 
Player_ec07eb75: folds
Player_3efbab53: raises $0.10 to $0.20
Player_f9da16d1: calls $0.10 
Player_5d8d87d4: calls $0.10 
Player_8b59a3d0: calls $0.10 
*** FLOP *** [Qs 9c 2s]
Player_3efbab53: bets $0.25 
Player_f9da16d1: calls $0.25 
Player_5d8d87d4: calls $0.25 
Player_8b59a3d0: folds
*** TURN *** [Qs 9c 2s] [2c]
Player_3efbab53: checks
Player_f9da16d1: bets $1.55 
Player_5d8d87d4: folds
Player_3efbab53: calls $1.55 
*** RIVER *** [Qs 9c 2s 2c] [Kc]
Player_3efbab53: checks
Seat sit down
Player_f9da16d1: bets $9.19 and is all-in
Player_3efbab53: calls $2.20 and is all-in
*** SHOW DOWN ***
Player_f9da16d1: shows [8s As] (a pair of Deuces)
Player_3efbab53: shows [Qh Th] (two pair, Queens and Deuces)
Uncalled bet ($6.99) returned to Player_f9da16d1
Player_3efbab53 collected $8.60 from pot
*** SUMMARY ***
Total pot $9.05 | Rake $0.45
Board [Qs 9c 2s 2c Kc]
Seat 1: Player_8b59a3d0 mucked
Seat 2: Player_ec07eb75 (button) mucked
Seat 3: Player_3efbab53 (small blind) showed [Qh Th] and won ($8.60) with two pair, Queens and Deuces
Seat 4: Player_f9da16d1 (big blind) showed [8s As] and lost with a pair of Deuces
Seat 5: Hero mucked
Seat 6: Player_5d8d87d4 mucked



PokerStars Hand #3591334243: Hold'em No Limit ($0.05/$0.10) - 2018/04/11 3:07:14
Table '#14913699' 6-max Seat #3 is the button
Seat 1: Player_18d97671 ($11.37 in chips)
Seat 2: Player_20d0afaf ($23.46 in chips)
Seat 3: Player_eea68d65 ($8.60 in chips)
Seat 4: Player_1bc08379 ($6.99 in chips)
Seat 5: Hero ($8.54 in chips)
Player_1bc08379: posts small blind $0.05
Hero: posts big blind $0.10
*** HOLE CARDS ***
Dealt to Hero [2d Qh]
Player_18d97671: folds
Player_20d0afaf: folds
Player_eea68d65: folds
Player_1bc08379: calls $0.05 
Hero: checks
*** FLOP *** [3d 8d 4c]
Player_1bc08379: bets $0.20 
Hero: folds
Uncalled bet ($0.20) returned to Player_1bc08379
Player_1bc08379: doesn't show hand
Player_1bc08379 collected $0.19 from pot
*** SUMMARY ***
Total pot $0.20 | Rake $0.01
Board [3d 8d 4c]
Seat 1: Player_18d97671 mucked
Seat 2: Player_20d0afaf mucked
Seat 3: Player_eea68d65 (button) mucked
Seat 4: Player_1bc08379 (small blind) won ($0.19)
Seat 5: Hero (big blind) mucked



PokerStars Hand #3591334485: Hold'em No Limit ($0.05/$0.10) - 2018/04/11 3:08:04
Table '#14913699' 6-max Seat #4 is the button
Seat 1: Player_e65b00b9 ($11.37 in chips)
Seat 2: Player_8aea357a ($23.46 in chips)
Seat 3: Player_d3412924 ($8.60 in chips)
Seat 4: Player_da766be2 ($7.08 in chips)
Seat 5: Hero ($8.44 in chips)
Seat 6: Player_cfdebc0f ($3 in chips)
Hero: posts small blind $0.05
Player_cfdebc0f: posts big blind $0.10
*** HOLE CARDS ***
Dealt to Hero [Ts Qc]
Player_e65b00b9: folds
Player_8aea357a: folds
Player_d3412924: folds
Player_da766be2: raises $0.25 to $0.35
Hero: folds
Player_cfdebc0f: calls $0.25 
*** FLOP *** [Qd 4s 6c]
Player_cfdebc0f: checks
Player_da766be2: bets $0.75 
Player_cfdebc0f: calls $0.75 
*** TURN *** [Qd 4s 6c] [2h]
Player_cfdebc0f: bets $0.10 
Player_da766be2: raises $5.88 to $5.98 and is all-in
Player_cfdebc0f: folds
Uncalled bet ($5.88) returned to Player_da766be2
Player_da766be2: doesn't show hand
Player_da766be2 collected $2.33 from pot
*** SUMMARY ***
Total pot $2.45 | Rake $0.12
Board [Qd 4s 6c 2h]
Seat 1: Player_e65b00b9 mucked
Seat 2: Player_8aea357a mucked
Seat 3: Player_d3412924 mucked
Seat 4: Player_da766be2 (button) won ($2.33)
Seat 5: Hero (small blind) mucked
Seat 6: Player_cfdebc0f (big blind) mucked



PokerStars Hand #3591334773: Hold'em No Limit ($0.05/$0.10) - 2018/04/11 3:09:01
Table '#14913699' 6-max Seat #5 is the button
Seat 1: Player_d5a0b69b ($11.37 in chips)
Seat 2: Player_ef6ac940 ($23.46 in chips)
Seat 3: Player_a3c8092b ($8.60 in chips)
Seat 4: Player_1316820f ($8.21 in chips)
Seat 5: Hero ($8.39 in chips)
Seat 6: Player_369ce059 ($1.80 in chips)
Player_369ce059: posts small blind $0.05
Player_d5a0b69b: posts big blind $0.10
*** HOLE CARDS ***
Dealt to Hero [Jh Tc]
Player_ef6ac940: folds
Player_a3c8092b: folds
Player_1316820f: calls $0.10 
Hero: raises $0.40 to $0.50
Seat sit down
Player_369ce059: folds
Player_d5a0b69b: folds
Player_1316820f: folds
Uncalled bet ($0.40) returned to Hero
Hero: doesn't show hand
Hero collected $0.35 from pot
*** SUMMARY ***
Total pot $0.35
Seat 1: Player_d5a0b69b (big blind) mucked
Seat 2: Player_ef6ac940 mucked
Seat 3: Player_a3c8092b mucked
Seat 4: Player_1316820f mucked
Seat 5: Hero (button) won ($0.35)
Seat 6: Player_369ce059 (small blind) mucked



PokerStars Hand #3591335000: Hold'em No Limit ($0.05/$0.10) - 2018/04/11 3:09:53
Table '#14913699' 6-max Seat #6 is the button
Seat 1: Player_dab84ad3 ($11.27 in chips)
Seat 2: Player_00c99700 ($10 in chips)
Seat 3: Player_d71064f0 ($8.60 in chips)
Seat 4: Player_23ca1a87 ($8.11 in chips)
Seat 5: Hero ($8.64 in chips)
Seat 6: Player_07c082c8 ($1.75 in chips)
Player_dab84ad3: posts small blind $0.05
Player_d71064f0: posts big blind $0.10
*** HOLE CARDS ***
Dealt to Hero [2c Qd]
Player_23ca1a87: folds
Hero: folds
Player_00c99700: Seat re-join
Player_07c082c8: folds
Player_dab84ad3: folds
*** SHOW DOWN ***
Player_d71064f0: shows [4c 2d] (high card Four)
Player_d71064f0 collected $0.15 from pot
*** SUMMARY ***
Total pot $0.15
Seat 1: Player_dab84ad3 (small blind) mucked
Seat 3: Player_d71064f0 (big blind) showed [4c 2d] and won ($0.15) with high card Four
Seat 4: Player_23ca1a87 mucked
Seat 5: Hero mucked
Seat 6: Player_07c082c8 (button) mucked



PokerStars Hand #3591335217: Hold'em No Limit ($0.05/$0.10) - 2018/04/11 3:10:38
Table '#14913699' 6-max Seat #1 is the button
Seat 1: Player_2620176f ($11.22 in chips)
Seat 3: Player_b135227f ($8.65 in chips)
Seat 4: Player_b6a6839c ($8.11 in chips)
Seat 5: Hero ($8.64 in chips)
Seat 6: Player_cfd12e42 ($1.75 in chips)
Player_b135227f: posts small blind $0.05
Player_b6a6839c: posts big blind $0.10
*** HOLE CARDS ***
Dealt to Hero [Ah Jd]
Hero: raises $0.30 to $0.40
Player_cfd12e42: calls $0.40 
Player_2620176f: folds
Player_b135227f: folds
Player_b6a6839c: folds
*** FLOP *** [9c 3d Jc]
Hero: bets $0.40 
Player_cfd12e42: folds
Uncalled bet ($0.40) returned to Hero
Hero: doesn't show hand
Hero collected $0.91 from pot
*** SUMMARY ***
Total pot $0.95 | Rake $0.04
Board [9c 3d Jc]
Seat 1: Player_2620176f (button) mucked
Seat 3: Player_b135227f (small blind) mucked
Seat 4: Player_b6a6839c (big blind) mucked
Seat 5: Hero won ($0.91)
Seat 6: Player_cfd12e42 mucked



PokerStars Hand #3591335430: Hold'em No Limit ($0.05/$0.10) - 2018/04/11 3:11:26
Table '#14913699' 6-max Seat #3 is the button
Seat 1: Player_2b09883e ($11.22 in chips)
Seat 2: Player_797451e6 ($10 in chips)
Seat 3: Player_24b538b3 ($8.60 in chips)
Seat 4: Player_7ac51720 ($8.01 in chips)
Seat 5: Hero ($9.15 in chips)
Seat 6: Player_60d8684f ($1.35 in chips)
Player_7ac51720: posts small blind $0.05
Hero: posts big blind $0.10
Player_797451e6: posts big blind $0.10
*** HOLE CARDS ***
Dealt to Hero [Kc Qd]
Player_60d8684f: calls $0.10 
Player_2b09883e: calls $0.10 
Player_797451e6: checks
Player_24b538b3: calls $0.10 
Player_7ac51720: calls $0.05 
Hero: raises $0.78 to $0.88
Player_60d8684f: calls $0.78 
Player_2b09883e: folds
Player_797451e6: folds
Player_24b538b3: folds
Player_7ac51720: folds
*** FLOP *** [Qh 7d Kh]
Hero: checks
Player_60d8684f: bets $0.47 and is all-in
Hero: calls $0.47 
*** TURN *** [Qh 7d Kh] [3h]
*** RIVER *** [Qh 7d Kh 3h] [Kd]
*** SHOW DOWN ***
Hero: shows [Kc Qd] (a full house, Kings full of Queens)
Player_60d8684f: shows [Qc As] (two pair, Kings and Queens)
Hero collected $2.95 from pot
*** SUMMARY ***
Total pot $3.10 | Rake $0.15
Board [Qh 7d Kh 3h Kd]
Seat 1: Player_2b09883e mucked
Seat 2: Player_797451e6 mucked
Seat 3: Player_24b538b3 (button) mucked
Seat 4: Player_7ac51720 (small blind) mucked
Seat 5: Hero (big blind) showed [Kc Qd] and won ($2.95) with a full house, Kings full of Queens
Seat 6: Player_60d8684f showed [Qc As] and lost with two pair, Kings and Queens



PokerStars Hand #3591335821: Hold'em No Limit ($0.05/$0.10) - 2018/04/11 3:12:52
Table '#14913699' 6-max Seat #4 is the button
Seat 1: Player_07d28f02 ($11.12 in chips)
Seat 2: Player_44afff21 ($9.90 in chips)
Seat 3: Player_af088c19 ($8.50 in chips)
Seat 4: Player_e6ca6fec ($7.91 in chips)
Seat 5: Hero ($10.75 in chips)
Table deposit $3 
Hero: posts small blind $0.05
Player_07d28f02: posts big blind $0.10
*** HOLE CARDS ***
Dealt to Hero [Jd Qd]
Player_44afff21: raises $0.20 to $0.30
Player_af088c19: calls $0.30 
Player_e6ca6fec: folds
Hero: raises $0.69 to $0.99
Player_07d28f02: folds
Player_44afff21: calls $0.69 
Player_af088c19: calls $0.69 
*** FLOP *** [Tc 8s 2d]
Hero: bets $2 
Player_44afff21: folds
Player_af088c19: folds
Uncalled bet ($2) returned to Hero
Hero: doesn't show hand
Hero collected $2.92 from pot
*** SUMMARY ***
Total pot $3.07 | Rake $0.15
Board [Tc 8s 2d]
Seat 1: Player_07d28f02 (big blind) mucked
Seat 2: Player_44afff21 mucked
Seat 3: Player_af088c19 mucked
Seat 4: Player_e6ca6fec (button) mucked
Seat 5: Hero (small blind) won ($2.92)



PokerStars Hand #3591336135: Hold'em No Limit ($0.05/$0.10) - 2018/04/11 3:14:00
Table '#14913699' 6-max Seat #5 is the button
Seat 1: Player_97e72d49 ($11.02 in chips)
Seat 2: Player_b9192882 ($8.91 in chips)
Seat 3: Player_e0c31461 ($7.51 in chips)
Seat 4: Player_e7cb1e70 ($7.91 in chips)
Seat 5: Hero ($12.68 in chips)
Player_97e72d49: posts small blind $0.05
Player_b9192882: posts big blind $0.10
*** HOLE CARDS ***
Dealt to Hero [4s 3c]
Player_e0c31461: calls $0.10 
Player_e7cb1e70: folds
Hero: folds
Player_97e72d49: raises $0.40 to $0.50
Player_b9192882: folds
Player_e0c31461: calls $0.40 
*** FLOP *** [6c 9d Jh]
Player_97e72d49: bets $0.65 
Player_e0c31461: folds
Uncalled bet ($0.65) returned to Player_97e72d49
Player_97e72d49: doesn't show hand
Player_97e72d49 collected $1.05 from pot
*** SUMMARY ***
Total pot $1.10 | Rake $0.05
Board [6c 9d Jh]
Seat 1: Player_97e72d49 (small blind) won ($1.05)
Seat 2: Player_b9192882 (big blind) mucked
Seat 3: Player_e0c31461 mucked
Seat 4: Player_e7cb1e70 mucked
Seat 5: Hero (button) mucked



PokerStars Hand #3591336370: Hold'em No Limit ($0.05/$0.10) - 2018/04/11 3:14:52
Table '#14913699' 6-max Seat #1 is the button
Seat 1: Player_2bde861e ($11.57 in chips)
Seat 2: Player_74482767 ($8.81 in chips)
Seat 3: Player_ce62de20 ($7.01 in chips)
Seat 4: Player_b77086da ($7.91 in chips)
Seat 5: Hero ($12.68 in chips)
Player_74482767: posts small blind $0.05
Player_ce62de20: posts big blind $0.10
*** HOLE CARDS ***
Dealt to Hero [Th 8d]
Player_b77086da: folds
Hero: folds
Player_2bde861e: folds
Seat sit down
Player_74482767: folds
Player_ce62de20: doesn't show hand
Player_ce62de20 collected $0.15 from pot
*** SUMMARY ***
Total pot $0.15
Seat 1: Player_2bde861e (button) mucked
Seat 2: Player_74482767 (small blind) mucked
Seat 3: Player_ce62de20 (big blind) won ($0.15)
Seat 4: Player_b77086da mucked
Seat 5: Hero mucked



PokerStars Hand #3591336511: Hold'em No Limit ($0.05/$0.10) - 2018/04/11 3:15:24
Table '#14913699' 6-max Seat #2 is the button
Seat 1: Player_10a4018d ($11.57 in chips)
Seat 2: Player_b3117de9 ($8.76 in chips)
Seat 3: Player_d1433ff1 ($7.06 in chips)
Seat 4: Player_c38d8d4c ($7.91 in chips)
Seat 5: Hero ($12.68 in chips)
Seat 6: Player_89d5d517 ($3 in chips)
Player_d1433ff1: posts small blind $0.05
Player_c38d8d4c: posts big blind $0.10
Player_89d5d517: posts big blind $0.10
*** HOLE CARDS ***
Dealt to Hero [6h 3c]
Hero: folds
Player_89d5d517: checks
Player_10a4018d: folds
Player_b3117de9: folds
Player_d1433ff1: raises $0.10 to $0.20
Player_c38d8d4c: calls $0.10 
Player_89d5d517: calls $0.10 
*** FLOP *** [As 4c Kh]
Player_d1433ff1: bets $0.30 
Player_c38d8d4c: folds
Player_89d5d517: folds
Uncalled bet ($0.30) returned to Player_d1433ff1
Player_d1433ff1: doesn't show hand
Player_d1433ff1 collected $0.57 from pot
*** SUMMARY ***
Total pot $0.60 | Rake $0.03
Board [As 4c Kh]
Seat 1: Player_10a4018d mucked
Seat 2: Player_b3117de9 (button) mucked
Seat 3: Player_d1433ff1 (small blind) won ($0.57)
Seat 4: Player_c38d8d4c (big blind) mucked
Seat 5: Hero mucked
Seat 6: Player_89d5d517 mucked



PokerStars Hand #3591336743: Hold'em No Limit ($0.05/$0.10) - 2018/04/11 3:16:14
Table '#14913699' 6-max Seat #3 is the button
Seat 1: Player_f814e2eb ($11.57 in chips)
Seat 2: Player_43bfea57 ($8.76 in chips)
Seat 3: Player_f091755c ($7.43 in chips)
Seat 4: Player_19d8dae8 ($7.71 in chips)
Seat 5: Hero ($12.68 in chips)
Seat 6: Player_e7faf8c4 ($2.80 in chips)
Player_19d8dae8: posts small blind $0.05
Hero: posts big blind $0.10
*** HOLE CARDS ***
Dealt to Hero [9s Ah]
Player_e7faf8c4: calls $0.10 
Player_f814e2eb: folds
Player_43bfea57: folds
Player_f091755c: folds
Player_19d8dae8: calls $0.05 
Hero: checks
*** FLOP *** [7s 8d 4s]
Player_19d8dae8: bets $0.30 
Hero: calls $0.30 
Player_e7faf8c4: calls $0.30 
*** TURN *** [7s 8d 4s] [6d]
Player_19d8dae8: bets $1.20 
Hero: calls $1.20 
Player_e7faf8c4: calls $1.20 
*** RIVER *** [7s 8d 4s 6d] [7h]
Player_19d8dae8: bets $6.11 and is all-in
Hero: folds
Player_e7faf8c4: calls $1.20 and is all-in
*** SHOW DOWN ***
Player_19d8dae8: shows [5c 2h] (a straight, Four to Eight)
Player_e7faf8c4: shows [5h 5s] (a straight, Four to Eight)
Uncalled bet ($4.91) returned to Player_19d8dae8
Player_19d8dae8 collected $3.42 from pot
Player_e7faf8c4 collected $3.42 from pot
*** SUMMARY ***
Total pot $7.20 | Rake $0.36
Board [7s 8d 4s 6d 7h]
Seat 1: Player_f814e2eb mucked
Seat 2: Player_43bfea57 mucked
Seat 3: Player_f091755c (button) mucked
Seat 4: Player_19d8dae8 (small blind) showed [5c 2h] and won ($3.42) with a straight, Four to Eight
Seat 5: Hero (big blind) mucked
Seat 6: Player_e7faf8c4 showed [5h 5s] and won ($3.42) with a straight, Four to Eight



PokerStars Hand #3591337029: Hold'em No Limit ($0.05/$0.10) - 2018/04/11 3:17:16
Table '#14913699' 6-max Seat #4 is the button
Seat 1: Player_6a17d532 ($11.57 in chips)
Seat 2: Player_0f0d6301 ($8.76 in chips)
Seat 3: Player_aad633ea ($7.43 in chips)
Seat 4: Player_afa48b81 ($8.33 in chips)
Seat 5: Hero ($11.08 in chips)
Seat 6: Player_2b4979f7 ($3.42 in chips)
Hero: posts small blind $0.05
Player_2b4979f7: posts big blind $0.10
*** HOLE CARDS ***
Dealt to Hero [Jc Qd]
Player_6a17d532: folds
Player_0f0d6301: folds
Player_aad633ea: folds
Player_afa48b81: calls $0.10 
Hero: raises $0.30 to $0.40
Player_2b4979f7: folds
Player_afa48b81: calls $0.30 
*** FLOP *** [Jh 9s 3c]
Hero: checks
Player_afa48b81: bets $0.45 
Hero: calls $0.45 
*** TURN *** [Jh 9s 3c] [2c]
Hero: checks
Player_afa48b81: bets $1.80 
Hero: calls $1.80 
*** RIVER *** [Jh 9s 3c 2c] [7d]
Hero: checks
Player_afa48b81: bets $5.40 
Hero: calls $5.40 
*** SHOW DOWN ***
Player_afa48b81: shows [4h 4d] (a pair of Fours)
Hero: shows [Jc Qd] (a pair of Jacks)
Hero collected $15.39 from pot
*** SUMMARY ***
Total pot $16.20 | Rake $0.81
Board [Jh 9s 3c 2c 7d]
Seat 1: Player_6a17d532 mucked
Seat 2: Player_0f0d6301 mucked
Seat 3: Player_aad633ea mucked
Seat 4: Player_afa48b81 (button) showed [4h 4d] and lost with a pair of Fours
Seat 5: Hero (small blind) showed [Jc Qd] and won ($15.39) with a pair of Jacks
Seat 6: Player_2b4979f7 (big blind) mucked



PokerStars Hand #3591337363: Hold'em No Limit ($0.05/$0.10) - 2018/04/11 3:18:31
Table '#14913699' 6-max Seat #5 is the button
Seat 1: Player_1494e91d ($11.57 in chips)
Seat 2: Player_de2cea53 ($8.76 in chips)
Seat 3: Player_6356e63d ($7.43 in chips)
Seat 4: Player_ee4badcb ($0.28 in chips)
Seat 5: Hero ($18.42 in chips)
Player_1494e91d: posts big blind $0.10
*** HOLE CARDS ***
Dealt to Hero [Kd Ah]
Player_de2cea53: folds
Player_6356e63d: calls $0.10 
Player_ee4badcb: folds
Hero: raises $0.27 to $0.37
Seat sit down
Player_1494e91d: calls $0.27 
Player_6356e63d: calls $0.27 
*** FLOP *** [6c Ks Jd]
Player_1494e91d: checks
Player_6356e63d: bets $0.30 
Hero: raises $0.70 to $1
Player_1494e91d: folds
Player_6356e63d: calls $0.70 
*** TURN *** [6c Ks Jd] [Th]
Player_6356e63d: bets $6.06 and is all-in
Seat sit down
Hero: folds
Uncalled bet ($6.06) returned to Player_6356e63d
Player_6356e63d: doesn't show hand
Player_6356e63d collected $2.96 from pot
*** SUMMARY ***
Total pot $3.11 | Rake $0.15
Board [6c Ks Jd Th]
Seat 1: Player_1494e91d (big blind) mucked
Seat 2: Player_de2cea53 mucked
Seat 3: Player_6356e63d won ($2.96)
Seat 4: Player_ee4badcb mucked
Seat 5: Hero (button) mucked



PokerStars Hand #3591337782: Hold'em No Limit ($0.05/$0.10) - 2018/04/11 3:20:00
Table '#14913699' 6-max Seat #5 is the button
Seat 1: Player_80da7c6b ($11.20 in chips)
Seat 3: Player_a4bc58a5 ($9.02 in chips)
Seat 4: Player_86251ec1 ($5 in chips)
Seat 5: Hero ($17.05 in chips)
Player_80da7c6b: posts small blind $0.05
Player_a4bc58a5: posts big blind $0.10
Player_86251ec1: posts big blind $0.10
*** HOLE CARDS ***
Dealt to Hero [Kc 2s]
Player_86251ec1: checks
Hero: folds
Player_80da7c6b: folds
Seat sit down
Player_a4bc58a5: checks
*** FLOP *** [5d 4h 9d]
Player_a4bc58a5: checks
Player_86251ec1: checks
*** TURN *** [5d 4h 9d] [8h]
Player_a4bc58a5: checks
Player_86251ec1: checks
*** RIVER *** [5d 4h 9d 8h] [2h]
Player_a4bc58a5: checks
Player_86251ec1: checks
*** SHOW DOWN ***
Player_a4bc58a5: shows [3s Td] (high card Ten)
Player_86251ec1: shows [4d Kh] (a pair of Fours)
Player_86251ec1 collected $0.24 from pot
*** SUMMARY ***
Total pot $0.25 | Rake $0.01
Board [5d 4h 9d 8h 2h]
Seat 1: Player_80da7c6b (small blind) mucked
Seat 3: Player_a4bc58a5 (big blind) showed [3s Td] and lost with high card Ten
Seat 4: Player_86251ec1 showed [4d Kh] and won ($0.24) with a pair of Fours
Seat 5: Hero mucked



PokerStars Hand #3591337983: Hold'em No Limit ($0.05/$0.10) - 2018/04/11 3:20:46
Table '#14913699' 6-max Seat #1 is the button
Seat 1: Player_52d956ea ($11.15 in chips)
Seat 3: Player_46c230fd ($8.92 in chips)
Seat 4: Player_9e952a8e ($5.14 in chips)
Seat 5: Hero ($17.05 in chips)
Seat 6: Player_474eaaca ($3 in chips)
Player_46c230fd: posts small blind $0.05
Player_9e952a8e: posts big blind $0.10
*** HOLE CARDS ***
Dealt to Hero [8c 5c]
Hero: raises $0.30 to $0.40
Player_52d956ea: calls $0.40 
Seat sit down
Player_46c230fd: calls $0.35 
Player_9e952a8e: folds
*** FLOP *** [Qh 2d 6h]
Player_46c230fd: checks
Hero: checks
Player_52d956ea: bets $0.85 
Player_46c230fd: folds
Hero: folds
Uncalled bet ($0.85) returned to Player_52d956ea
Player_52d956ea: doesn't show hand
Player_52d956ea collected $1.24 from pot
*** SUMMARY ***
Total pot $1.30 | Rake $0.06
Board [Qh 2d 6h]
Seat 1: Player_52d956ea (button) won ($1.24)
Seat 3: Player_46c230fd (small blind) mucked
Seat 4: Player_9e952a8e (big blind) mucked
Seat 5: Hero mucked



PokerStars Hand #3591338328: Hold'em No Limit ($0.05/$0.10) - 2018/04/11 3:22:07
Table '#14913699' 6-max Seat #3 is the button
Seat 1: Player_c2d9d462 ($11.99 in chips)
Seat 2: Player_a653b9ac ($3 in chips)
Seat 3: Player_a5facc74 ($8.52 in chips)
Seat 4: Player_c18c4998 ($5.04 in chips)
Seat 5: Hero ($16.65 in chips)
Seat 6: Player_ee92b804 ($4.19 in chips)
Player_c18c4998: posts small blind $0.05
Hero: posts big blind $0.10
Player_ee92b804: posts big blind $0.10
*** HOLE CARDS ***
Dealt to Hero [2d Ah]
Player_ee92b804: checks
Player_c2d9d462: folds
Player_a5facc74: calls $0.10 
Player_c18c4998: folds
Hero: checks
*** FLOP *** [4c Jh Jd]
Hero: checks
Player_ee92b804: bets $0.40 
Player_a5facc74: folds
Hero: folds
Uncalled bet ($0.40) returned to Player_ee92b804
Player_ee92b804: doesn't show hand
Player_ee92b804 collected $0.34 from pot
*** SUMMARY ***
Total pot $0.35 | Rake $0.01
Board [4c Jh Jd]
Seat 1: Player_c2d9d462 mucked
Seat 3: Player_a5facc74 (button) mucked
Seat 4: Player_c18c4998 (small blind) mucked
Seat 5: Hero (big blind) mucked
Seat 6: Player_ee92b804 won ($0.34)



PokerStars Hand #3591338547: Hold'em No Limit ($0.05/$0.10) - 2018/04/11 3:23:00
Table '#14913699' 6-max Seat #4 is the button
Seat 1: Player_b906d3f5 ($11.99 in chips)
Seat 3: Player_450f9dc2 ($8.42 in chips)
Seat 4: Player_42880a90 ($4.99 in chips)
Seat 5: Hero ($16.55 in chips)
Seat 6: Player_b8babab0 ($4.43 in chips)
Hero: posts small blind $0.05
Player_b8babab0: posts big blind $0.10
*** HOLE CARDS ***
Dealt to Hero [2h Th]
Player_b906d3f5: folds
Player_450f9dc2: raises $0.10 to $0.20
Player_42880a90: folds
Hero: folds
Player_b8babab0: calls $0.10 
*** FLOP *** [4s 2d 7h]
Player_b8babab0: checks (disconnect)
Player_450f9dc2: bets $0.20 
Player_b8babab0: calls $0.20 
*** TURN *** [4s 2d 7h] [Jd]
Player_b8babab0: checks
Player_450f9dc2: bets $0.27 
Player_b8babab0: calls $0.27 
*** RIVER *** [4s 2d 7h Jd] [2s]
Player_b8babab0: checks
Player_450f9dc2: checks
*** SHOW DOWN ***
Player_b8babab0: shows [5h 4d] (two pair, Fours and Deuces)
Player_450f9dc2: shows [Jc As] (two pair, Jacks and Deuces)
Player_450f9dc2 collected $1.33 from pot
*** SUMMARY ***
Total pot $1.39 | Rake $0.06
Board [4s 2d 7h Jd 2s]
Seat 1: Player_b906d3f5 mucked
Seat 3: Player_450f9dc2 showed [Jc As] and won ($1.33) with two pair, Jacks and Deuces
Seat 4: Player_42880a90 (button) mucked
Seat 5: Hero (small blind) mucked
Seat 6: Player_b8babab0 (big blind) showed [5h 4d] and lost with two pair, Fours and Deuces



PokerStars Hand #3591339058: Hold'em No Limit ($0.05/$0.10) - 2018/04/11 3:24:54
Table '#14913699' 6-max Seat #5 is the button
Seat 1: Player_f83bebc5 ($11.99 in chips)
Seat 3: Player_2c0531c2 ($9.08 in chips)
Seat 4: Player_8bd5ef2d ($4.99 in chips)
Seat 5: Hero ($16.50 in chips)
Seat 6: Player_21f15761 ($3.76 in chips)
Player_21f15761: posts small blind $0.05
Player_f83bebc5: posts big blind $0.10
*** HOLE CARDS ***
Dealt to Hero [Qs 7c]
Player_2c0531c2: calls $0.10 
Player_8bd5ef2d: folds
Hero: folds
Player_21f15761: calls $0.05 
Player_f83bebc5: raises $0.30 to $0.40
Player_2c0531c2: calls $0.30 
Player_21f15761: calls $0.30 
*** FLOP *** [Jd Ts Js]
Player_21f15761: checks
Player_f83bebc5: checks
Player_2c0531c2: bets $0.30 
Player_21f15761: raises $0.30 to $0.60
Player_f83bebc5: folds
Player_2c0531c2: calls $0.30 
*** TURN *** [Jd Ts Js] [Th]
Player_21f15761: bets $2.76 and is all-in
Player_2c0531c2: calls $2.76 
*** RIVER *** [Jd Ts Js Th] [4d]
*** SHOW DOWN ***
Player_2c0531c2: shows [Kc Td] (a full house, Tens full of Jacks)
Player_21f15761: shows [3s 2h] (two pair, Jacks and Tens)
Player_2c0531c2 collected $7.53 from pot
*** SUMMARY ***
Total pot $7.92 | Rake $0.39
Board [Jd Ts Js Th 4d]
Seat 1: Player_f83bebc5 (big blind) mucked
Seat 3: Player_2c0531c2 showed [Kc Td] and won ($7.53) with a full house, Tens full of Jacks
Seat 4: Player_8bd5ef2d mucked
Seat 5: Hero (button) mucked
Seat 6: Player_21f15761 (small blind) showed [3s 2h] and lost with two pair, Jacks and Tens



PokerStars Hand #3591339448: Hold'em No Limit ($0.05/$0.10) - 2018/04/11 3:26:25
Table '#14913699' 6-max Seat #5 is the button
Seat 1: Player_d6c922f5 ($11.59 in chips)
Seat 3: Player_2fec30d4 ($12.85 in chips)
Seat 4: Player_cb016c5a ($4.99 in chips)
Seat 5: Hero ($16.50 in chips)
Player_d6c922f5: posts small blind $0.05
Player_2fec30d4: posts big blind $0.10
*** HOLE CARDS ***
Dealt to Hero [7c 4d]
Player_cb016c5a: folds
Hero: folds
Player_d6c922f5: folds
Seat re-join
Player_2fec30d4: doesn't show hand
Player_2fec30d4 collected $0.15 from pot
*** SUMMARY ***
Total pot $0.15
Seat 1: Player_d6c922f5 (small blind) mucked
Seat 3: Player_2fec30d4 (big blind) won ($0.15)
Seat 4: Player_cb016c5a mucked
Seat 5: Hero mucked



PokerStars Hand #3591339621: Hold'em No Limit ($0.05/$0.10) - 2018/04/11 3:27:02
Table '#14913699' 6-max Seat #1 is the button
Seat 1: Player_76345881 ($11.54 in chips)
Seat 3: Player_9cbeef36 ($12.90 in chips)
Seat 4: Player_67a71241 ($4.99 in chips)
Seat 5: Hero ($16.50 in chips)
Player_9cbeef36: posts small blind $0.05
Player_67a71241: posts big blind $0.10
*** HOLE CARDS ***
Dealt to Hero [Td 6h]
Seat sit down
Hero: folds
Player_76345881: folds
Player_9cbeef36: calls $0.05 
Player_67a71241: raises $0.20 to $0.30
Player_9cbeef36: calls $0.20 
*** FLOP *** [Ad 8h 6s]
Player_9cbeef36: checks
Player_67a71241: bets $0.60 
Player_9cbeef36: folds
Uncalled bet ($0.60) returned to Player_67a71241
Player_67a71241: doesn't show hand
Player_67a71241 collected $0.57 from pot
*** SUMMARY ***
Total pot $0.60 | Rake $0.03
Board [Ad 8h 6s]
Seat 1: Player_76345881 (button) mucked
Seat 3: Player_9cbeef36 (small blind) mucked
Seat 4: Player_67a71241 (big blind) won ($0.57)
Seat 5: Hero mucked



PokerStars Hand #3591339870: Hold'em No Limit ($0.05/$0.10) - 2018/04/11 3:27:59
Table '#14913699' 6-max Seat #3 is the button
Seat 1: Player_30e57049 ($11.54 in chips)
Seat 2: Player_ef9b1937 ($3 in chips)
Seat 3: Player_6ba0b163 ($12.60 in chips)
Seat 4: Player_e803e07e ($5.26 in chips)
Seat 5: Hero ($16.50 in chips)
Player_e803e07e: posts small blind $0.05
Hero: posts big blind $0.10
*** HOLE CARDS ***
Dealt to Hero [6d Td]
Player_30e57049: raises $0.20 to $0.30
Player_6ba0b163: calls $0.30 
Player_e803e07e: folds
Hero: calls $0.20 
*** FLOP *** [3c 3s Ac]
Hero: checks
Player_30e57049: checks
Player_6ba0b163: bets $0.32 
Player_ef9b1937: Seat re-join
Hero: folds
Player_30e57049: folds
Uncalled bet ($0.32) returned to Player_6ba0b163
Player_6ba0b163: doesn't show hand
Player_6ba0b163 collected $0.91 from pot
*** SUMMARY ***
Total pot $0.95 | Rake $0.04
Board [3c 3s Ac]
Seat 1: Player_30e57049 mucked
Seat 3: Player_6ba0b163 (button) won ($0.91)
Seat 4: Player_e803e07e (small blind) mucked
Seat 5: Hero (big blind) mucked



PokerStars Hand #3591340153: Hold'em No Limit ($0.05/$0.10) - 2018/04/11 3:29:04
Table '#14913699' 6-max Seat #4 is the button
Seat 1: Player_cc9eb517 ($11.24 in chips)
Seat 2: Player_a275d317 ($3 in chips)
Seat 3: Player_a9947c2d ($13.21 in chips)
Seat 4: Player_731a09d9 ($5.21 in chips)
Seat 5: Hero ($16.20 in chips)
Seat 6: Player_23f74372 ($10 in chips)
Hero: posts small blind $0.05
Player_23f74372: posts big blind $0.10
*** HOLE CARDS ***
Dealt to Hero [8d 8h]
Player_a275d317: Seat re-join
Player_cc9eb517: folds
Player_a9947c2d: folds
Player_731a09d9: calls $0.10 
Hero: raises $0.30 to $0.40
Player_23f74372: calls $0.30 
Player_731a09d9: calls $0.30 
*** FLOP *** [Qc Ts 7h]
Hero: checks
Player_23f74372: bets $0.70 
Player_731a09d9: folds
Hero: calls $0.70 
*** TURN *** [Qc Ts 7h] [2s]
Hero: checks
Player_23f74372: bets $1.70 
Hero: folds
Uncalled bet ($1.70) returned to Player_23f74372
Player_23f74372: doesn't show hand
Player_23f74372 collected $2.47 from pot
*** SUMMARY ***
Total pot $2.60 | Rake $0.13
Board [Qc Ts 7h 2s]
Seat 1: Player_cc9eb517 mucked
Seat 3: Player_a9947c2d mucked
Seat 4: Player_731a09d9 (button) mucked
Seat 5: Hero (small blind) mucked
Seat 6: Player_23f74372 (big blind) won ($2.47)



PokerStars Hand #3591340537: Hold'em No Limit ($0.05/$0.10) - 2018/04/11 3:30:25
Table '#14913699' 6-max Seat #5 is the button
Seat 1: Player_fd233d02 ($11.24 in chips)
Seat 2: Player_67041c8b ($3 in chips)
Seat 3: Player_00811ece ($13.21 in chips)
Seat 4: Player_58b2d437 ($4.81 in chips)
Seat 5: Hero ($15.10 in chips)
Seat 6: Player_f06ef802 ($11.37 in chips)
Player_f06ef802: posts small blind $0.05
Player_fd233d02: posts big blind $0.10
*** HOLE CARDS ***
Dealt to Hero [4h 7d]
Player_00811ece: folds
Player_58b2d437: folds
Hero: folds
Player_f06ef802: raises $0.20 to $0.30
Player_fd233d02: calls $0.20 
*** FLOP *** [Jd 5h 8h]
Player_f06ef802: bets $0.35 
Player_fd233d02: calls $0.35 
*** TURN *** [Jd 5h 8h] [7h]
Player_f06ef802: checks
Player_fd233d02: checks
*** RIVER *** [Jd 5h 8h 7h] [3d]
Player_f06ef802: checks
Player_fd233d02: checks
*** SHOW DOWN ***
Player_f06ef802: shows [6d 6c] (a pair of Sixes)
Player_fd233d02: shows [Jc Qc] (a pair of Jacks)
Player_fd233d02 collected $1.24 from pot
*** SUMMARY ***
Total pot $1.30 | Rake $0.06
Board [Jd 5h 8h 7h 3d]
Seat 1: Player_fd233d02 (big blind) showed [Jc Qc] and won ($1.24) with a pair of Jacks
Seat 3: Player_00811ece mucked
Seat 4: Player_58b2d437 mucked
Seat 5: Hero (button) mucked
Seat 6: Player_f06ef802 (small blind) showed [6d 6c] and lost with a pair of Sixes



PokerStars Hand #3591340834: Hold'em No Limit ($0.05/$0.10) - 2018/04/11 3:31:33
Table '#14913699' 6-max Seat #6 is the button
Seat 1: Player_ecb956b9 ($11.83 in chips)
Seat 4: Player_26533311 ($4.81 in chips)
Seat 5: Hero ($15.10 in chips)
Seat 6: Player_d5d6709c ($10.72 in chips)
Player_ecb956b9: posts small blind $0.05
Player_26533311: posts big blind $0.10
*** HOLE CARDS ***
Dealt to Hero [2d 5d]
Hero: folds
Player_d5d6709c: folds
Player_ecb956b9: folds
Player_26533311: doesn't show hand
Player_26533311 collected $0.15 from pot
*** SUMMARY ***
Total pot $0.15
Seat 1: Player_ecb956b9 (small blind) mucked
Seat 4: Player_26533311 (big blind) won ($0.15)
Seat 5: Hero mucked
Seat 6: Player_d5d6709c (button) mucked



PokerStars Hand #3591340907: Hold'em No Limit ($0.05/$0.10) - 2018/04/11 3:31:48
Table '#14913699' 6-max Seat #1 is the button
Seat 1: Player_8048072f ($11.78 in chips)
Seat 4: Player_69579970 ($4.86 in chips)
Seat 5: Hero ($15.10 in chips)
Seat 6: Player_95e2657c ($10.72 in chips)
Player_69579970: posts small blind $0.05
Hero: posts big blind $0.10
*** HOLE CARDS ***
Dealt to Hero [Jh 6d]
Player_95e2657c: raises $0.20 to $0.30
Player_8048072f: folds
Player_69579970: folds
Seat sit down
Hero: folds
Uncalled bet ($0.20) returned to Player_95e2657c
Player_95e2657c: doesn't show hand
Player_95e2657c collected $0.25 from pot
*** SUMMARY ***
Total pot $0.25
Seat 1: Player_8048072f (button) mucked
Seat 4: Player_69579970 (small blind) mucked
Seat 5: Hero (big blind) mucked
Seat 6: Player_95e2657c won ($0.25)



PokerStars Hand #3591341035: Hold'em No Limit ($0.05/$0.10) - 2018/04/11 3:32:17
Table '#14913699' 6-max Seat #4 is the button
Seat 1: Player_d22ad500 ($11.78 in chips)
Seat 4: Player_cf47d34c ($4.81 in chips)
Seat 5: Hero ($15 in chips)
Seat 6: Player_36b73887 ($10.87 in chips)
Hero: posts small blind $0.05
Player_36b73887: posts big blind $0.10
*** HOLE CARDS ***
Dealt to Hero [Kc Js]
Player_d22ad500: folds
Player_cf47d34c: folds
Hero: raises $0.23 to $0.33
Player_36b73887: folds
Uncalled bet ($0.23) returned to Hero
Hero: doesn't show hand
Hero collected $0.20 from pot
*** SUMMARY ***
Total pot $0.20
Seat 1: Player_d22ad500 mucked
Seat 4: Player_cf47d34c (button) mucked
Seat 5: Hero (small blind) won ($0.20)
Seat 6: Player_36b73887 (big blind) mucked



PokerStars Hand #3591341143: Hold'em No Limit ($0.05/$0.10) - 2018/04/11 3:32:40
Table '#14913699' 6-max Seat #5 is the button
Seat 1: Player_adb945ae ($11.78 in chips)
Seat 4: Player_1c5d2fd6 ($4.81 in chips)
Seat 5: Hero ($15.10 in chips)
Seat 6: Player_c993f48c ($10.77 in chips)
Player_c993f48c: posts small blind $0.05
Player_adb945ae: posts big blind $0.10
*** HOLE CARDS ***
Dealt to Hero [3s 4h]
Player_1c5d2fd6: folds
Hero: folds
Player_c993f48c: folds
Player_adb945ae: doesn't show hand
Player_adb945ae collected $0.15 from pot
*** SUMMARY ***
Total pot $0.15
Seat 1: Player_adb945ae (big blind) won ($0.15)
Seat 4: Player_1c5d2fd6 mucked
Seat 5: Hero (button) mucked
Seat 6: Player_c993f48c (small blind) mucked



PokerStars Hand #3591341289: Hold'em No Limit ($0.05/$0.10) - 2018/04/11 3:33:11
Table '#14913699' 6-max Seat #6 is the button
Seat 1: Player_9961344b ($11.83 in chips)
Seat 3: Player_97985702 ($10 in chips)
Seat 4: Player_6dca7ec3 ($4.81 in chips)
Seat 5: Hero ($15.10 in chips)
Seat 6: Player_406c34d2 ($10.72 in chips)
Player_9961344b: posts small blind $0.05
Player_97985702: posts big blind $0.10
*** HOLE CARDS ***
Dealt to Hero [Qh Jd]
Player_6dca7ec3: folds
Hero: raises $0.30 to $0.40
Player_406c34d2: folds
Player_9961344b: folds
Player_97985702: raises $0.40 to $0.80
Hero: calls $0.40 
*** FLOP *** [Ad 3s 9h]
Player_97985702: bets $0.97 
Hero: folds
Uncalled bet ($0.97) returned to Player_97985702
Player_97985702: doesn't show hand
Player_97985702 collected $1.57 from pot
*** SUMMARY ***
Total pot $1.65 | Rake $0.08
Board [Ad 3s 9h]
Seat 1: Player_9961344b (small blind) mucked
Seat 3: Player_97985702 (big blind) won ($1.57)
Seat 4: Player_6dca7ec3 mucked
Seat 5: Hero mucked
Seat 6: Player_406c34d2 (button) mucked



PokerStars Hand #3591341566: Hold'em No Limit ($0.05/$0.10) - 2018/04/11 3:34:11
Table '#14913699' 6-max Seat #1 is the button
Seat 1: Player_44137eee ($11.78 in chips)
Seat 3: Player_82f00713 ($10.77 in chips)
Seat 4: Player_91b1fb27 ($4.81 in chips)
Seat 5: Hero ($14.30 in chips)
Seat 6: Player_bb755c69 ($10.72 in chips)
Player_82f00713: posts small blind $0.05
Player_91b1fb27: posts big blind $0.10
*** HOLE CARDS ***
Dealt to Hero [Ks Ts]
Hero: raises $0.30 to $0.40
Player_bb755c69: folds
Player_44137eee: folds
Player_82f00713: calls $0.35 
Player_91b1fb27: folds
*** FLOP *** [Qh 4d 3h]
Player_82f00713: bets $10.37 and is all-in
Hero: folds
Uncalled bet ($10.37) returned to Player_82f00713
Player_82f00713: doesn't show hand
Player_82f00713 collected $0.86 from pot
*** SUMMARY ***
Total pot $0.90 | Rake $0.04
Board [Qh 4d 3h]
Seat 1: Player_44137eee (button) mucked
Seat 3: Player_82f00713 (small blind) won ($0.86)
Seat 4: Player_91b1fb27 (big blind) mucked
Seat 5: Hero mucked
Seat 6: Player_bb755c69 mucked



PokerStars Hand #3591341697: Hold'em No Limit ($0.05/$0.10) - 2018/04/11 3:34:43
Table '#14913699' 6-max Seat #3 is the button
Seat 1: Player_e3ca4457 ($11.78 in chips)
Seat 3: Player_a0e72b19 ($11.23 in chips)
Seat 4: Player_858447d4 ($4.71 in chips)
Seat 5: Hero ($13.90 in chips)
Seat 6: Player_91fbc62a ($10.72 in chips)
Player_858447d4: posts small blind $0.05
Hero: posts big blind $0.10
*** HOLE CARDS ***
Dealt to Hero [5d 8s]
Player_91fbc62a: folds
Player_e3ca4457: raises $0.20 to $0.30
Player_a0e72b19: calls $0.30 
Player_858447d4: calls $0.25 
Hero: calls $0.20 
*** FLOP *** [4h Jc 3c]
Player_858447d4: checks
Hero: checks
Player_e3ca4457: bets $0.70 
Player_a0e72b19: folds
Player_858447d4: calls $0.70 
Hero: folds
*** TURN *** [4h Jc 3c] [2d]
Player_858447d4: checks
Player_e3ca4457: checks
*** RIVER *** [4h Jc 3c 2d] [Td]
Seat sit down
Player_858447d4: checks
Player_e3ca4457: checks
*** SHOW DOWN ***
Player_858447d4: shows [Kc Qd] (high card King)
Player_e3ca4457: shows [4c Ac] (a pair of Fours)
Player_e3ca4457 collected $2.47 from pot
*** SUMMARY ***
Total pot $2.60 | Rake $0.13
Board [4h Jc 3c 2d Td]
Seat 1: Player_e3ca4457 showed [4c Ac] and won ($2.47) with a pair of Fours
Seat 3: Player_a0e72b19 (button) mucked
Seat 4: Player_858447d4 (small blind) showed [Kc Qd] and lost with high card King
Seat 5: Hero (big blind) mucked
Seat 6: Player_91fbc62a mucked



PokerStars Hand #3591341959: Hold'em No Limit ($0.05/$0.10) - 2018/04/11 3:35:41
Table '#14913699' 6-max Seat #4 is the button
Seat 1: Player_5bc63c50 ($13.25 in chips)
Seat 3: Player_a5f6c5e9 ($10.93 in chips)
Seat 4: Player_c539cb6e ($3.71 in chips)
Seat 5: Hero ($13.60 in chips)
Seat 6: Player_18a3ab4d ($10.72 in chips)
Hero: posts small blind $0.05
Player_18a3ab4d: posts big blind $0.10
*** HOLE CARDS ***
Dealt to Hero [4h 3s]
Player_5bc63c50: folds
Player_a5f6c5e9: raises $0.20 to $0.30
Player_c539cb6e: calls $0.30 
Hero: folds
Player_18a3ab4d: folds
*** FLOP *** [8c Ad Tc]
Player_a5f6c5e9: bets $0.20 
Player_c539cb6e: calls $0.20 
*** TURN *** [8c Ad Tc] [8h]
Player_a5f6c5e9: bets $0.40 
Player_c539cb6e: calls $0.40 
*** RIVER *** [8c Ad Tc 8h] [9h]
Player_a5f6c5e9: bets $10.03 and is all-in
Player_c539cb6e: calls $2.81 and is all-in
*** SHOW DOWN ***
Player_a5f6c5e9: shows [8s 7c] (three of a kind, Eights)
Player_c539cb6e: Mucks [Qc Td] (Two pair)
Uncalled bet ($7.22) returned to Player_a5f6c5e9
Player_a5f6c5e9 collected $7.20 from pot
*** SUMMARY ***
Total pot $7.57 | Rake $0.37
Board [8c Ad Tc 8h 9h]
Seat 1: Player_5bc63c50 mucked
Seat 3: Player_a5f6c5e9 showed [8s 7c] and won ($7.20) with three of a kind, Eights
Seat 4: Player_c539cb6e (button) mucked [Qc Td]
Seat 5: Hero (small blind) mucked
Seat 6: Player_18a3ab4d (big blind) mucked



PokerStars Hand #3591342150: Hold'em No Limit ($0.05/$0.10) - 2018/04/11 3:36:25
Table '#14913699' 6-max Seat #5 is the button
Seat 1: Player_0251539e ($13.25 in chips)
Seat 3: Player_59c02266 ($14.42 in chips)
Seat 5: Hero ($13.55 in chips)
Seat 6: Player_9c7109f0 ($10.62 in chips)
Player_9c7109f0: posts small blind $0.05
Player_0251539e: posts big blind $0.10
*** HOLE CARDS ***
Dealt to Hero [3h 6c]
Player_59c02266: folds
Hero: folds
Player_9c7109f0: folds
Player_0251539e: doesn't show hand
Player_0251539e collected $0.15 from pot
*** SUMMARY ***
Total pot $0.15
Seat 1: Player_0251539e (big blind) won ($0.15)
Seat 3: Player_59c02266 mucked
Seat 5: Hero (button) mucked
Seat 6: Player_9c7109f0 (small blind) mucked



PokerStars Hand #3591342206: Hold'em No Limit ($0.05/$0.10) - 2018/04/11 3:36:37
Table '#14913699' 6-max Seat #6 is the button
Seat 1: Player_94165b16 ($13.30 in chips)
Seat 2: Player_66fed9ab ($5.55 in chips)
Seat 3: Player_9c22a578 ($14.42 in chips)
Seat 5: Hero ($13.55 in chips)
Seat 6: Player_c9944b1d ($10.57 in chips)
Player_94165b16: posts small blind $0.05
Player_66fed9ab: posts big blind $0.10
*** HOLE CARDS ***
Dealt to Hero [Qh 2h]
Player_9c22a578: calls $0.10 
Hero: folds
Player_c9944b1d: folds
Player_94165b16: raises $0.40 to $0.50
Player_66fed9ab: calls $0.40 
Player_9c22a578: calls $0.40 
*** FLOP *** [5s 4d As]
Player_94165b16: bets $0.85 
Player_66fed9ab: folds
Player_9c22a578: calls $0.85 
*** TURN *** [5s 4d As] [Td]
Seat sit down
Player_94165b16: checks
Player_9c22a578: checks
*** RIVER *** [5s 4d As Td] [8d]
Player_94165b16: checks
Player_9c22a578: bets $0.30 
Player_94165b16: calls $0.30 
*** SHOW DOWN ***
Player_9c22a578: shows [8s 4s] (two pair, Eights and Fours)
Player_94165b16: Mucks [Kh Kd] (One pair)
Player_9c22a578 collected $3.61 from pot
*** SUMMARY ***
Total pot $3.80 | Rake $0.19
Board [5s 4d As Td 8d]
Seat 1: Player_94165b16 (small blind) mucked [Kh Kd]
Seat 2: Player_66fed9ab (big blind) mucked
Seat 3: Player_9c22a578 showed [8s 4s] and won ($3.61) with two pair, Eights and Fours
Seat 5: Hero mucked
Seat 6: Player_c9944b1d (button) mucked



PokerStars Hand #3591342467: Hold'em No Limit ($0.05/$0.10) - 2018/04/11 3:37:38
Table '#14913699' 6-max Seat #1 is the button
Seat 1: Player_19fa5873 ($11.65 in chips)
Seat 2: Player_b44bacd4 ($5.05 in chips)
Seat 3: Player_4be5be00 ($16.38 in chips)
Seat 5: Hero ($13.55 in chips)
Seat 6: Player_458d4394 ($10.57 in chips)
Player_b44bacd4: posts small blind $0.05
Player_4be5be00: posts big blind $0.10
*** HOLE CARDS ***
Dealt to Hero [6d 2s]
Hero: folds
Player_458d4394: folds
Player_19fa5873: raises $0.20 to $0.30
Player_b44bacd4: calls $0.25 
Player_4be5be00: folds
*** FLOP *** [5h 9h 5s]
Player_b44bacd4: bets $0.10 
Player_19fa5873: calls $0.10 
*** TURN *** [5h 9h 5s] [Qs]
Player_b44bacd4: bets $0.20 
Player_19fa5873: folds
*** SHOW DOWN ***
Player_b44bacd4: shows [Ad Ks] (a pair of Fives)
Uncalled bet ($0.20) returned to Player_b44bacd4
Player_b44bacd4 collected $0.86 from pot
*** SUMMARY ***
Total pot $0.90 | Rake $0.04
Board [5h 9h 5s Qs]
Seat 1: Player_19fa5873 (button) mucked
Seat 2: Player_b44bacd4 (small blind) showed [Ad Ks] and won ($0.86) with a pair of Fives
Seat 3: Player_4be5be00 (big blind) mucked
Seat 5: Hero mucked
Seat 6: Player_458d4394 mucked



PokerStars Hand #3591342651: Hold'em No Limit ($0.05/$0.10) - 2018/04/11 3:38:18
Table '#14913699' 6-max Seat #2 is the button
Seat 1: Player_d021e98b ($11.25 in chips)
Seat 2: Player_73e538dd ($5.51 in chips)
Seat 3: Player_900271a1 ($16.28 in chips)
Seat 5: Hero ($13.55 in chips)
Seat 6: Player_17353c3a ($10.57 in chips)
Player_900271a1: posts small blind $0.05
Hero: posts big blind $0.10
*** HOLE CARDS ***
Dealt to Hero [2d Ts]
Player_17353c3a: folds
Player_d021e98b: raises $0.20 to $0.30
Player_73e538dd: calls $0.30 
Player_900271a1: calls $0.25 
Hero: folds
*** FLOP *** [7h 4d 9d]
Player_900271a1: bets $0.40 
Player_d021e98b: calls $0.40 
Seat sit down
Player_73e538dd: calls $0.40 
*** TURN *** [7h 4d 9d] [Qc]
Player_900271a1: bets $0.30 
Player_d021e98b: raises $1.30 to $1.60
Player_73e538dd: calls $1.60 
Player_900271a1: calls $1.30 
*** RIVER *** [7h 4d 9d Qc] [9s]
Player_900271a1: bets $4 
Player_d021e98b: folds
Player_73e538dd: calls $3.21 and is all-in
*** SHOW DOWN ***
Player_900271a1: shows [9h 6s] (three of a kind, Nines)
Player_73e538dd: Mucks [Ad Qh] (Two pair)
Uncalled bet ($0.79) returned to Player_900271a1
Player_900271a1 collected $12.75 from pot
*** SUMMARY ***
Total pot $13.42 | Rake $0.67
Board [7h 4d 9d Qc 9s]
Seat 1: Player_d021e98b mucked
Seat 2: Player_73e538dd (button) mucked [Ad Qh]
Seat 3: Player_900271a1 (small blind) showed [9h 6s] and won ($12.75) with three of a kind, Nines
Seat 5: Hero (big blind) mucked
Seat 6: Player_17353c3a mucked



PokerStars Hand #3591343107: Hold'em No Limit ($0.05/$0.10) - 2018/04/11 3:39:59
Table '#14913699' 6-max Seat #3 is the button
Seat 1: Player_229a1391 ($8.95 in chips)
Seat 3: Player_dbec8c54 ($23.52 in chips)
Seat 5: Hero ($13.45 in chips)
Seat 6: Player_47713f32 ($10.57 in chips)
Hero: posts small blind $0.05
Player_47713f32: posts big blind $0.10
*** HOLE CARDS ***
Dealt to Hero [Kd Ah]
Player_229a1391: folds
Player_dbec8c54: folds
Hero: raises $0.20 to $0.30
Player_47713f32: folds
Uncalled bet ($0.20) returned to Hero
Hero: doesn't show hand
Hero collected $0.20 from pot
*** SUMMARY ***
Total pot $0.20
Seat 1: Player_229a1391 mucked
Seat 3: Player_dbec8c54 (button) mucked
Seat 5: Hero (small blind) won ($0.20)
Seat 6: Player_47713f32 (big blind) mucked



PokerStars Hand #3591343223: Hold'em No Limit ($0.05/$0.10) - 2018/04/11 3:40:24
Table '#14913699' 6-max Seat #5 is the button
Seat 1: Player_c29e71b0 ($8.95 in chips)
Seat 3: Player_48101456 ($23.52 in chips)
Seat 5: Hero ($13.55 in chips)
Seat 6: Player_98d6ec44 ($10.47 in chips)
Player_98d6ec44: posts small blind $0.05
Player_c29e71b0: posts big blind $0.10
*** HOLE CARDS ***
Dealt to Hero [Jh 9s]
Player_48101456: calls $0.10 
Seat sit down
Hero: raises $0.34 to $0.44
Player_98d6ec44: calls $0.39 
Player_c29e71b0: folds
Player_48101456: calls $0.34 
*** FLOP *** [4h 7d 9d]
Player_98d6ec44: checks
Player_48101456: checks
Hero: bets $1 
Player_98d6ec44: folds
Player_48101456: folds
Uncalled bet ($1) returned to Hero
Hero: doesn't show hand
Hero collected $1.35 from pot
*** SUMMARY ***
Total pot $1.42 | Rake $0.07
Board [4h 7d 9d]
Seat 1: Player_c29e71b0 (big blind) mucked
Seat 3: Player_48101456 mucked
Seat 5: Hero (button) won ($1.35)
Seat 6: Player_98d6ec44 (small blind) mucked



PokerStars Hand #3591343454: Hold'em No Limit ($0.05/$0.10) - 2018/04/11 3:41:18
Table '#14913699' 6-max Seat #6 is the button
Seat 1: Player_0a6acfd9 ($8.85 in chips)
Seat 2: Player_d3d7e051 ($10 in chips)
Seat 3: Player_78b5ef12 ($23.08 in chips)
Seat 5: Hero ($14.46 in chips)
Seat 6: Player_47aa4dbe ($10.03 in chips)
Player_0a6acfd9: posts small blind $0.05
Player_d3d7e051: posts big blind $0.10
*** HOLE CARDS ***
Dealt to Hero [8s Ac]
Player_78b5ef12: calls $0.10 
Hero: folds
Player_47aa4dbe: folds
Player_0a6acfd9: calls $0.05 
Player_d3d7e051: checks
*** FLOP *** [7h Jh 9d]
Player_0a6acfd9: checks
Player_d3d7e051: checks
Player_78b5ef12: checks
*** TURN *** [7h Jh 9d] [9c]
Player_0a6acfd9: bets $0.50 
Player_d3d7e051: folds
Player_78b5ef12: folds
Uncalled bet ($0.50) returned to Player_0a6acfd9
Player_0a6acfd9: doesn't show hand
Player_0a6acfd9 collected $0.29 from pot
*** SUMMARY ***
Total pot $0.30 | Rake $0.01
Board [7h Jh 9d 9c]
Seat 1: Player_0a6acfd9 (small blind) won ($0.29)
Seat 2: Player_d3d7e051 (big blind) mucked
Seat 3: Player_78b5ef12 mucked
Seat 5: Hero mucked
Seat 6: Player_47aa4dbe (button) mucked



PokerStars Hand #3591343645: Hold'em No Limit ($0.05/$0.10) - 2018/04/11 3:42:02
Table '#14913699' 6-max Seat #1 is the button
Seat 1: Player_b2d9ec2a ($9.04 in chips)
Seat 2: Player_75533fe9 ($9.90 in chips)
Seat 4: Player_8096bcce ($10 in chips)
Seat 5: Hero ($14.46 in chips)
Seat 6: Player_ec84ff34 ($10.03 in chips)
Player_75533fe9: posts small blind $0.05
Player_8096bcce: posts big blind $0.10
*** HOLE CARDS ***
Dealt to Hero [5s Kd]
Hero: folds
Player_ec84ff34: raises $0.20 to $0.30
Player_b2d9ec2a: calls $0.30 
Player_75533fe9: calls $0.25 
Player_8096bcce: folds
*** FLOP *** [Td 7d 8d]
Player_75533fe9: checks
Player_ec84ff34: bets $0.60 
Player_b2d9ec2a: folds
Player_75533fe9: folds
Uncalled bet ($0.60) returned to Player_ec84ff34
Player_ec84ff34: doesn't show hand
Player_ec84ff34 collected $0.95 from pot
*** SUMMARY ***
Total pot $1 | Rake $0.05
Board [Td 7d 8d]
Seat 1: Player_b2d9ec2a (button) mucked
Seat 2: Player_75533fe9 (small blind) mucked
Seat 4: Player_8096bcce (big blind) mucked
Seat 5: Hero mucked
Seat 6: Player_ec84ff34 won ($0.95)



PokerStars Hand #3591343869: Hold'em No Limit ($0.05/$0.10) - 2018/04/11 3:42:52
Table '#14913699' 6-max Seat #2 is the button
Seat 1: Player_37c6f072 ($8.74 in chips)
Seat 2: Player_5abe49bd ($9.60 in chips)
Seat 4: Player_d20c5930 ($9.90 in chips)
Seat 5: Hero ($14.46 in chips)
Seat 6: Player_60884c07 ($10.68 in chips)
Player_d20c5930: posts small blind $0.05
Hero: posts big blind $0.10
*** HOLE CARDS ***
Dealt to Hero [9h 6c]
Player_60884c07: folds
Player_37c6f072: folds
Player_5abe49bd: raises $0.20 to $0.30
Player_d20c5930: folds
Seat sit down
Hero: folds
Uncalled bet ($0.20) returned to Player_5abe49bd
Player_5abe49bd: doesn't show hand
Player_5abe49bd collected $0.25 from pot
*** SUMMARY ***
Total pot $0.25
Seat 1: Player_37c6f072 mucked
Seat 2: Player_5abe49bd (button) won ($0.25)
Seat 4: Player_d20c5930 (small blind) mucked
Seat 5: Hero (big blind) mucked
Seat 6: Player_60884c07 mucked



PokerStars Hand #3591344032: Hold'em No Limit ($0.05/$0.10) - 2018/04/11 3:43:30
Table '#14913699' 6-max Seat #4 is the button
Seat 1: Player_7d74746f ($8.74 in chips)
Seat 2: Player_dec04d12 ($9.75 in chips)
Seat 4: Player_e6ab6393 ($9.85 in chips)
Seat 5: Hero ($14.36 in chips)
Seat 6: Player_af0344aa ($10.68 in chips)
Hero: posts small blind $0.05
Player_af0344aa: posts big blind $0.10
*** HOLE CARDS ***
Dealt to Hero [8h Ac]
Player_7d74746f: raises $0.25 to $0.35
Player_dec04d12: folds
Player_e6ab6393: folds
Hero: folds
Player_af0344aa: folds
Uncalled bet ($0.25) returned to Player_7d74746f
Player_7d74746f: doesn't show hand
Player_7d74746f collected $0.25 from pot
*** SUMMARY ***
Total pot $0.25
Seat 1: Player_7d74746f won ($0.25)
Seat 2: Player_dec04d12 mucked
Seat 4: Player_e6ab6393 (button) mucked
Seat 5: Hero (small blind) mucked
Seat 6: Player_af0344aa (big blind) mucked



PokerStars Hand #3591344120: Hold'em No Limit ($0.05/$0.10) - 2018/04/11 3:43:48
Table '#14913699' 6-max Seat #5 is the button
Seat 1: Player_2f3a8545 ($8.89 in chips)
Seat 2: Player_d46b6739 ($9.75 in chips)
Seat 4: Player_f8890432 ($9.85 in chips)
Seat 5: Hero ($14.31 in chips)
Seat 6: Player_b464752c ($10.58 in chips)
Player_b464752c: posts small blind $0.05
Player_2f3a8545: posts big blind $0.10
*** HOLE CARDS ***
Dealt to Hero [Ac 8d]
Player_d46b6739: raises $0.20 to $0.30
Player_f8890432: folds
Hero: folds
Player_b464752c: folds
Player_2f3a8545: folds
Uncalled bet ($0.20) returned to Player_d46b6739
Player_d46b6739: doesn't show hand
Player_d46b6739 collected $0.25 from pot
*** SUMMARY ***
Total pot $0.25
Seat 1: Player_2f3a8545 (big blind) mucked
Seat 2: Player_d46b6739 won ($0.25)
Seat 4: Player_f8890432 mucked
Seat 5: Hero (button) mucked
Seat 6: Player_b464752c (small blind) mucked



PokerStars Hand #3591344232: Hold'em No Limit ($0.05/$0.10) - 2018/04/11 3:44:14
Table '#14913699' 6-max Seat #6 is the button
Seat 1: Player_c76dff46 ($8.79 in chips)
Seat 2: Player_bd32cc5b ($9.90 in chips)
Seat 4: Player_63f91966 ($9.85 in chips)
Seat 5: Hero ($14.31 in chips)
Seat 6: Player_2baf582b ($10.53 in chips)
Player_c76dff46: posts small blind $0.05
Player_bd32cc5b: posts big blind $0.10
*** HOLE CARDS ***
Dealt to Hero [Js Qd]
Player_63f91966: folds
Hero: raises $0.25 to $0.35
Player_2baf582b: folds
Player_c76dff46: raises $0.90 to $1.25
Player_bd32cc5b: folds
Hero: folds
Uncalled bet ($0.90) returned to Player_c76dff46
Player_c76dff46: doesn't show hand
Player_c76dff46 collected $0.80 from pot
*** SUMMARY ***
Total pot $0.80
Seat 1: Player_c76dff46 (small blind) won ($0.80)
Seat 2: Player_bd32cc5b (big blind) mucked
Seat 4: Player_63f91966 mucked
Seat 5: Hero mucked
Seat 6: Player_2baf582b (button) mucked



PokerStars Hand #3591344436: Hold'em No Limit ($0.05/$0.10) - 2018/04/11 3:44:58
Table '#14913699' 6-max Seat #1 is the button
Seat 1: Player_8058d408 ($9.24 in chips)
Seat 2: Player_21b02787 ($9.80 in chips)
Seat 3: Player_c6586d82 ($6.90 in chips)
Seat 4: Player_f9f65cb2 ($9.85 in chips)
Seat 5: Hero ($13.96 in chips)
Seat 6: Player_b00f3608 ($10.53 in chips)
Player_21b02787: posts small blind $0.05
Player_c6586d82: posts big blind $0.10
*** HOLE CARDS ***
Dealt to Hero [Ac 5h]
Player_f9f65cb2: raises $0.20 to $0.30
Hero: folds
Player_b00f3608: folds
Player_8058d408: folds
Player_21b02787: folds
Player_c6586d82: calls $0.20 
*** FLOP *** [4h 8d 5c]
Player_c6586d82: bets $0.60 
Player_f9f65cb2: calls $0.60 
*** TURN *** [4h 8d 5c] [Kc]
Player_c6586d82: checks
Player_f9f65cb2: checks
*** RIVER *** [4h 8d 5c Kc] [4s]
Player_c6586d82: checks
Player_f9f65cb2: checks
*** SHOW DOWN ***
Player_c6586d82: shows [Qc 8c] (two pair, Eights and Fours)
Player_f9f65cb2: Mucks [6d 6h] (Two pair)
Player_c6586d82 collected $1.76 from pot
*** SUMMARY ***
Total pot $1.85 | Rake $0.09
Board [4h 8d 5c Kc 4s]
Seat 1: Player_8058d408 (button) mucked
Seat 2: Player_21b02787 (small blind) mucked
Seat 3: Player_c6586d82 (big blind) showed [Qc 8c] and won ($1.76) with two pair, Eights and Fours
Seat 4: Player_f9f65cb2 mucked [6d 6h]
Seat 5: Hero mucked
Seat 6: Player_b00f3608 mucked



PokerStars Hand #3591344680: Hold'em No Limit ($0.05/$0.10) - 2018/04/11 3:45:55
Table '#14913699' 6-max Seat #2 is the button
Seat 1: Player_b08c98bb ($9.24 in chips)
Seat 2: Player_3349c7b9 ($9.75 in chips)
Seat 3: Player_3186986e ($7.76 in chips)
Seat 4: Player_0299b892 ($10 in chips)
Seat 5: Hero ($13.96 in chips)
Seat 6: Player_0e1bf5d4 ($10.53 in chips)
Player_3186986e: posts small blind $0.05
Player_0299b892: posts big blind $0.10
*** HOLE CARDS ***
Dealt to Hero [2d 8c]
Hero: folds
Player_0e1bf5d4: folds
Player_b08c98bb: folds
Player_3349c7b9: raises $0.20 to $0.30
Player_3186986e: folds
Player_0299b892: calls $0.20 
*** FLOP *** [Kd 4s Tc]
Player_0299b892: checks
Player_3349c7b9: bets $0.30 
Player_0299b892: calls $0.30 
*** TURN *** [Kd 4s Tc] [Jc]
Player_0299b892: checks
Player_3349c7b9: bets $0.75 
Player_0299b892: calls $0.75 
*** RIVER *** [Kd 4s Tc Jc] [5d]
Player_0299b892: checks
Player_3349c7b9: bets $2.25 
Player_0299b892: folds
Uncalled bet ($2.25) returned to Player_3349c7b9
Player_3349c7b9: doesn't show hand
Player_3349c7b9 collected $2.62 from pot
*** SUMMARY ***
Total pot $2.75 | Rake $0.13
Board [Kd 4s Tc Jc 5d]
Seat 1: Player_b08c98bb mucked
Seat 2: Player_3349c7b9 (button) won ($2.62)
Seat 3: Player_3186986e (small blind) mucked
Seat 4: Player_0299b892 (big blind) mucked
Seat 5: Hero mucked
Seat 6: Player_0e1bf5d4 mucked



PokerStars Hand #3591344994: Hold'em No Limit ($0.05/$0.10) - 2018/04/11 3:47:10
Table '#14913699' 6-max Seat #3 is the button
Seat 1: Player_d001a4ef ($9.24 in chips)
Seat 2: Player_bffa7991 ($11.02 in chips)
Seat 3: Player_75543f50 ($7.71 in chips)
Seat 4: Player_6c603ca5 ($10 in chips)
Seat 5: Hero ($13.96 in chips)
Seat 6: Player_eb5830e9 ($10.53 in chips)
Player_6c603ca5: posts small blind $0.05
Hero: posts big blind $0.10
*** HOLE CARDS ***
Dealt to Hero [5h 7d]
Player_eb5830e9: folds
Player_d001a4ef: raises $0.20 to $0.30
Player_bffa7991: folds
Player_75543f50: calls $0.30 
Player_6c603ca5: folds
Hero: folds
*** FLOP *** [3c Ad Th]
Player_d001a4ef: checks
Player_75543f50: checks
*** TURN *** [3c Ad Th] [Ac]
Player_d001a4ef: checks
Player_75543f50: checks
*** RIVER *** [3c Ad Th Ac] [5s]
Player_d001a4ef: bets $0.47 
Player_75543f50: folds
Uncalled bet ($0.47) returned to Player_d001a4ef
Player_d001a4ef: doesn't show hand
Player_d001a4ef collected $0.72 from pot
*** SUMMARY ***
Total pot $0.75 | Rake $0.03
Board [3c Ad Th Ac 5s]
Seat 1: Player_d001a4ef won ($0.72)
Seat 2: Player_bffa7991 mucked
Seat 3: Player_75543f50 (button) mucked
Seat 4: Player_6c603ca5 (small blind) mucked
Seat 5: Hero (big blind) mucked
Seat 6: Player_eb5830e9 mucked



PokerStars Hand #3591345207: Hold'em No Limit ($0.05/$0.10) - 2018/04/11 3:48:01
Table '#14913699' 6-max Seat #4 is the button
Seat 1: Player_7f914768 ($9.66 in chips)
Seat 2: Player_15945313 ($11.02 in chips)
Seat 3: Player_76eb7181 ($7.41 in chips)
Seat 4: Player_2974038c ($9.95 in chips)
Seat 5: Hero ($13.86 in chips)
Seat 6: Player_cda8f57f ($10.53 in chips)
Hero: posts small blind $0.05
Player_cda8f57f: posts big blind $0.10
*** HOLE CARDS ***
Dealt to Hero [Jd 6h]
Player_7f914768: folds
Player_15945313: folds
Player_76eb7181: raises $0.20 to $0.30
Player_2974038c: folds
Hero: folds
Player_cda8f57f: folds
Uncalled bet ($0.20) returned to Player_76eb7181
Player_76eb7181: doesn't show hand
Player_76eb7181 collected $0.25 from pot
*** SUMMARY ***
Total pot $0.25
Seat 1: Player_7f914768 mucked
Seat 2: Player_15945313 mucked
Seat 3: Player_76eb7181 won ($0.25)
Seat 4: Player_2974038c (button) mucked
Seat 5: Hero (small blind) mucked
Seat 6: Player_cda8f57f (big blind) mucked



PokerStars Hand #3591345297: Hold'em No Limit ($0.05/$0.10) - 2018/04/11 3:48:21
Table '#14913699' 6-max Seat #5 is the button
Seat 1: Player_ed2e7de9 ($9.66 in chips)
Seat 2: Player_0ec4bc51 ($11.02 in chips)
Seat 3: Player_f528f148 ($7.56 in chips)
Seat 4: Player_80c0b415 ($9.95 in chips)
Seat 5: Hero ($13.81 in chips)
Seat 6: Player_a6730a5e ($10.43 in chips)
Player_a6730a5e: posts small blind $0.05
Player_ed2e7de9: posts big blind $0.10
*** HOLE CARDS ***
Dealt to Hero [Jd Td]
Player_0ec4bc51: folds
Player_f528f148: folds
Player_80c0b415: raises $0.20 to $0.30
Hero: calls $0.30 
Player_a6730a5e: folds
Player_ed2e7de9: calls $0.20 
*** FLOP *** [Ah 3s 7c]
Player_ed2e7de9: checks
Player_80c0b415: bets $0.58 
Hero: folds
Player_ed2e7de9: folds
Uncalled bet ($0.58) returned to Player_80c0b415
Player_80c0b415: doesn't show hand
Player_80c0b415 collected $0.91 from pot
*** SUMMARY ***
Total pot $0.95 | Rake $0.04
Board [Ah 3s 7c]
Seat 1: Player_ed2e7de9 (big blind) mucked
Seat 2: Player_0ec4bc51 mucked
Seat 3: Player_f528f148 mucked
Seat 4: Player_80c0b415 won ($0.91)
Seat 5: Hero (button) mucked
Seat 6: Player_a6730a5e (small blind) mucked



PokerStars Hand #3591345490: Hold'em No Limit ($0.05/$0.10) - 2018/04/11 3:49:13
Table '#14913699' 6-max Seat #6 is the button
Seat 1: Player_4ead8296 ($9.36 in chips)
Seat 2: Player_f9579529 ($11.02 in chips)
Seat 3: Player_ce32a039 ($7.56 in chips)
Seat 4: Player_df747f8f ($10.56 in chips)
Seat 5: Hero ($13.51 in chips)
Seat 6: Player_6f13091c ($10.38 in chips)
Player_4ead8296: posts small blind $0.05
Player_f9579529: posts big blind $0.10
*** HOLE CARDS ***
Dealt to Hero [Jd 4h]
Player_ce32a039: folds
Player_df747f8f: folds
Hero: folds
Player_6f13091c: folds
Player_4ead8296: folds
Player_f9579529: doesn't show hand
Player_f9579529 collected $0.15 from pot
*** SUMMARY ***
Total pot $0.15
Seat 1: Player_4ead8296 (small blind) mucked
Seat 2: Player_f9579529 (big blind) won ($0.15)
Seat 3: Player_ce32a039 mucked
Seat 4: Player_df747f8f mucked
Seat 5: Hero mucked
Seat 6: Player_6f13091c (button) mucked



PokerStars Hand #3591345558: Hold'em No Limit ($0.05/$0.10) - 2018/04/11 3:49:28
Table '#14913699' 6-max Seat #1 is the button
Seat 1: Player_a28af5b9 ($9.31 in chips)
Seat 2: Player_3dddc9d2 ($11.07 in chips)
Seat 3: Player_1d9c635a ($7.56 in chips)
Seat 4: Player_be86d1e2 ($10.56 in chips)
Seat 5: Hero ($13.51 in chips)
Seat 6: Player_95ef8a01 ($10.38 in chips)
Player_3dddc9d2: posts small blind $0.05
Player_1d9c635a: posts big blind $0.10
*** HOLE CARDS ***
Dealt to Hero [7s 3h]
Player_be86d1e2: folds
Hero: folds
Player_95ef8a01: raises $0.20 to $0.30
Player_a28af5b9: folds
Player_3dddc9d2: folds
Player_1d9c635a: calls $0.20 
*** FLOP *** [6s 2c 4c]
Player_1d9c635a: bets $0.90 
Player_95ef8a01: folds
Uncalled bet ($0.90) returned to Player_1d9c635a
Player_1d9c635a: doesn't show hand
Player_1d9c635a collected $0.62 from pot
*** SUMMARY ***
Total pot $0.65 | Rake $0.03
Board [6s 2c 4c]
Seat 1: Player_a28af5b9 (button) mucked
Seat 2: Player_3dddc9d2 (small blind) mucked
Seat 3: Player_1d9c635a (big blind) won ($0.62)
Seat 4: Player_be86d1e2 mucked
Seat 5: Hero mucked
Seat 6: Player_95ef8a01 mucked



PokerStars Hand #3591345723: Hold'em No Limit ($0.05/$0.10) - 2018/04/11 3:50:04
Table '#14913699' 6-max Seat #2 is the button
Seat 1: Player_7b9694fe ($9.31 in chips)
Seat 2: Player_3ab3162c ($11.02 in chips)
Seat 3: Player_97510621 ($7.88 in chips)
Seat 4: Player_87cc454c ($10.56 in chips)
Seat 5: Hero ($13.51 in chips)
Seat 6: Player_82aebea4 ($10.08 in chips)
Player_97510621: posts small blind $0.05
Player_87cc454c: posts big blind $0.10
*** HOLE CARDS ***
Dealt to Hero [6c 6s]
Hero: raises $0.25 to $0.35
Player_82aebea4: folds
Player_7b9694fe: calls $0.35 
Player_3ab3162c: folds
Player_97510621: folds
Player_87cc454c: folds
*** FLOP *** [8s 7c 4c]
Hero: checks
Player_97510621: Seat re-join
Player_7b9694fe: bets $0.55 
Hero: calls $0.55 
*** TURN *** [8s 7c 4c] [5d]
Hero: checks
Player_7b9694fe: bets $1.15 
Hero: calls $1.15 
*** RIVER *** [8s 7c 4c 5d] [Kh]
Hero: checks
Player_7b9694fe: checks
*** SHOW DOWN ***
Hero: shows [6c 6s] (a straight, Four to Eight)
Player_7b9694fe: Mucks [Qc 8c] (One pair)
Hero collected $4.04 from pot
*** SUMMARY ***
Total pot $4.25 | Rake $0.21
Board [8s 7c 4c 5d Kh]
Seat 1: Player_7b9694fe mucked [Qc 8c]
Seat 2: Player_3ab3162c (button) mucked
Seat 3: Player_97510621 (small blind) mucked
Seat 4: Player_87cc454c (big blind) mucked
Seat 5: Hero showed [6c 6s] and won ($4.04) with a straight, Four to Eight
Seat 6: Player_82aebea4 mucked



PokerStars Hand #3591346156: Hold'em No Limit ($0.05/$0.10) - 2018/04/11 3:51:48
Table '#14913699' 6-max Seat #3 is the button
Seat 1: Player_8e5dbaa3 ($7.26 in chips)
Seat 2: Player_4dd727b2 ($11.02 in chips)
Seat 3: Player_df6ebe64 ($7.83 in chips)
Seat 4: Player_8c633e54 ($10.46 in chips)
Seat 5: Hero ($15.50 in chips)
Seat 6: Player_f80ef5b4 ($10.08 in chips)
Player_8c633e54: posts small blind $0.05
Hero: posts big blind $0.10
*** HOLE CARDS ***
Dealt to Hero [Ad Qs]
Player_f80ef5b4: folds
Player_8e5dbaa3: folds
Player_4dd727b2: raises $0.20 to $0.30
Player_df6ebe64: folds
Player_8c633e54: folds
Hero: raises $0.69 to $0.99
Player_4dd727b2: calls $0.69 
*** FLOP *** [Jc 4c Kh]
Hero: checks
Player_4dd727b2: checks
*** TURN *** [Jc 4c Kh] [4h]
Hero: checks
Player_4dd727b2: bets $1.25 
Hero: calls $1.25 
*** RIVER *** [Jc 4c Kh 4h] [9h]
Hero: checks
Player_4dd727b2: bets $2.95 
Hero: calls $2.95 
*** SHOW DOWN ***
Player_4dd727b2: shows [4d Td] (three of a kind, Fours)
Hero: Mucks [Ad Qs] (One pair)
Player_4dd727b2 collected $9.91 from pot
*** SUMMARY ***
Total pot $10.43 | Rake $0.52
Board [Jc 4c Kh 4h 9h]
Seat 1: Player_8e5dbaa3 mucked
Seat 2: Player_4dd727b2 showed [4d Td] and won ($9.91) with three of a kind, Fours
Seat 3: Player_df6ebe64 (button) mucked
Seat 4: Player_8c633e54 (small blind) mucked
Seat 5: Hero (big blind) mucked [Ad Qs]
Seat 6: Player_f80ef5b4 mucked



PokerStars Hand #3591346631: Hold'em No Limit ($0.05/$0.10) - 2018/04/11 3:53:41
Table '#14913699' 6-max Seat #4 is the button
Seat 1: Player_1f2c8063 ($7.26 in chips)
Seat 2: Player_1547c5ec ($15.74 in chips)
Seat 3: Player_fc448e62 ($7.83 in chips)
Seat 4: Player_50091c67 ($10.41 in chips)
Seat 5: Hero ($10.31 in chips)
Seat 6: Player_caf14fbe ($10.08 in chips)
Hero: posts small blind $0.05
Player_caf14fbe: posts big blind $0.10
*** HOLE CARDS ***
Dealt to Hero [5c 3s]
Player_1f2c8063: folds
Player_1547c5ec: raises $0.20 to $0.30
Player_fc448e62: folds
Player_50091c67: folds
Hero: folds
Player_caf14fbe: folds
Uncalled bet ($0.20) returned to Player_1547c5ec
Player_1547c5ec: doesn't show hand
Player_1547c5ec collected $0.25 from pot
*** SUMMARY ***
Total pot $0.25
Seat 1: Player_1f2c8063 mucked
Seat 2: Player_1547c5ec won ($0.25)
Seat 3: Player_fc448e62 mucked
Seat 4: Player_50091c67 (button) mucked
Seat 5: Hero (small blind) mucked
Seat 6: Player_caf14fbe (big blind) mucked



PokerStars Hand #3591346712: Hold'em No Limit ($0.05/$0.10) - 2018/04/11 3:54:02
Table '#14913699' 6-max Seat #5 is the button
Seat 1: Player_aabe1575 ($7.26 in chips)
Seat 2: Player_30ff6a02 ($15.89 in chips)
Seat 3: Player_e26c0f28 ($7.83 in chips)
Seat 4: Player_e213eb69 ($10.41 in chips)
Seat 5: Hero ($10.26 in chips)
Seat 6: Player_4ebd30f3 ($9.98 in chips)
Player_4ebd30f3: posts small blind $0.05
Player_aabe1575: posts big blind $0.10
*** HOLE CARDS ***
Dealt to Hero [8c 5s]
Player_30ff6a02: folds
Player_e26c0f28: raises $0.30 to $0.40
Player_e213eb69: calls $0.40 
Hero: folds
Player_4ebd30f3: folds
Player_aabe1575: folds
*** FLOP *** [4h 4c Ad]
Player_e26c0f28: checks
Player_e213eb69: bets $0.57 
Player_e26c0f28: folds
Uncalled bet ($0.57) returned to Player_e213eb69
Player_e213eb69: doesn't show hand
Player_e213eb69 collected $0.91 from pot
*** SUMMARY ***
Total pot $0.95 | Rake $0.04
Board [4h 4c Ad]
Seat 1: Player_aabe1575 (big blind) mucked
Seat 2: Player_30ff6a02 mucked
Seat 3: Player_e26c0f28 mucked
Seat 4: Player_e213eb69 won ($0.91)
Seat 5: Hero (button) mucked
Seat 6: Player_4ebd30f3 (small blind) mucked



PokerStars Hand #3591346857: Hold'em No Limit ($0.05/$0.10) - 2018/04/11 3:54:34
Table '#14913699' 6-max Seat #6 is the button
Seat 1: Player_328cf12a ($7.16 in chips)
Seat 2: Player_63a4834f ($15.89 in chips)
Seat 3: Player_348b1a73 ($7.43 in chips)
Seat 4: Player_105e03a6 ($10.92 in chips)
Seat 5: Hero ($10.26 in chips)
Seat 6: Player_e8ad45dc ($9.93 in chips)
Player_328cf12a: posts small blind $0.05
Player_63a4834f: posts big blind $0.10
*** HOLE CARDS ***
Dealt to Hero [4d 5c]
Player_348b1a73: folds
Player_105e03a6: folds
Hero: folds
Player_e8ad45dc: folds
Player_328cf12a: folds
Player_63a4834f: doesn't show hand
Player_63a4834f collected $0.15 from pot
*** SUMMARY ***
Total pot $0.15
Seat 1: Player_328cf12a (small blind) mucked
Seat 2: Player_63a4834f (big blind) won ($0.15)
Seat 3: Player_348b1a73 mucked
Seat 4: Player_105e03a6 mucked
Seat 5: Hero mucked
Seat 6: Player_e8ad45dc (button) mucked



PokerStars Hand #3591346925: Hold'em No Limit ($0.05/$0.10) - 2018/04/11 3:54:50
Table '#14913699' 6-max Seat #1 is the button
Seat 1: Player_755f6426 ($7.11 in chips)
Seat 2: Player_d84fa4a9 ($15.94 in chips)
Seat 3: Player_93e1ae3c ($7.43 in chips)
Seat 4: Player_5b34aefd ($10.92 in chips)
Seat 5: Hero ($10.26 in chips)
Seat 6: Player_f0dd4dbe ($9.93 in chips)
Player_d84fa4a9: posts small blind $0.05
Player_93e1ae3c: posts big blind $0.10
*** HOLE CARDS ***
Dealt to Hero [3s Kc]
Player_5b34aefd: folds
Hero: folds
Player_f0dd4dbe: raises $0.20 to $0.30
Player_755f6426: folds
Player_d84fa4a9: calls $0.25 
Player_93e1ae3c: folds
*** FLOP *** [4s 3c 9h]
Player_d84fa4a9: checks
Player_f0dd4dbe: bets $0.35 
Player_d84fa4a9: folds
Uncalled bet ($0.35) returned to Player_f0dd4dbe
Player_f0dd4dbe: doesn't show hand
Player_f0dd4dbe collected $0.67 from pot
*** SUMMARY ***
Total pot $0.70 | Rake $0.03
Board [4s 3c 9h]
Seat 1: Player_755f6426 (button) mucked
Seat 2: Player_d84fa4a9 (small blind) mucked
Seat 3: Player_93e1ae3c (big blind) mucked
Seat 4: Player_5b34aefd mucked
Seat 5: Hero mucked
Seat 6: Player_f0dd4dbe won ($0.67)



PokerStars Hand #3591347127: Hold'em No Limit ($0.05/$0.10) - 2018/04/11 3:55:39
Table '#14913699' 6-max Seat #2 is the button
Seat 1: Player_bde0d017 ($7.11 in chips)
Seat 2: Player_f7057578 ($15.64 in chips)
Seat 3: Player_cb9e7bbf ($7.33 in chips)
Seat 4: Player_9b719882 ($10.92 in chips)
Seat 5: Hero ($10.26 in chips)
Seat 6: Player_54efc38b ($10.30 in chips)
Player_cb9e7bbf: posts small blind $0.05
Player_9b719882: posts big blind $0.10
*** HOLE CARDS ***
Dealt to Hero [6d 7d]
Hero: raises $0.30 to $0.40
Player_54efc38b: calls $0.40 
Player_bde0d017: folds
Player_f7057578: folds
Player_cb9e7bbf: folds
Player_9b719882: folds
*** FLOP *** [7s 2d 8h]
Hero: checks
Player_54efc38b: bets $0.62 
Hero: calls $0.62 
*** TURN *** [7s 2d 8h] [7h]
Hero: checks
Player_54efc38b: bets $1.35 
Hero: calls $1.35 
*** RIVER *** [7s 2d 8h 7h] [4h]
Hero: checks
Player_54efc38b: checks
*** SHOW DOWN ***
Hero: shows [6d 7d] (three of a kind, Sevens)
Player_54efc38b: Mucks [Qs Ts] (One pair)
Hero collected $4.65 from pot
*** SUMMARY ***
Total pot $4.89 | Rake $0.24
Board [7s 2d 8h 7h 4h]
Seat 1: Player_bde0d017 mucked
Seat 2: Player_f7057578 (button) mucked
Seat 3: Player_cb9e7bbf (small blind) mucked
Seat 4: Player_9b719882 (big blind) mucked
Seat 5: Hero showed [6d 7d] and won ($4.65) with three of a kind, Sevens
Seat 6: Player_54efc38b mucked [Qs Ts]



PokerStars Hand #3591347428: Hold'em No Limit ($0.05/$0.10) - 2018/04/11 3:56:53
Table '#14913699' 6-max Seat #3 is the button
Seat 1: Player_a1951305 ($7.11 in chips)
Seat 2: Player_d210de4d ($15.64 in chips)
Seat 3: Player_0874f95a ($7.28 in chips)
Seat 4: Player_7998832d ($10.82 in chips)
Seat 5: Hero ($12.54 in chips)
Seat 6: Player_726dd47b ($7.93 in chips)
Player_7998832d: posts small blind $0.05
Hero: posts big blind $0.10
*** HOLE CARDS ***
Dealt to Hero [Js 8h]
Player_726dd47b: folds
Player_a1951305: folds
Player_d210de4d: folds
Player_0874f95a: folds
Player_7998832d: raises $0.20 to $0.30
Hero: calls $0.20 
*** FLOP *** [9d Kh 7s]
Player_7998832d: bets $0.35 
Hero: raises $0.75 to $1.10
Player_7998832d: calls $0.75 
*** TURN *** [9d Kh 7s] [Ac]
Player_7998832d: checks
Hero: bets $2 
Player_7998832d: folds
Uncalled bet ($2) returned to Hero
Hero: doesn't show hand
Hero collected $2.66 from pot
*** SUMMARY ***
Total pot $2.80 | Rake $0.14
Board [9d Kh 7s Ac]
Seat 1: Player_a1951305 mucked
Seat 2: Player_d210de4d mucked
Seat 3: Player_0874f95a (button) mucked
Seat 4: Player_7998832d (small blind) mucked
Seat 5: Hero (big blind) won ($2.66)
Seat 6: Player_726dd47b mucked



PokerStars Hand #3591347754: Hold'em No Limit ($0.05/$0.10) - 2018/04/11 3:58:15
Table '#14913699' 6-max Seat #4 is the button
Seat 1: Player_1a60e253 ($7.11 in chips)
Seat 2: Player_6047dd48 ($15.64 in chips)
Seat 3: Player_b7c6c6bf ($7.28 in chips)
Seat 4: Player_07c08224 ($10 in chips)
Seat 5: Hero ($13.80 in chips)
Seat 6: Player_09bd6477 ($10 in chips)
Hero: posts small blind $0.05
Player_09bd6477: posts big blind $0.10
*** HOLE CARDS ***
Dealt to Hero [4c Jd]
Player_1a60e253: folds
Player_6047dd48: folds
Player_b7c6c6bf: folds
Player_07c08224: folds
Hero: folds
Player_09bd6477: doesn't show hand
Player_09bd6477 collected $0.15 from pot
*** SUMMARY ***
Total pot $0.15
Seat 1: Player_1a60e253 mucked
Seat 2: Player_6047dd48 mucked
Seat 3: Player_b7c6c6bf mucked
Seat 4: Player_07c08224 (button) mucked
Seat 5: Hero (small blind) mucked
Seat 6: Player_09bd6477 (big blind) won ($0.15)



PokerStars Hand #3591347802: Hold'em No Limit ($0.05/$0.10) - 2018/04/11 3:58:28
Table '#14913699' 6-max Seat #5 is the button
Seat 1: Player_b884d367 ($7.11 in chips)
Seat 2: Player_429587fb ($15.64 in chips)
Seat 3: Player_0b6b8c38 ($7.28 in chips)
Seat 4: Player_0c2de263 ($10 in chips)
Seat 5: Hero ($13.75 in chips)
Seat 6: Player_d5b8dce5 ($10.05 in chips)
Player_d5b8dce5: posts small blind $0.05
Player_b884d367: posts big blind $0.10
*** HOLE CARDS ***
Dealt to Hero [Qs 8s]
Player_429587fb: folds
Player_0b6b8c38: folds
Player_0c2de263: raises $0.20 to $0.30
Hero: calls $0.30 
Player_d5b8dce5: folds
Player_b884d367: calls $0.20 
*** FLOP *** [7c 6s 7d]
Player_b884d367: checks
Player_0c2de263: checks
Hero: bets $0.40 
Player_b884d367: folds
Player_0c2de263: folds
Uncalled bet ($0.40) returned to Hero
Hero: doesn't show hand
Hero collected $0.91 from pot
*** SUMMARY ***
Total pot $0.95 | Rake $0.04
Board [7c 6s 7d]
Seat 1: Player_b884d367 (big blind) mucked
Seat 2: Player_429587fb mucked
Seat 3: Player_0b6b8c38 mucked
Seat 4: Player_0c2de263 mucked
Seat 5: Hero (button) won ($0.91)
Seat 6: Player_d5b8dce5 (small blind) mucked



PokerStars Hand #3591348111: Hold'em No Limit ($0.05/$0.10) - 2018/04/11 3:59:47
Table '#14913699' 6-max Seat #6 is the button
Seat 1: Player_c75b8127 ($9.31 in chips)
Seat 2: Player_b7a0f431 ($15.64 in chips)
Seat 3: Player_3092005b ($7.28 in chips)
Seat 4: Player_00801cb6 ($10 in chips)
Seat 5: Hero ($14.36 in chips)
Seat 6: Player_777085bc ($10 in chips)
Player_c75b8127: posts small blind $0.05
Player_b7a0f431: posts big blind $0.10
*** HOLE CARDS ***
Dealt to Hero [5c Th]
Player_3092005b: raises $0.20 to $0.30
Player_00801cb6: folds
Hero: folds
Player_777085bc: calls $0.30 
Player_c75b8127: folds
Player_b7a0f431: calls $0.20 
*** FLOP *** [4h Kc 7h]
Player_b7a0f431: checks
Player_3092005b: bets $0.90 
Player_777085bc: folds
Player_b7a0f431: calls $0.90 
*** TURN *** [4h Kc 7h] [As]
Player_b7a0f431: checks
Player_3092005b: checks
*** RIVER *** [4h Kc 7h As] [2h]
Player_b7a0f431: checks
Player_3092005b: bets $1 
Player_b7a0f431: folds
Uncalled bet ($1) returned to Player_3092005b
Player_3092005b: doesn't show hand
Player_3092005b collected $2.62 from pot
*** SUMMARY ***
Total pot $2.75 | Rake $0.13
Board [4h Kc 7h As 2h]
Seat 1: Player_c75b8127 (small blind) mucked
Seat 2: Player_b7a0f431 (big blind) mucked
Seat 3: Player_3092005b won ($2.62)
Seat 4: Player_00801cb6 mucked
Seat 5: Hero mucked
Seat 6: Player_777085bc (button) mucked



PokerStars Hand #3591348378: Hold'em No Limit ($0.05/$0.10) - 2018/04/11 4:00:54
Table '#14913699' 6-max Seat #1 is the button
Seat 1: Player_eb5691b7 ($9.26 in chips)
Seat 2: Player_b5fdb475 ($14.44 in chips)
Seat 3: Player_bca23619 ($8.70 in chips)
Seat 4: Player_376a8d4e ($10 in chips)
Seat 5: Hero ($14.36 in chips)
Seat 6: Player_f534d60b ($9.70 in chips)
Player_b5fdb475: posts small blind $0.05
Player_bca23619: posts big blind $0.10
*** HOLE CARDS ***
Dealt to Hero [6h Ts]
Player_376a8d4e: folds
Hero: folds
Player_f534d60b: raises $0.20 to $0.30
Player_eb5691b7: folds
Player_b5fdb475: folds
Player_bca23619: calls $0.20 
*** FLOP *** [Qd 4d 7s]
Player_bca23619: bets $0.60 
Player_f534d60b: calls $0.60 
*** TURN *** [Qd 4d 7s] [3s]
Player_bca23619: bets $0.80 
Player_f534d60b: calls $0.80 
*** RIVER *** [Qd 4d 7s 3s] [4c]
Player_bca23619: checks
Player_f534d60b: bets $2.12 
Player_bca23619: calls $2.12 
*** SHOW DOWN ***
Player_f534d60b: shows [8d 6d] (a pair of Fours)
Player_bca23619: shows [Qh Kd] (two pair, Queens and Fours)
Player_bca23619 collected $7.31 from pot
*** SUMMARY ***
Total pot $7.69 | Rake $0.38
Board [Qd 4d 7s 3s 4c]
Seat 1: Player_eb5691b7 (button) mucked
Seat 2: Player_b5fdb475 (small blind) mucked
Seat 3: Player_bca23619 (big blind) showed [Qh Kd] and won ($7.31) with two pair, Queens and Fours
Seat 4: Player_376a8d4e mucked
Seat 5: Hero mucked
Seat 6: Player_f534d60b showed [8d 6d] and lost with a pair of Fours



PokerStars Hand #3591348655: Hold'em No Limit ($0.05/$0.10) - 2018/04/11 4:02:04
Table '#14913699' 6-max Seat #2 is the button
Seat 1: Player_1595d121 ($9.26 in chips)
Seat 2: Player_483bb686 ($14.39 in chips)
Seat 3: Player_9af75f66 ($12.19 in chips)
Seat 4: Player_29b16571 ($10 in chips)
Seat 5: Hero ($14.36 in chips)
Seat 6: Player_6e38c089 ($5.88 in chips)
Player_9af75f66: posts small blind $0.05
Player_29b16571: posts big blind $0.10
*** HOLE CARDS ***
Dealt to Hero [6s 8h]
Hero: folds
Player_6e38c089: raises $0.20 to $0.30
Player_1595d121: folds
Player_483bb686: folds
Player_9af75f66: folds
Player_29b16571: folds
Uncalled bet ($0.20) returned to Player_6e38c089
Player_6e38c089: doesn't show hand
Player_6e38c089 collected $0.25 from pot
*** SUMMARY ***
Total pot $0.25
Seat 1: Player_1595d121 mucked
Seat 2: Player_483bb686 (button) mucked
Seat 3: Player_9af75f66 (small blind) mucked
Seat 4: Player_29b16571 (big blind) mucked
Seat 5: Hero mucked
Seat 6: Player_6e38c089 won ($0.25)



PokerStars Hand #3591348726: Hold'em No Limit ($0.05/$0.10) - 2018/04/11 4:02:24
Table '#14913699' 6-max Seat #3 is the button
Seat 1: Player_54694861 ($9.26 in chips)
Seat 2: Player_1f0160f5 ($14.39 in chips)
Seat 3: Player_324d6208 ($12.14 in chips)
Seat 4: Player_64b2e10b ($9.90 in chips)
Seat 5: Hero ($14.36 in chips)
Seat 6: Player_cf9deb6c ($6.03 in chips)
Player_64b2e10b: posts small blind $0.05
Hero: posts big blind $0.10
*** HOLE CARDS ***
Dealt to Hero [6c Kc]
Player_cf9deb6c: raises $0.20 to $0.30
Player_54694861: folds
Player_1f0160f5: folds
Player_324d6208: folds
Player_64b2e10b: folds
Hero: calls $0.20 
*** FLOP *** [Js 7c 9s]
Hero: checks
Player_cf9deb6c: bets $0.42 
Hero: folds
Uncalled bet ($0.42) returned to Player_cf9deb6c
Player_cf9deb6c: doesn't show hand
Player_cf9deb6c collected $0.62 from pot
*** SUMMARY ***
Total pot $0.65 | Rake $0.03
Board [Js 7c 9s]
Seat 1: Player_54694861 mucked
Seat 2: Player_1f0160f5 mucked
Seat 3: Player_324d6208 (button) mucked
Seat 4: Player_64b2e10b (small blind) mucked
Seat 5: Hero (big blind) mucked
Seat 6: Player_cf9deb6c won ($0.62)



PokerStars Hand #3591348872: Hold'em No Limit ($0.05/$0.10) - 2018/04/11 4:03:02
Table '#14913699' 6-max Seat #4 is the button
Seat 1: Player_e8fb2477 ($9.26 in chips)
Seat 2: Player_aeff5589 ($14.39 in chips)
Seat 4: Player_d91a082e ($9.85 in chips)
Seat 5: Hero ($14.06 in chips)
Seat 6: Player_67e362c5 ($10 in chips)
Hero: posts small blind $0.05
Player_67e362c5: posts big blind $0.10
*** HOLE CARDS ***
Dealt to Hero [5d 6d]
Player_e8fb2477: raises $0.20 to $0.30
Player_aeff5589: folds
Player_d91a082e: folds
Hero: calls $0.25 
Player_67e362c5: folds
*** FLOP *** [3s 4s Qh]
Hero: checks
Player_e8fb2477: bets $0.40 
Seat sit down
Hero: raises $0.60 to $1
Player_e8fb2477: calls $0.60 
*** TURN *** [3s 4s Qh] [Kc]
Hero: checks
Player_e8fb2477: bets $1.75 
Hero: folds
Uncalled bet ($1.75) returned to Player_e8fb2477
Player_e8fb2477: doesn't show hand
Player_e8fb2477 collected $2.57 from pot
*** SUMMARY ***
Total pot $2.70 | Rake $0.13
Board [3s 4s Qh Kc]
Seat 1: Player_e8fb2477 won ($2.57)
Seat 2: Player_aeff5589 mucked
Seat 4: Player_d91a082e (button) mucked
Seat 5: Hero (small blind) mucked
Seat 6: Player_67e362c5 (big blind) mucked



PokerStars Hand #3591349250: Hold'em No Limit ($0.05/$0.10) - 2018/04/11 4:04:42
Table '#14913699' 6-max Seat #5 is the button
Seat 1: Player_74476e68 ($10.53 in chips)
Seat 2: Player_240888bc ($14.39 in chips)
Seat 3: Player_913b0c04 ($3 in chips)
Seat 4: Player_b1bbcab5 ($9.85 in chips)
Seat 5: Hero ($12.76 in chips)
Seat 6: Player_4edf8d89 ($9.90 in chips)
Player_4edf8d89: posts small blind $0.05
Player_74476e68: posts big blind $0.10
Player_913b0c04: posts big blind $0.10
*** HOLE CARDS ***
Dealt to Hero [7c 2c]
Player_240888bc: raises $0.25 to $0.35
Player_913b0c04: calls $0.25 
Player_b1bbcab5: folds
Hero: folds
Player_4edf8d89: folds
Player_74476e68: folds
*** FLOP *** [Ts Ks Jd]
Player_240888bc: bets $0.45 
Player_913b0c04: folds
Uncalled bet ($0.45) returned to Player_240888bc
Player_240888bc: doesn't show hand
Player_240888bc collected $0.81 from pot
*** SUMMARY ***
Total pot $0.85 | Rake $0.04
Board [Ts Ks Jd]
Seat 1: Player_74476e68 (big blind) mucked
Seat 2: Player_240888bc won ($0.81)
Seat 3: Player_913b0c04 mucked
Seat 4: Player_b1bbcab5 mucked
Seat 5: Hero (button) mucked
Seat 6: Player_4edf8d89 (small blind) mucked




