PokerStars Hand #3661260797: Tournament #21391319, $20+$2 - Hold'em No Limit (30/60) - 2018/04/06 22:06:14
Table '#18' Seat #5 is the button
Seat 1: Player_110bb56b (10,000 in chips)
Seat 2: Player_59faed2e (9,980 in chips)
Seat 3: Hero (10,000 in chips)
Seat 4: Player_c7098561 (10,000 in chips)
Seat 5: Player_fd9e87a0 (10,020 in chips)
Seat 6: Player_b087af24 (10,029 in chips)
Seat 7: Player_bfad040a (14,870 in chips)
Player_b087af24: posts small blind 30
Player_bfad040a: posts big blind 60
*** HOLE CARDS ***
Dealt to Hero [Qd 7h]
Player_110bb56b: folds
Player_59faed2e: folds
Hero: folds
Player_c7098561: folds
Player_fd9e87a0: folds
Player_b087af24: raises 150 to 180
Player_bfad040a: calls 120 
*** FLOP *** [Ac 4c Qh]
Player_b087af24: bets 200 
Player_bfad040a: calls 200 
*** TURN *** [Ac 4c Qh] [Jh]
Player_b087af24: bets 400 
Player_bfad040a: calls 400 
*** RIVER *** [Ac 4c Qh Jh] [2c]
Player_b087af24: bets 750 
Player_bfad040a: calls 750 
*** SHOW DOWN ***
Player_b087af24: shows [Ad Jd] (two pair, Aces and Jacks)
Player_bfad040a: Mucks [Td Ah] (One pair)
Player_b087af24 collected 3060 from pot
*** SUMMARY ***
Total pot 3060 | Rake 0
Board [Ac 4c Qh Jh 2c]
Seat 1: Player_110bb56b mucked
Seat 2: Player_59faed2e mucked
Seat 3: Hero mucked
Seat 4: Player_c7098561 mucked
Seat 5: Player_fd9e87a0 (button) mucked
Seat 6: Player_b087af24 (small blind) showed [Ad Jd] and won (3060) with two pair, Aces and Jacks
Seat 7: Player_bfad040a (big blind) mucked [Td Ah]



PokerStars Hand #3661261701: Tournament #21391319, $20+$2 - Hold'em No Limit (30/60) - 2018/04/06 22:07:41
Table '#18' Seat #7 is the button
Seat 1: Player_0aba9223 (10,000 in chips)
Seat 2: Player_a0b55fa1 (9,980 in chips)
Seat 3: Hero (10,000 in chips)
Seat 4: Player_2abdcfc1 (10,020 in chips)
Seat 5: Player_61afad58 (10,000 in chips)
Seat 6: Player_91b6ac06 (10,000 in chips)
Seat 7: Player_6d6da6fa (11,559 in chips)
Seat 8: Player_c0a20c19 (13,340 in chips)
Player_c0a20c19: posts small blind 30
Player_0aba9223: posts big blind 60
*** HOLE CARDS ***
Dealt to Hero [5h Th]
Player_a0b55fa1: folds
Hero: folds
Player_2abdcfc1: folds
Player_61afad58: folds
Player_91b6ac06: raises 120 to 120
Player_6d6da6fa: calls 120 
Player_c0a20c19: folds
Player_0aba9223: folds
*** FLOP *** [Jh 7h 8c]
Player_91b6ac06: bets 60 
Player_6d6da6fa: calls 60 
*** TURN *** [Jh 7h 8c] [6d]
Player_91b6ac06: bets 60 
Player_6d6da6fa: raises 222 to 222
Player_91b6ac06: folds
Uncalled bet (162) returned to Player_6d6da6fa
Player_6d6da6fa: doesn't show hand
Player_6d6da6fa collected 570 from pot
*** SUMMARY ***
Total pot 570 | Rake 0
Board [Jh 7h 8c 6d]
Seat 1: Player_0aba9223 (big blind) mucked
Seat 2: Player_a0b55fa1 mucked
Seat 3: Hero mucked
Seat 4: Player_2abdcfc1 mucked
Seat 5: Player_61afad58 mucked
Seat 6: Player_91b6ac06 mucked
Seat 7: Player_6d6da6fa (button) won (570)
Seat 8: Player_c0a20c19 (small blind) mucked



PokerStars Hand #3661262348: Tournament #21391319, $20+$2 - Hold'em No Limit (30/60) - 2018/04/06 22:08:41
Table '#18' Seat #9 is the button
Seat 1: Player_392ed639 (9,940 in chips)
Seat 2: Player_edc1ac15 (9,980 in chips)
Seat 3: Hero (10,000 in chips)
Seat 4: Player_1d5c506f (10,000 in chips)
Seat 5: Player_9be9ccc8 (10,020 in chips)
Seat 6: Player_9ad508b6 (10,000 in chips)
Seat 7: Player_fed248ac (9,760 in chips)
Seat 8: Player_35b3c0b1 (11,889 in chips)
Seat 9: Player_1d31feec (13,310 in chips)
Player_392ed639: posts small blind 30
Player_edc1ac15: posts big blind 60
*** HOLE CARDS ***
Dealt to Hero [Ah Qs]
Hero: raises 180 to 180
Player_1d5c506f: folds
Player_9be9ccc8: folds
Player_9ad508b6: folds
Player_fed248ac: calls 180 
Player_35b3c0b1: folds
Player_1d31feec: folds
Player_392ed639: calls 150 
Player_edc1ac15: folds
*** FLOP *** [Qh 8d Jd]
Player_392ed639: checks
Hero: bets 400 
Player_fed248ac: folds
Player_392ed639: folds
Uncalled bet (400) returned to Hero
Hero: doesn't show hand
Hero collected 600 from pot
*** SUMMARY ***
Total pot 600 | Rake 0
Board [Qh 8d Jd]
Seat 1: Player_392ed639 (small blind) mucked
Seat 2: Player_edc1ac15 (big blind) mucked
Seat 3: Hero won (600)
Seat 4: Player_1d5c506f mucked
Seat 5: Player_9be9ccc8 mucked
Seat 6: Player_9ad508b6 mucked
Seat 7: Player_fed248ac mucked
Seat 8: Player_35b3c0b1 mucked
Seat 9: Player_1d31feec (button) mucked



PokerStars Hand #3661263420: Tournament #21391319, $20+$2 - Hold'em No Limit (30/60) - 2018/04/06 22:10:26
Table '#18' Seat #1 is the button
Seat 1: Player_6f4d7a6d (9,760 in chips)
Seat 2: Player_dcc48f7e (9,920 in chips)
Seat 3: Hero (10,420 in chips)
Seat 4: Player_a0e038d7 (10,000 in chips)
Seat 5: Player_88c20c1a (10,020 in chips)
Seat 6: Player_df24feb3 (10,000 in chips)
Seat 7: Player_41aff755 (9,580 in chips)
Seat 8: Player_d80ebccb (11,889 in chips)
Seat 9: Player_e0bad436 (13,310 in chips)
Player_dcc48f7e: posts small blind 30
Hero: posts big blind 60
*** HOLE CARDS ***
Dealt to Hero [8d 3h]
Player_a0e038d7: folds
Player_88c20c1a: folds
Player_df24feb3: folds
Player_41aff755: calls 60 
Player_d80ebccb: raises 270 to 270
Player_e0bad436: calls 270 
Player_6f4d7a6d: folds
Player_dcc48f7e: folds
Hero: folds
Player_41aff755: calls 210 
*** FLOP *** [2c 8s 9d]
Player_41aff755: checks
Player_d80ebccb: bets 360 
Player_e0bad436: calls 360 
Player_41aff755: folds
*** TURN *** [2c 8s 9d] [7d]
Player_d80ebccb: bets 890 
Player_e0bad436: folds
Uncalled bet (890) returned to Player_d80ebccb
Player_d80ebccb: doesn't show hand
Player_d80ebccb collected 1620 from pot
*** SUMMARY ***
Total pot 1620 | Rake 0
Board [2c 8s 9d 7d]
Seat 1: Player_6f4d7a6d (button) mucked
Seat 2: Player_dcc48f7e (small blind) mucked
Seat 3: Hero (big blind) mucked
Seat 4: Player_a0e038d7 mucked
Seat 5: Player_88c20c1a mucked
Seat 6: Player_df24feb3 mucked
Seat 7: Player_41aff755 mucked
Seat 8: Player_d80ebccb won (1620)
Seat 9: Player_e0bad436 mucked



PokerStars Hand #3661264773: Tournament #21391319, $20+$2 - Hold'em No Limit (30/60) - 2018/04/06 22:12:35
Table '#18' Seat #2 is the button
Seat 1: Player_a2173c49 (9,760 in chips)
Seat 2: Player_3201fa48 (9,890 in chips)
Seat 3: Hero (10,360 in chips)
Seat 4: Player_e3e3e9dc (10,000 in chips)
Seat 5: Player_7af85f52 (10,020 in chips)
Seat 6: Player_84793d96 (10,000 in chips)
Seat 7: Player_836bcce4 (9,310 in chips)
Seat 8: Player_934bcdb2 (12,879 in chips)
Seat 9: Player_4e30e79f (12,680 in chips)
Hero: posts small blind 30
Player_e3e3e9dc: posts big blind 60
*** HOLE CARDS ***
Dealt to Hero [3d 9c]
Player_7af85f52: folds
Player_84793d96: folds
Player_836bcce4: raises 207 to 207
Player_934bcdb2: calls 207 
Player_4e30e79f: folds
Player_a2173c49: folds
Player_3201fa48: folds
Hero: folds
Player_e3e3e9dc: folds
*** FLOP *** [5h Qd 4c]
Player_836bcce4: bets 254 
Player_934bcdb2: calls 254 
*** TURN *** [5h Qd 4c] [7d]
Player_836bcce4: bets 509 
Player_934bcdb2: calls 509 
*** RIVER *** [5h Qd 4c 7d] [Ks]
Player_836bcce4: checks
Player_934bcdb2: checks
*** SHOW DOWN ***
Player_836bcce4: shows [Td Ac] (high card Ace)
Player_934bcdb2: shows [Qh Jh] (a pair of Queens)
Player_934bcdb2 collected 2030 from pot
*** SUMMARY ***
Total pot 2030 | Rake 0
Board [5h Qd 4c 7d Ks]
Seat 1: Player_a2173c49 mucked
Seat 2: Player_3201fa48 (button) mucked
Seat 3: Hero (small blind) mucked
Seat 4: Player_e3e3e9dc (big blind) mucked
Seat 5: Player_7af85f52 mucked
Seat 6: Player_84793d96 mucked
Seat 7: Player_836bcce4 showed [Td Ac] and lost with high card Ace
Seat 8: Player_934bcdb2 showed [Qh Jh] and won (2030) with a pair of Queens
Seat 9: Player_4e30e79f mucked



PokerStars Hand #3661265930: Tournament #21391319, $20+$2 - Hold'em No Limit (30/60) - 2018/04/06 22:14:23
Table '#18' Seat #3 is the button
Seat 1: Player_9b74be39 (9,760 in chips)
Seat 2: Player_be085def (9,890 in chips)
Seat 3: Hero (10,330 in chips)
Seat 4: Player_a7a5556d (9,940 in chips)
Seat 5: Player_7e4e053f (10,020 in chips)
Seat 6: Player_f86c80c6 (10,000 in chips)
Seat 7: Player_20f8cbec (8,340 in chips)
Seat 8: Player_d3cf7a76 (13,939 in chips)
Seat 9: Player_35e16491 (12,680 in chips)
Player_a7a5556d: posts small blind 30
Player_7e4e053f: posts big blind 60
*** HOLE CARDS ***
Dealt to Hero [6s Ks]
Player_f86c80c6: folds
Player_20f8cbec: raises 320 to 320
Player_d3cf7a76: raises 818 to 818
Player_35e16491: folds
Player_9b74be39: calls 818 
Player_be085def: folds
Hero: folds
Player_a7a5556d: folds
Player_7e4e053f: folds
Player_20f8cbec: calls 498 
*** FLOP *** [4c 6h 7h]
Player_20f8cbec: bets 60 
Player_d3cf7a76: raises 1418 to 1418
Player_9b74be39: folds
Player_20f8cbec: folds
Uncalled bet (1358) returned to Player_d3cf7a76
Player_d3cf7a76: doesn't show hand
Player_d3cf7a76 collected 2664 from pot
*** SUMMARY ***
Total pot 2664 | Rake 0
Board [4c 6h 7h]
Seat 1: Player_9b74be39 mucked
Seat 2: Player_be085def mucked
Seat 3: Hero (button) mucked
Seat 4: Player_a7a5556d (small blind) mucked
Seat 5: Player_7e4e053f (big blind) mucked
Seat 6: Player_f86c80c6 mucked
Seat 7: Player_20f8cbec mucked
Seat 8: Player_d3cf7a76 won (2664)
Seat 9: Player_35e16491 mucked



PokerStars Hand #3661267605: Tournament #21391319, $20+$2 - Hold'em No Limit (40/80) - 2018/04/06 22:16:56
Table '#18' Seat #4 is the button
Seat 1: Player_6caa520c (8,942 in chips)
Seat 2: Player_2d646321 (9,890 in chips)
Seat 3: Hero (10,330 in chips)
Seat 4: Player_f5790552 (9,910 in chips)
Seat 5: Player_a99c5ed3 (9,960 in chips)
Seat 6: Player_d71ffafc (10,000 in chips)
Seat 7: Player_3c41edf8 (7,462 in chips)
Seat 8: Player_0a0369a6 (15,725 in chips)
Seat 9: Player_3845f19e (12,680 in chips)
Player_a99c5ed3: posts small blind 40
Player_d71ffafc: posts big blind 80
*** HOLE CARDS ***
Dealt to Hero [Ts 4s]
Player_3c41edf8: calls 80 
Player_0a0369a6: folds
Player_3845f19e: calls 80 
Player_6caa520c: folds
Player_2d646321: folds
Hero: folds
Player_f5790552: folds
Player_a99c5ed3: calls 40 
Player_d71ffafc: folds
*** FLOP *** [5c 5d Qh]
Player_a99c5ed3: checks
Player_3c41edf8: checks
Player_3845f19e: checks
*** TURN *** [5c 5d Qh] [Ac]
Player_a99c5ed3: checks
Player_3c41edf8: bets 80 
Player_3845f19e: folds
Player_a99c5ed3: folds
Uncalled bet (80) returned to Player_3c41edf8
Player_3c41edf8: doesn't show hand
Player_3c41edf8 collected 320 from pot
*** SUMMARY ***
Total pot 320 | Rake 0
Board [5c 5d Qh Ac]
Seat 1: Player_6caa520c mucked
Seat 2: Player_2d646321 mucked
Seat 3: Hero mucked
Seat 4: Player_f5790552 (button) mucked
Seat 5: Player_a99c5ed3 (small blind) mucked
Seat 6: Player_d71ffafc (big blind) mucked
Seat 7: Player_3c41edf8 won (320)
Seat 8: Player_0a0369a6 mucked
Seat 9: Player_3845f19e mucked



PokerStars Hand #3661268213: Tournament #21391319, $20+$2 - Hold'em No Limit (40/80) - 2018/04/06 22:17:50
Table '#18' Seat #5 is the button
Seat 1: Player_51290919 (8,942 in chips)
Seat 2: Player_3a19075e (9,890 in chips)
Seat 3: Hero (10,330 in chips)
Seat 4: Player_43427fca (9,910 in chips)
Seat 5: Player_e2b618f8 (9,880 in chips)
Seat 6: Player_8870cf97 (9,920 in chips)
Seat 7: Player_99a2b453 (7,702 in chips)
Seat 8: Player_45e3fea9 (15,725 in chips)
Seat 9: Player_892dd8ee (12,600 in chips)
Player_8870cf97: posts small blind 40
Player_99a2b453: posts big blind 80
*** HOLE CARDS ***
Dealt to Hero [4h Qc]
Player_45e3fea9: folds
Player_892dd8ee: folds
Player_51290919: calls 80 
Player_3a19075e: folds
Hero: folds
Player_43427fca: folds
Player_e2b618f8: calls 80 
Player_8870cf97: folds
Player_99a2b453: checks
*** FLOP *** [Ah 6c 7c]
Player_99a2b453: bets 359 
Player_51290919: calls 359 
Player_e2b618f8: folds
*** TURN *** [Ah 6c 7c] [Qh]
Player_99a2b453: bets 486 
Player_51290919: raises 1640 to 1640
Player_99a2b453: folds
*** SHOW DOWN ***
Player_51290919: shows [As 7h] (two pair, Aces and Sevens)
Uncalled bet (1154) returned to Player_51290919
Player_51290919 collected 1970 from pot
*** SUMMARY ***
Total pot 1970 | Rake 0
Board [Ah 6c 7c Qh]
Seat 1: Player_51290919 showed [As 7h] and won (1970) with two pair, Aces and Sevens
Seat 2: Player_3a19075e mucked
Seat 3: Hero mucked
Seat 4: Player_43427fca mucked
Seat 5: Player_e2b618f8 (button) mucked
Seat 6: Player_8870cf97 (small blind) mucked
Seat 7: Player_99a2b453 (big blind) mucked
Seat 8: Player_45e3fea9 mucked
Seat 9: Player_892dd8ee mucked



PokerStars Hand #3661268828: Tournament #21391319, $20+$2 - Hold'em No Limit (40/80) - 2018/04/06 22:18:47
Table '#18' Seat #6 is the button
Seat 1: Player_88aa4c00 (9,987 in chips)
Seat 2: Player_41ed7ad3 (9,890 in chips)
Seat 3: Hero (10,330 in chips)
Seat 4: Player_0bc9457d (9,910 in chips)
Seat 5: Player_71202831 (9,800 in chips)
Seat 6: Player_434bb041 (9,880 in chips)
Seat 7: Player_3fefbd0f (6,777 in chips)
Seat 8: Player_d9bcc68f (15,725 in chips)
Seat 9: Player_85918f45 (12,600 in chips)
Player_3fefbd0f: posts small blind 40
Player_d9bcc68f: posts big blind 80
*** HOLE CARDS ***
Dealt to Hero [5d 4c]
Player_85918f45: folds
Player_88aa4c00: folds
Player_41ed7ad3: folds
Hero: folds
Player_0bc9457d: raises 280 to 280
Player_71202831: folds
Player_434bb041: folds
Player_3fefbd0f: calls 240 
Player_d9bcc68f: raises 1040 to 1120
Player_0bc9457d: calls 840 
Player_3fefbd0f: calls 840 
*** FLOP *** [As 2c Kh]
Player_3fefbd0f: bets 80 
Player_d9bcc68f: calls 80 
Player_0bc9457d: calls 80 
*** TURN *** [As 2c Kh] [Jc]
Player_3fefbd0f: bets 478 
Player_d9bcc68f: folds
Player_0bc9457d: calls 478 
*** RIVER *** [As 2c Kh Jc] [2d]
Player_3fefbd0f: bets 1401 
Player_0bc9457d: folds
Uncalled bet (1401) returned to Player_3fefbd0f
Player_3fefbd0f: doesn't show hand
Player_3fefbd0f collected 4556 from pot
*** SUMMARY ***
Total pot 4556 | Rake 0
Board [As 2c Kh Jc 2d]
Seat 1: Player_88aa4c00 mucked
Seat 2: Player_41ed7ad3 mucked
Seat 3: Hero mucked
Seat 4: Player_0bc9457d mucked
Seat 5: Player_71202831 mucked
Seat 6: Player_434bb041 (button) mucked
Seat 7: Player_3fefbd0f (small blind) won (4556)
Seat 8: Player_d9bcc68f (big blind) mucked
Seat 9: Player_85918f45 mucked



PokerStars Hand #3661269645: Tournament #21391319, $20+$2 - Hold'em No Limit (40/80) - 2018/04/06 22:19:59
Table '#18' Seat #7 is the button
Seat 1: Player_ff7f20aa (9,987 in chips)
Seat 2: Player_b1bf8201 (9,890 in chips)
Seat 3: Hero (10,330 in chips)
Seat 4: Player_9748501d (8,232 in chips)
Seat 5: Player_95048587 (9,800 in chips)
Seat 6: Player_3eb54ad3 (9,880 in chips)
Seat 7: Player_2d59cb86 (9,655 in chips)
Seat 8: Player_56239dd0 (14,525 in chips)
Seat 9: Player_f6a86aa4 (12,600 in chips)
Player_56239dd0: posts small blind 40
Player_f6a86aa4: posts big blind 80
*** HOLE CARDS ***
Dealt to Hero [9c 8c]
Player_ff7f20aa: calls 80 
Player_b1bf8201: folds
Hero: raises 320 to 320
Player_9748501d: folds
Player_95048587: folds
Player_3eb54ad3: folds
Player_2d59cb86: calls 320 
Player_56239dd0: folds
Player_f6a86aa4: folds
Player_ff7f20aa: calls 240 
*** FLOP *** [Ts 6s Jd]
Player_ff7f20aa: checks
Hero: checks
Player_2d59cb86: checks
*** TURN *** [Ts 6s Jd] [5h]
Player_ff7f20aa: checks
Hero: checks
Player_2d59cb86: checks
*** RIVER *** [Ts 6s Jd 5h] [Ks]
Player_ff7f20aa: checks
Hero: checks
Player_2d59cb86: checks
*** SHOW DOWN ***
Player_ff7f20aa: shows [2s Ac] (high card Ace)
Hero: Mucks [9c 8c] (High Card)
Player_2d59cb86: shows [9h Kh] (a pair of Kings)
Player_2d59cb86 collected 1080 from pot
*** SUMMARY ***
Total pot 1080 | Rake 0
Board [Ts 6s Jd 5h Ks]
Seat 1: Player_ff7f20aa showed [2s Ac] and lost with high card Ace
Seat 2: Player_b1bf8201 mucked
Seat 3: Hero mucked [9c 8c]
Seat 4: Player_9748501d mucked
Seat 5: Player_95048587 mucked
Seat 6: Player_3eb54ad3 mucked
Seat 7: Player_2d59cb86 (button) showed [9h Kh] and won (1080) with a pair of Kings
Seat 8: Player_56239dd0 (small blind) mucked
Seat 9: Player_f6a86aa4 (big blind) mucked



PokerStars Hand #3661271006: Tournament #21391319, $20+$2 - Hold'em No Limit (40/80) - 2018/04/06 22:22:02
Table '#18' Seat #8 is the button
Seat 1: Player_b3f2e882 (9,667 in chips)
Seat 2: Player_1c2cefe4 (9,890 in chips)
Seat 3: Hero (10,010 in chips)
Seat 4: Player_fb18ae78 (8,232 in chips)
Seat 5: Player_555669fe (9,800 in chips)
Seat 6: Player_b475d34f (9,880 in chips)
Seat 7: Player_c946bf5d (10,415 in chips)
Seat 8: Player_dc7e39f3 (14,485 in chips)
Seat 9: Player_f1193a82 (12,520 in chips)
Player_f1193a82: posts small blind 40
Player_b3f2e882: posts big blind 80
*** HOLE CARDS ***
Dealt to Hero [As 2c]
Player_1c2cefe4: folds
Hero: folds
Player_fb18ae78: folds
Player_555669fe: folds
Player_b475d34f: folds
Player_c946bf5d: calls 80 
Player_dc7e39f3: folds
Player_f1193a82: folds
Player_b3f2e882: checks
*** FLOP *** [Js Th 6d]
Player_b3f2e882: checks
Player_c946bf5d: checks
*** TURN *** [Js Th 6d] [Ah]
Player_b3f2e882: checks
Player_c946bf5d: checks
*** RIVER *** [Js Th 6d Ah] [4c]
Player_b3f2e882: checks
Player_c946bf5d: checks
*** SHOW DOWN ***
Player_b3f2e882: shows [3d 8h] (high card Ace)
Player_c946bf5d: Mucks [7d 2s] (High Card)
Player_b3f2e882 collected 200 from pot
*** SUMMARY ***
Total pot 200 | Rake 0
Board [Js Th 6d Ah 4c]
Seat 1: Player_b3f2e882 (big blind) showed [3d 8h] and won (200) with high card Ace
Seat 2: Player_1c2cefe4 mucked
Seat 3: Hero mucked
Seat 4: Player_fb18ae78 mucked
Seat 5: Player_555669fe mucked
Seat 6: Player_b475d34f mucked
Seat 7: Player_c946bf5d mucked [7d 2s]
Seat 8: Player_dc7e39f3 (button) mucked
Seat 9: Player_f1193a82 (small blind) mucked



PokerStars Hand #3661271715: Tournament #21391319, $20+$2 - Hold'em No Limit (40/80) - 2018/04/06 22:23:05
Table '#18' Seat #9 is the button
Seat 1: Player_903005ed (9,787 in chips)
Seat 2: Player_e4e8656a (9,890 in chips)
Seat 3: Hero (10,010 in chips)
Seat 4: Player_f82b735b (8,232 in chips)
Seat 5: Player_448697b9 (9,800 in chips)
Seat 6: Player_e804be2c (9,880 in chips)
Seat 7: Player_407302eb (10,335 in chips)
Seat 8: Player_86374ec9 (14,485 in chips)
Seat 9: Player_0f46748c (12,480 in chips)
Player_903005ed: posts small blind 40
Player_e4e8656a: posts big blind 80
*** HOLE CARDS ***
Dealt to Hero [Ts 8s]
Hero: raises 180 to 180
Player_f82b735b: calls 180 
Player_448697b9: calls 180 
Player_e804be2c: folds
Player_407302eb: folds
Player_86374ec9: calls 180 
Player_0f46748c: folds
Player_903005ed: folds
Player_e4e8656a: calls 100 
*** FLOP *** [9h Qc 6s]
Player_e4e8656a: checks
Hero: bets 500 
Player_f82b735b: raises 1000 to 1000
Player_448697b9: folds
Player_86374ec9: folds
Player_e4e8656a: raises 2500 to 2500
Hero: folds
Player_f82b735b: raises 7052 to 8052 and is all-in
Player_e4e8656a: calls 5552 
*** TURN *** [9h Qc 6s] [5h]
*** RIVER *** [9h Qc 6s 5h] [Kc]
*** SHOW DOWN ***
Player_e4e8656a: shows [9d 6d] (two pair, Nines and Sixes)
Player_f82b735b: shows [Js Jc] (a pair of Jacks)
Player_e4e8656a collected 17544 from pot
Player_f82b735b finished the tournament in 102nd place
*** SUMMARY ***
Total pot 17544 | Rake 0
Board [9h Qc 6s 5h Kc]
Seat 1: Player_903005ed (small blind) mucked
Seat 2: Player_e4e8656a (big blind) showed [9d 6d] and won (17544) with two pair, Nines and Sixes
Seat 3: Hero mucked
Seat 4: Player_f82b735b showed [Js Jc] and lost with a pair of Jacks
Seat 5: Player_448697b9 mucked
Seat 6: Player_e804be2c mucked
Seat 7: Player_407302eb mucked
Seat 8: Player_86374ec9 mucked
Seat 9: Player_0f46748c (button) mucked



PokerStars Hand #3661273462: Tournament #21391319, $20+$2 - Hold'em No Limit (50/100) - 2018/04/06 22:25:44
Table '#18' Seat #1 is the button
Seat 1: Player_38f94658 (9,747 in chips)
Seat 2: Player_54dc8136 (19,202 in chips)
Seat 3: Hero (9,330 in chips)
Seat 4: Player_f7474593 (9,620 in chips)
Seat 5: Player_e16a24a7 (9,880 in chips)
Seat 6: Player_f7fa1e1e (10,335 in chips)
Seat 7: Player_e2e98b0a (14,305 in chips)
Seat 8: Player_c2c98bb1 (12,480 in chips)
Player_54dc8136: posts small blind 50
Hero: posts big blind 100
*** HOLE CARDS ***
Dealt to Hero [3d 8c]
Player_f7474593: folds
Player_e16a24a7: folds
Player_f7fa1e1e: folds
Player_e2e98b0a: folds
Player_c2c98bb1: folds
Player_38f94658: calls 100 
Player_54dc8136: calls 50 
Hero: checks
*** FLOP *** [Ks Ah Qs]
Player_54dc8136: bets 150 
Hero: folds
Player_38f94658: calls 150 
*** TURN *** [Ks Ah Qs] [4c]
Player_54dc8136: checks
Player_38f94658: checks
*** RIVER *** [Ks Ah Qs 4c] [9d]
Player_54dc8136: bets 150 
Player_38f94658: folds
Uncalled bet (150) returned to Player_54dc8136
Player_54dc8136: doesn't show hand
Player_54dc8136 collected 600 from pot
*** SUMMARY ***
Total pot 600 | Rake 0
Board [Ks Ah Qs 4c 9d]
Seat 1: Player_38f94658 (button) mucked
Seat 2: Player_54dc8136 (small blind) won (600)
Seat 3: Hero (big blind) mucked
Seat 4: Player_f7474593 mucked
Seat 5: Player_e16a24a7 mucked
Seat 6: Player_f7fa1e1e mucked
Seat 7: Player_e2e98b0a mucked
Seat 8: Player_c2c98bb1 mucked



PokerStars Hand #3661274519: Tournament #21391319, $20+$2 - Hold'em No Limit (50/100) - 2018/04/06 22:27:17
Table '#18' Seat #2 is the button
Seat 1: Player_39c164b3 (9,497 in chips)
Seat 2: Player_49979464 (19,552 in chips)
Seat 3: Hero (9,230 in chips)
Seat 4: Player_7dc042e6 (9,620 in chips)
Seat 5: Player_8e9a2922 (9,880 in chips)
Seat 6: Player_40fa4451 (10,335 in chips)
Seat 7: Player_2f6c8538 (14,305 in chips)
Seat 8: Player_a035b18e (12,480 in chips)
Hero: posts small blind 50
Player_7dc042e6: posts big blind 100
*** HOLE CARDS ***
Dealt to Hero [Qs 7c]
Player_8e9a2922: folds
Player_40fa4451: raises 200 to 200
Player_2f6c8538: folds
Player_a035b18e: folds
Player_39c164b3: calls 200 
Player_49979464: folds
Hero: folds
Player_7dc042e6: calls 100 
*** FLOP *** [4s 5h Ks]
Player_7dc042e6: checks
Player_40fa4451: bets 797 
Player_39c164b3: folds
Player_7dc042e6: calls 797 
*** TURN *** [4s 5h Ks] [7d]
Player_7dc042e6: checks
Player_40fa4451: bets 930 
Player_7dc042e6: calls 930 
*** RIVER *** [4s 5h Ks 7d] [Ah]
Player_7dc042e6: checks
Player_40fa4451: checks
*** SHOW DOWN ***
Player_7dc042e6: shows [2h Kh] (a pair of Kings)
Player_40fa4451: shows [Jh Kc] (a pair of Kings)
Player_40fa4451 collected 4104 from pot
*** SUMMARY ***
Total pot 4104 | Rake 0
Board [4s 5h Ks 7d Ah]
Seat 1: Player_39c164b3 mucked
Seat 2: Player_49979464 (button) mucked
Seat 3: Hero (small blind) mucked
Seat 4: Player_7dc042e6 (big blind) showed [2h Kh] and lost with a pair of Kings
Seat 5: Player_8e9a2922 mucked
Seat 6: Player_40fa4451 showed [Jh Kc] and won (4104) with a pair of Kings
Seat 7: Player_2f6c8538 mucked
Seat 8: Player_a035b18e mucked



PokerStars Hand #3661275691: Tournament #21391319, $20+$2 - Hold'em No Limit (50/100) - 2018/04/06 22:29:02
Table '#18' Seat #3 is the button
Seat 1: Player_7379e205 (9,297 in chips)
Seat 2: Player_3f2cb335 (19,552 in chips)
Seat 3: Hero (9,180 in chips)
Seat 4: Player_cfbbe641 (7,693 in chips)
Seat 5: Player_2b5643da (9,880 in chips)
Seat 6: Player_502805e8 (12,512 in chips)
Seat 7: Player_cc7dded9 (14,305 in chips)
Seat 8: Player_bda15759 (12,480 in chips)
Player_cfbbe641: posts small blind 50
Player_2b5643da: posts big blind 100
*** HOLE CARDS ***
Dealt to Hero [8s 5d]
Player_502805e8: calls 100 
Player_cc7dded9: raises 400 to 400
Player_bda15759: folds
Player_7379e205: calls 400 
Player_3f2cb335: folds
Hero: folds
Player_cfbbe641: folds
Player_2b5643da: folds
Player_502805e8: calls 300 
*** FLOP *** [9s 2s 6s]
Player_502805e8: bets 538 
Player_cc7dded9: folds
Player_7379e205: calls 538 
*** TURN *** [9s 2s 6s] [7d]
Player_502805e8: bets 1143 
Player_7379e205: calls 1143 
*** RIVER *** [9s 2s 6s 7d] [3h]
Player_502805e8: bets 1554 
Player_7379e205: calls 1554 
*** SHOW DOWN ***
Player_502805e8: shows [4h 9h] (a pair of Nines)
Player_7379e205: shows [Kc 9c] (a pair of Nines)
Player_7379e205 collected 7820 from pot
*** SUMMARY ***
Total pot 7820 | Rake 0
Board [9s 2s 6s 7d 3h]
Seat 1: Player_7379e205 showed [Kc 9c] and won (7820) with a pair of Nines
Seat 2: Player_3f2cb335 mucked
Seat 3: Hero (button) mucked
Seat 4: Player_cfbbe641 (small blind) mucked
Seat 5: Player_2b5643da (big blind) mucked
Seat 6: Player_502805e8 showed [4h 9h] and lost with a pair of Nines
Seat 7: Player_cc7dded9 mucked
Seat 8: Player_bda15759 mucked



PokerStars Hand #3661276545: Tournament #21391319, $20+$2 - Hold'em No Limit (50/100) - 2018/04/06 22:30:20
Table '#18' Seat #4 is the button
Seat 1: Player_f78a1f5a (13,482 in chips)
Seat 2: Player_7c3923b0 (19,552 in chips)
Seat 3: Hero (9,180 in chips)
Seat 4: Player_b740e53d (7,643 in chips)
Seat 5: Player_8045ad4d (9,780 in chips)
Seat 6: Player_e0cef299 (8,877 in chips)
Seat 7: Player_e6c94fc7 (13,905 in chips)
Seat 8: Player_1248e60e (12,480 in chips)
Player_8045ad4d: posts small blind 50
Player_e0cef299: posts big blind 100
*** HOLE CARDS ***
Dealt to Hero [7s 4s]
Player_e6c94fc7: folds
Player_1248e60e: folds
Player_f78a1f5a: folds
Player_7c3923b0: raises 300 to 300
Hero: folds
Player_b740e53d: calls 300 
Player_8045ad4d: folds
Player_e0cef299: folds
*** FLOP *** [Jc Td 7h]
Player_7c3923b0: bets 300 
Player_b740e53d: calls 300 
*** TURN *** [Jc Td 7h] [As]
Player_7c3923b0: checks
Player_b740e53d: checks
*** RIVER *** [Jc Td 7h As] [Jh]
Player_7c3923b0: bets 420 
Player_b740e53d: calls 420 
*** SHOW DOWN ***
Player_7c3923b0: shows [Kc Qs] (a straight, Ten to Ace)
Player_b740e53d: Mucks [Tc Kh] (Two pair)
Player_7c3923b0 collected 2190 from pot
*** SUMMARY ***
Total pot 2190 | Rake 0
Board [Jc Td 7h As Jh]
Seat 1: Player_f78a1f5a mucked
Seat 2: Player_7c3923b0 showed [Kc Qs] and won (2190) with a straight, Ten to Ace
Seat 3: Hero mucked
Seat 4: Player_b740e53d (button) mucked [Tc Kh]
Seat 5: Player_8045ad4d (small blind) mucked
Seat 6: Player_e0cef299 (big blind) mucked
Seat 7: Player_e6c94fc7 mucked
Seat 8: Player_1248e60e mucked



PokerStars Hand #3661277240: Tournament #21391319, $20+$2 - Hold'em No Limit (50/100) - 2018/04/06 22:31:23
Table '#18' Seat #5 is the button
Seat 1: Player_ed2e3d42 (13,482 in chips)
Seat 2: Player_3dfa615f (20,722 in chips)
Seat 3: Hero (9,180 in chips)
Seat 4: Player_898aaac8 (6,623 in chips)
Seat 5: Player_11452b17 (9,730 in chips)
Seat 6: Player_3c015913 (8,777 in chips)
Seat 7: Player_83df86a4 (13,905 in chips)
Seat 8: Player_0f877121 (12,480 in chips)
Player_3c015913: posts small blind 50
Player_83df86a4: posts big blind 100
*** HOLE CARDS ***
Dealt to Hero [8c Ks]
Player_0f877121: folds
Player_ed2e3d42: folds
Player_3dfa615f: folds
Hero: folds
Player_898aaac8: folds
Player_11452b17: folds
Player_3c015913: folds
Player_83df86a4: doesn't show hand
Uncalled bet (100) returned to Player_83df86a4
Player_83df86a4 collected 50 from pot
*** SUMMARY ***
Total pot 50 | Rake 0
Seat 1: Player_ed2e3d42 mucked
Seat 2: Player_3dfa615f mucked
Seat 3: Hero mucked
Seat 4: Player_898aaac8 mucked
Seat 5: Player_11452b17 (button) mucked
Seat 6: Player_3c015913 (small blind) mucked
Seat 7: Player_83df86a4 (big blind) won (50)
Seat 8: Player_0f877121 mucked



PokerStars Hand #3661277747: Tournament #21391319, $20+$2 - Hold'em No Limit (50/100) - 2018/04/06 22:32:11
Table '#18' Seat #6 is the button
Seat 1: Player_b2ffd7c4 (13,482 in chips)
Seat 2: Player_26722e93 (20,722 in chips)
Seat 3: Hero (9,180 in chips)
Seat 4: Player_6132d73c (6,623 in chips)
Seat 5: Player_b4ce27f1 (9,730 in chips)
Seat 6: Player_9d24640b (8,727 in chips)
Seat 7: Player_1b18af2d (13,955 in chips)
Seat 8: Player_49ae47f6 (12,480 in chips)
Player_1b18af2d: posts small blind 50
Player_49ae47f6: posts big blind 100
*** HOLE CARDS ***
Dealt to Hero [As Jh]
Player_b2ffd7c4: folds
Player_26722e93: folds
Hero: raises 300 to 300
Player_6132d73c: folds
Player_b4ce27f1: folds
Player_9d24640b: folds
Player_1b18af2d: calls 250 
Player_49ae47f6: folds
*** FLOP *** [5h 5d 7c]
Player_1b18af2d: checks
Hero: checks
*** TURN *** [5h 5d 7c] [6c]
Player_1b18af2d: bets 300 
Hero: calls 300 
*** RIVER *** [5h 5d 7c 6c] [4h]
Player_1b18af2d: bets 1000 
Hero: folds
Uncalled bet (1000) returned to Player_1b18af2d
Player_1b18af2d: doesn't show hand
Player_1b18af2d collected 1300 from pot
*** SUMMARY ***
Total pot 1300 | Rake 0
Board [5h 5d 7c 6c 4h]
Seat 1: Player_b2ffd7c4 mucked
Seat 2: Player_26722e93 mucked
Seat 3: Hero mucked
Seat 4: Player_6132d73c mucked
Seat 5: Player_b4ce27f1 mucked
Seat 6: Player_9d24640b (button) mucked
Seat 7: Player_1b18af2d (small blind) won (1300)
Seat 8: Player_49ae47f6 (big blind) mucked



PokerStars Hand #3661278554: Tournament #21391319, $20+$2 - Hold'em No Limit (50/100) - 2018/04/06 22:33:26
Table '#18' Seat #7 is the button
Seat 1: Player_ca782cd5 (13,482 in chips)
Seat 2: Player_3c43e15e (20,722 in chips)
Seat 3: Hero (8,580 in chips)
Seat 4: Player_2aaea0ac (6,623 in chips)
Seat 5: Player_e182fdcc (9,730 in chips)
Seat 6: Player_3aad4c9e (8,727 in chips)
Seat 7: Player_d40064d8 (14,655 in chips)
Seat 8: Player_1109bed0 (12,380 in chips)
Player_1109bed0: posts small blind 50
Player_ca782cd5: posts big blind 100
*** HOLE CARDS ***
Dealt to Hero [9d 4s]
Player_3c43e15e: folds
Hero: folds
Player_2aaea0ac: folds
Player_e182fdcc: folds
Player_3aad4c9e: calls 100 
Player_d40064d8: calls 100 
Player_1109bed0: folds
Player_ca782cd5: folds
*** FLOP *** [9h 5d 9c]
Player_3aad4c9e: bets 100 
Player_d40064d8: calls 100 
*** TURN *** [9h 5d 9c] [6h]
Player_3aad4c9e: bets 100 
Player_d40064d8: raises 500 to 500
Player_3aad4c9e: folds
Uncalled bet (400) returned to Player_d40064d8
Player_d40064d8: doesn't show hand
Player_d40064d8 collected 750 from pot
*** SUMMARY ***
Total pot 750 | Rake 0
Board [9h 5d 9c 6h]
Seat 1: Player_ca782cd5 (big blind) mucked
Seat 2: Player_3c43e15e mucked
Seat 3: Hero mucked
Seat 4: Player_2aaea0ac mucked
Seat 5: Player_e182fdcc mucked
Seat 6: Player_3aad4c9e mucked
Seat 7: Player_d40064d8 (button) won (750)
Seat 8: Player_1109bed0 (small blind) mucked



PokerStars Hand #3661279293: Tournament #21391319, $20+$2 - Hold'em No Limit (50/100) - 2018/04/06 22:34:32
Table '#18' Seat #9 is the button
Seat 1: Player_c01e2e54 (13,382 in chips)
Seat 2: Player_cbc39a88 (20,722 in chips)
Seat 3: Hero (8,580 in chips)
Seat 4: Player_e2243558 (10,000 in chips)
Seat 5: Player_95136338 (6,623 in chips)
Seat 6: Player_f6810ac5 (9,730 in chips)
Seat 7: Player_9be5d6bb (8,427 in chips)
Seat 8: Player_9cd01144 (15,105 in chips)
Seat 9: Player_328d8110 (12,330 in chips)
Player_c01e2e54: posts small blind 50
Player_cbc39a88: posts big blind 100
*** HOLE CARDS ***
Dealt to Hero [6c Ah]
Hero: folds
Player_e2243558: folds
Player_95136338: raises 300 to 300
Player_f6810ac5: folds
Player_9be5d6bb: calls 300 
Player_9cd01144: folds
Player_328d8110: folds
Player_c01e2e54: folds
Player_cbc39a88: folds
*** FLOP *** [As Kh Jc]
Player_95136338: bets 200 
Player_9be5d6bb: folds
Uncalled bet (200) returned to Player_95136338
Player_95136338: doesn't show hand
Player_95136338 collected 750 from pot
*** SUMMARY ***
Total pot 750 | Rake 0
Board [As Kh Jc]
Seat 1: Player_c01e2e54 (small blind) mucked
Seat 2: Player_cbc39a88 (big blind) mucked
Seat 3: Hero mucked
Seat 4: Player_e2243558 mucked
Seat 5: Player_95136338 won (750)
Seat 6: Player_f6810ac5 mucked
Seat 7: Player_9be5d6bb mucked
Seat 8: Player_9cd01144 mucked
Seat 9: Player_328d8110 (button) mucked



PokerStars Hand #3661280038: Tournament #21391319, $20+$2 - Hold'em No Limit (75/150) - 2018/04/06 22:35:35
Table '#18' Seat #1 is the button
Seat 1: Player_fdb7ff7e (13,332 in chips)
Seat 2: Player_5ce970b6 (20,622 in chips)
Seat 3: Hero (8,580 in chips)
Seat 4: Player_cb3296dd (10,000 in chips)
Seat 5: Player_54b70954 (7,073 in chips)
Seat 6: Player_69f0c1ac (9,730 in chips)
Seat 7: Player_b1f2369a (8,127 in chips)
Seat 8: Player_b2b7fa59 (15,105 in chips)
Seat 9: Player_8570b902 (12,330 in chips)
Player_5ce970b6: posts small blind 75
Hero: posts big blind 150
*** HOLE CARDS ***
Dealt to Hero [Qs 7d]
Player_cb3296dd: folds
Player_54b70954: raises 450 to 450
Player_69f0c1ac: folds
Player_b1f2369a: folds
Player_b2b7fa59: folds
Player_8570b902: folds
Player_fdb7ff7e: folds
Player_5ce970b6: folds
Hero: folds
Uncalled bet (300) returned to Player_54b70954
Player_54b70954: doesn't show hand
Player_54b70954 collected 375 from pot
*** SUMMARY ***
Total pot 375 | Rake 0
Seat 1: Player_fdb7ff7e (button) mucked
Seat 2: Player_5ce970b6 (small blind) mucked
Seat 3: Hero (big blind) mucked
Seat 4: Player_cb3296dd mucked
Seat 5: Player_54b70954 won (375)
Seat 6: Player_69f0c1ac mucked
Seat 7: Player_b1f2369a mucked
Seat 8: Player_b2b7fa59 mucked
Seat 9: Player_8570b902 mucked



PokerStars Hand #3661280543: Tournament #21391319, $20+$2 - Hold'em No Limit (75/150) - 2018/04/06 22:36:20
Table '#18' Seat #2 is the button
Seat 1: Player_c7052561 (13,332 in chips)
Seat 2: Player_9037d224 (20,547 in chips)
Seat 3: Hero (8,430 in chips)
Seat 4: Player_ea2132a6 (10,000 in chips)
Seat 5: Player_27d7491e (7,298 in chips)
Seat 6: Player_a0b26732 (9,730 in chips)
Seat 7: Player_97567fcc (15,105 in chips)
Seat 8: Player_1a256644 (12,330 in chips)
Hero: posts small blind 75
Player_ea2132a6: posts big blind 150
*** HOLE CARDS ***
Dealt to Hero [Td 8d]
Player_27d7491e: calls 150 
Player_a0b26732: folds
Player_97567fcc: folds
Player_1a256644: folds
Player_c7052561: folds
Player_9037d224: folds
Hero: calls 75 
Player_ea2132a6: checks
*** FLOP *** [9h 5h Js]
Hero: bets 300 
Player_ea2132a6: calls 300 
Player_27d7491e: calls 300 
*** TURN *** [9h 5h Js] [Ac]
Hero: bets 1000 
Player_ea2132a6: calls 1000 
Player_27d7491e: folds
*** RIVER *** [9h 5h Js Ac] [2d]
Hero: bets 3000 
Player_ea2132a6: folds
Uncalled bet (3000) returned to Hero
Hero: doesn't show hand
Hero collected 3350 from pot
*** SUMMARY ***
Total pot 3350 | Rake 0
Board [9h 5h Js Ac 2d]
Seat 1: Player_c7052561 mucked
Seat 2: Player_9037d224 (button) mucked
Seat 3: Hero (small blind) won (3350)
Seat 4: Player_ea2132a6 (big blind) mucked
Seat 5: Player_27d7491e mucked
Seat 6: Player_a0b26732 mucked
Seat 7: Player_97567fcc mucked
Seat 8: Player_1a256644 mucked



PokerStars Hand #3661281886: Tournament #21391319, $20+$2 - Hold'em No Limit (75/150) - 2018/04/06 22:38:20
Table '#18' Seat #3 is the button
Seat 1: Player_5f449a3e (13,332 in chips)
Seat 2: Player_d69df555 (20,547 in chips)
Seat 3: Hero (10,330 in chips)
Seat 4: Player_bf4b8ad8 (8,550 in chips)
Seat 5: Player_2958daa5 (6,848 in chips)
Seat 6: Player_9343934f (9,730 in chips)
Seat 7: Player_98751082 (15,105 in chips)
Seat 8: Player_3d919361 (12,330 in chips)
Player_bf4b8ad8: posts small blind 75
Player_2958daa5: posts big blind 150
*** HOLE CARDS ***
Dealt to Hero [9h 5s]
Player_9343934f: folds
Player_98751082: folds
Player_3d919361: folds
Player_5f449a3e: folds
Player_d69df555: raises 350 to 350
Hero: folds
Player_bf4b8ad8: calls 275 
Player_2958daa5: folds
*** FLOP *** [8d 2c 5h]
Player_bf4b8ad8: checks
Player_d69df555: checks
*** TURN *** [8d 2c 5h] [6s]
Player_bf4b8ad8: bets 425 
Player_d69df555: folds
Uncalled bet (425) returned to Player_bf4b8ad8
Player_bf4b8ad8: doesn't show hand
Player_bf4b8ad8 collected 850 from pot
*** SUMMARY ***
Total pot 850 | Rake 0
Board [8d 2c 5h 6s]
Seat 1: Player_5f449a3e mucked
Seat 2: Player_d69df555 mucked
Seat 3: Hero (button) mucked
Seat 4: Player_bf4b8ad8 (small blind) won (850)
Seat 5: Player_2958daa5 (big blind) mucked
Seat 6: Player_9343934f mucked
Seat 7: Player_98751082 mucked
Seat 8: Player_3d919361 mucked



PokerStars Hand #3661282910: Tournament #21391319, $20+$2 - Hold'em No Limit (75/150) - 2018/04/06 22:39:50
Table '#18' Seat #4 is the button
Seat 1: Player_a36e4310 (13,332 in chips)
Seat 2: Player_4c5b335b (20,197 in chips)
Seat 3: Hero (10,330 in chips)
Seat 4: Player_d1ab7da1 (9,050 in chips)
Seat 5: Player_218b3d81 (6,698 in chips)
Seat 6: Player_eac5319b (9,730 in chips)
Seat 7: Player_c670e489 (15,105 in chips)
Seat 8: Player_3f31b7d7 (12,330 in chips)
Player_218b3d81: posts small blind 75
Player_eac5319b: posts big blind 150
*** HOLE CARDS ***
Dealt to Hero [Ah Kd]
Player_c670e489: folds
Player_3f31b7d7: folds
Player_a36e4310: folds
Player_4c5b335b: folds
Hero: raises 400 to 400
Player_d1ab7da1: folds
Player_218b3d81: folds
Player_eac5319b: folds
Uncalled bet (250) returned to Hero
Hero: doesn't show hand
Hero collected 375 from pot
*** SUMMARY ***
Total pot 375 | Rake 0
Seat 1: Player_a36e4310 mucked
Seat 2: Player_4c5b335b mucked
Seat 3: Hero won (375)
Seat 4: Player_d1ab7da1 (button) mucked
Seat 5: Player_218b3d81 (small blind) mucked
Seat 6: Player_eac5319b (big blind) mucked
Seat 7: Player_c670e489 mucked
Seat 8: Player_3f31b7d7 mucked



PokerStars Hand #3661283352: Tournament #21391319, $20+$2 - Hold'em No Limit (75/150) - 2018/04/06 22:40:29
Table '#18' Seat #5 is the button
Seat 1: Player_4b56f8b8 (13,332 in chips)
Seat 2: Player_7307b98e (20,197 in chips)
Seat 3: Hero (10,555 in chips)
Seat 4: Player_be0a3627 (9,050 in chips)
Seat 5: Player_48f495fd (6,623 in chips)
Seat 6: Player_55c55639 (9,580 in chips)
Seat 7: Player_cc15e055 (10,000 in chips)
Seat 8: Player_44cc49c5 (15,105 in chips)
Seat 9: Player_84682c9f (12,330 in chips)
Player_55c55639: posts small blind 75
Player_cc15e055: posts big blind 150
*** HOLE CARDS ***
Dealt to Hero [Qc 5c]
Player_44cc49c5: folds
Player_84682c9f: folds
Player_4b56f8b8: folds
Player_7307b98e: folds
Hero: folds
Player_be0a3627: folds
Player_48f495fd: raises 450 to 450
Player_55c55639: folds
Player_cc15e055: folds
Uncalled bet (300) returned to Player_48f495fd
Player_48f495fd: doesn't show hand
Player_48f495fd collected 375 from pot
*** SUMMARY ***
Total pot 375 | Rake 0
Seat 1: Player_4b56f8b8 mucked
Seat 2: Player_7307b98e mucked
Seat 3: Hero mucked
Seat 4: Player_be0a3627 mucked
Seat 5: Player_48f495fd (button) won (375)
Seat 6: Player_55c55639 (small blind) mucked
Seat 7: Player_cc15e055 (big blind) mucked
Seat 8: Player_44cc49c5 mucked
Seat 9: Player_84682c9f mucked



PokerStars Hand #3661283849: Tournament #21391319, $20+$2 - Hold'em No Limit (75/150) - 2018/04/06 22:41:14
Table '#18' Seat #6 is the button
Seat 1: Player_eb2dbf5c (13,332 in chips)
Seat 2: Player_63eb9790 (20,197 in chips)
Seat 3: Hero (10,555 in chips)
Seat 4: Player_b4c10ffe (9,050 in chips)
Seat 5: Player_8e3e2689 (6,848 in chips)
Seat 6: Player_8a9060d4 (9,505 in chips)
Seat 7: Player_6bc3f928 (9,850 in chips)
Seat 8: Player_da22f617 (15,105 in chips)
Seat 9: Player_92e921d3 (12,330 in chips)
Player_6bc3f928: posts small blind 75
Player_da22f617: posts big blind 150
*** HOLE CARDS ***
Dealt to Hero [3c 5h]
Player_92e921d3: folds
Player_eb2dbf5c: folds
Player_63eb9790: raises 350 to 350
Hero: folds
Player_b4c10ffe: folds
Player_8e3e2689: folds
Player_8a9060d4: folds
Player_6bc3f928: folds
Player_da22f617: calls 200 
*** FLOP *** [8d 6h Qc]
Player_da22f617: checks
Player_63eb9790: bets 325 
Player_da22f617: calls 325 
*** TURN *** [8d 6h Qc] [Qs]
Player_da22f617: checks
Player_63eb9790: bets 600 
Player_da22f617: folds
Uncalled bet (600) returned to Player_63eb9790
Player_63eb9790: doesn't show hand
Player_63eb9790 collected 1425 from pot
*** SUMMARY ***
Total pot 1425 | Rake 0
Board [8d 6h Qc Qs]
Seat 1: Player_eb2dbf5c mucked
Seat 2: Player_63eb9790 won (1425)
Seat 3: Hero mucked
Seat 4: Player_b4c10ffe mucked
Seat 5: Player_8e3e2689 mucked
Seat 6: Player_8a9060d4 (button) mucked
Seat 7: Player_6bc3f928 (small blind) mucked
Seat 8: Player_da22f617 (big blind) mucked
Seat 9: Player_92e921d3 mucked



PokerStars Hand #3661284499: Tournament #21391319, $20+$2 - Hold'em No Limit (75/150) - 2018/04/06 22:42:11
Table '#18' Seat #7 is the button
Seat 1: Player_119e1b79 (13,332 in chips)
Seat 2: Player_57cfad6f (20,947 in chips)
Seat 3: Hero (10,555 in chips)
Seat 4: Player_c266ad18 (9,050 in chips)
Seat 5: Player_9ac5a49f (6,848 in chips)
Seat 6: Player_e4b88023 (9,505 in chips)
Seat 7: Player_004d3b29 (9,775 in chips)
Seat 8: Player_91f7cc63 (14,430 in chips)
Seat 9: Player_f3efbbca (12,330 in chips)
Player_91f7cc63: posts small blind 75
Player_f3efbbca: posts big blind 150
*** HOLE CARDS ***
Dealt to Hero [2d Ah]
Player_119e1b79: folds
Player_57cfad6f: folds
Hero: folds
Player_c266ad18: folds
Player_9ac5a49f: folds
Player_e4b88023: folds
Player_004d3b29: folds
Player_91f7cc63: raises 375 to 450
Player_f3efbbca: folds
Uncalled bet (300) returned to Player_91f7cc63
Player_91f7cc63: doesn't show hand
Player_91f7cc63 collected 300 from pot
*** SUMMARY ***
Total pot 300 | Rake 0
Seat 1: Player_119e1b79 mucked
Seat 2: Player_57cfad6f mucked
Seat 3: Hero mucked
Seat 4: Player_c266ad18 mucked
Seat 5: Player_9ac5a49f mucked
Seat 6: Player_e4b88023 mucked
Seat 7: Player_004d3b29 (button) mucked
Seat 8: Player_91f7cc63 (small blind) won (300)
Seat 9: Player_f3efbbca (big blind) mucked



PokerStars Hand #3661284950: Tournament #21391319, $20+$2 - Hold'em No Limit (75/150) - 2018/04/06 22:42:53
Table '#18' Seat #8 is the button
Seat 1: Player_b20d2aa8 (13,332 in chips)
Seat 2: Player_c68581fd (20,947 in chips)
Seat 3: Hero (10,555 in chips)
Seat 4: Player_49085037 (9,050 in chips)
Seat 5: Player_93f05d51 (6,848 in chips)
Seat 6: Player_6c95edad (9,505 in chips)
Seat 7: Player_aaa73ffe (9,775 in chips)
Seat 8: Player_297e0354 (14,580 in chips)
Seat 9: Player_c5e6a473 (12,180 in chips)
Player_c5e6a473: posts small blind 75
Player_b20d2aa8: posts big blind 150
*** HOLE CARDS ***
Dealt to Hero [7s 5d]
Player_c68581fd: folds
Hero: folds
Player_49085037: folds
Player_93f05d51: folds
Player_6c95edad: raises 300 to 300
Player_aaa73ffe: folds
Player_297e0354: folds
Player_c5e6a473: folds
Player_b20d2aa8: folds
Uncalled bet (150) returned to Player_6c95edad
Player_6c95edad: doesn't show hand
Player_6c95edad collected 375 from pot
*** SUMMARY ***
Total pot 375 | Rake 0
Seat 1: Player_b20d2aa8 (big blind) mucked
Seat 2: Player_c68581fd mucked
Seat 3: Hero mucked
Seat 4: Player_49085037 mucked
Seat 5: Player_93f05d51 mucked
Seat 6: Player_6c95edad won (375)
Seat 7: Player_aaa73ffe mucked
Seat 8: Player_297e0354 (button) mucked
Seat 9: Player_c5e6a473 (small blind) mucked



PokerStars Hand #3661285701: Tournament #21391319, $20+$2 - Hold'em No Limit (75/150) - 2018/04/06 22:43:59
Table '#18' Seat #8 is the button
Seat 1: Player_fed56481 (13,182 in chips)
Seat 2: Player_decc2fe9 (20,947 in chips)
Seat 3: Hero (10,555 in chips)
Seat 4: Player_0bec7e6a (9,050 in chips)
Seat 5: Player_50c02fb0 (6,848 in chips)
Seat 6: Player_8395fb3a (9,730 in chips)
Seat 7: Player_3f20073d (14,580 in chips)
Seat 8: Player_8a0761d7 (12,105 in chips)
Player_fed56481: posts small blind 75
Player_decc2fe9: posts big blind 150
*** HOLE CARDS ***
Dealt to Hero [3c 7d]
Hero: folds
Player_0bec7e6a: folds
Player_50c02fb0: folds
Player_8395fb3a: folds
Player_3f20073d: raises 450 to 450
Player_8a0761d7: folds
Player_fed56481: calls 375 
Player_decc2fe9: calls 300 
*** FLOP *** [2s 2d 5c]
Player_fed56481: checks
Player_decc2fe9: bets 350 
Player_3f20073d: folds
Player_fed56481: calls 350 
*** TURN *** [2s 2d 5c] [5s]
Player_fed56481: bets 500 
Player_decc2fe9: calls 500 
*** RIVER *** [2s 2d 5c 5s] [8s]
Player_fed56481: bets 500 
Player_decc2fe9: raises 1750 to 1750
Player_fed56481: folds
Uncalled bet (1250) returned to Player_decc2fe9
Player_decc2fe9: doesn't show hand
Player_decc2fe9 collected 4050 from pot
*** SUMMARY ***
Total pot 4050 | Rake 0
Board [2s 2d 5c 5s 8s]
Seat 1: Player_fed56481 (small blind) mucked
Seat 2: Player_decc2fe9 (big blind) won (4050)
Seat 3: Hero mucked
Seat 4: Player_0bec7e6a mucked
Seat 5: Player_50c02fb0 mucked
Seat 6: Player_8395fb3a mucked
Seat 7: Player_3f20073d mucked
Seat 8: Player_8a0761d7 (button) mucked



PokerStars Hand #3661290922: Tournament #21391319, $20+$2 - Hold'em No Limit (100/200) - 2018/04/06 22:51:32
Table '#18' Seat #1 is the button
Seat 1: Player_a76f84b4 (11,382 in chips)
Seat 2: Player_e140df91 (23,197 in chips)
Seat 3: Hero (10,555 in chips)
Seat 4: Player_cb01ac9c (9,050 in chips)
Seat 5: Player_15866e63 (6,848 in chips)
Seat 6: Player_89a8637c (9,730 in chips)
Seat 7: Player_77597114 (10,000 in chips)
Seat 8: Player_391973fb (14,130 in chips)
Seat 9: Player_303b77ca (12,105 in chips)
Player_e140df91: posts small blind 100
Hero: posts big blind 200
*** HOLE CARDS ***
Dealt to Hero [3d 4h]
Player_cb01ac9c: raises 600 to 600
Player_15866e63: folds
Player_89a8637c: folds
Player_77597114: calls 600 
Player_391973fb: folds
Player_303b77ca: folds
Player_a76f84b4: calls 600 
Player_e140df91: folds
Hero: folds
*** FLOP *** [8c 8h Ac]
Player_cb01ac9c: bets 1050 
Player_77597114: calls 1050 
Player_a76f84b4: folds
*** TURN *** [8c 8h Ac] [As]
Player_cb01ac9c: checks
Player_77597114: checks
*** RIVER *** [8c 8h Ac As] [3h]
Player_cb01ac9c: bets 3400 
Player_77597114: raises 8350 to 8350 and is all-in
Player_cb01ac9c: folds
Uncalled bet (4950) returned to Player_77597114
Player_77597114: doesn't show hand
Player_77597114 collected 11000 from pot
*** SUMMARY ***
Total pot 11000 | Rake 0
Board [8c 8h Ac As 3h]
Seat 1: Player_a76f84b4 (button) mucked
Seat 2: Player_e140df91 (small blind) mucked
Seat 3: Hero (big blind) mucked
Seat 4: Player_cb01ac9c mucked
Seat 5: Player_15866e63 mucked
Seat 6: Player_89a8637c mucked
Seat 7: Player_77597114 won (11000)
Seat 8: Player_391973fb mucked
Seat 9: Player_303b77ca mucked



PokerStars Hand #3661291903: Tournament #21391319, $20+$2 - Hold'em No Limit (100/200) - 2018/04/06 22:52:56
Table '#18' Seat #2 is the button
Seat 1: Player_c7f07ce0 (10,782 in chips)
Seat 2: Player_c0d34bf1 (23,097 in chips)
Seat 3: Hero (10,355 in chips)
Seat 4: Player_d5b5bb11 (4,000 in chips)
Seat 5: Player_579a061e (6,848 in chips)
Seat 6: Player_7427c380 (9,730 in chips)
Seat 7: Player_a1ff5aaa (15,950 in chips)
Seat 8: Player_0979de93 (14,130 in chips)
Seat 9: Player_22a5863b (12,105 in chips)
Hero: posts small blind 100
Player_d5b5bb11: posts big blind 200
*** HOLE CARDS ***
Dealt to Hero [7d Ad]
Player_579a061e: folds
Player_7427c380: folds
Player_a1ff5aaa: folds
Player_0979de93: folds
Player_22a5863b: folds
Player_c7f07ce0: calls 200 
Player_c0d34bf1: folds
Hero: raises 700 to 800
Player_d5b5bb11: calls 600 
Player_c7f07ce0: calls 600 
*** FLOP *** [3c 6h 7c]
Hero: bets 1500 
Player_d5b5bb11: raises 3200 to 3200 and is all-in
Player_c7f07ce0: folds
Hero: calls 1700 
*** TURN *** [3c 6h 7c] [9c]
*** RIVER *** [3c 6h 7c 9c] [Js]
*** SHOW DOWN ***
Hero: shows [7d Ad] (a pair of Sevens)
Player_d5b5bb11: shows [2d 3d] (a pair of Threes)
Hero collected 8800 from pot
Player_d5b5bb11 finished the tournament in 134th place
*** SUMMARY ***
Total pot 8800 | Rake 0
Board [3c 6h 7c 9c Js]
Seat 1: Player_c7f07ce0 mucked
Seat 2: Player_c0d34bf1 (button) mucked
Seat 3: Hero (small blind) showed [7d Ad] and won (8800) with a pair of Sevens
Seat 4: Player_d5b5bb11 (big blind) showed [2d 3d] and lost with a pair of Threes
Seat 5: Player_579a061e mucked
Seat 6: Player_7427c380 mucked
Seat 7: Player_a1ff5aaa mucked
Seat 8: Player_0979de93 mucked
Seat 9: Player_22a5863b mucked



PokerStars Hand #3661292973: Tournament #21391319, $20+$2 - Hold'em No Limit (100/200) - 2018/04/06 22:54:38
Table '#18' Seat #3 is the button
Seat 1: Player_55a6b91a (9,982 in chips)
Seat 2: Player_daa1cadf (23,097 in chips)
Seat 3: Hero (15,155 in chips)
Seat 4: Player_a95f92ad (6,848 in chips)
Seat 5: Player_fd7b571c (9,730 in chips)
Seat 6: Player_ada3fad9 (15,950 in chips)
Seat 7: Player_de9b7305 (14,130 in chips)
Seat 8: Player_b1cf406a (12,105 in chips)
Player_a95f92ad: posts big blind 200
*** HOLE CARDS ***
Dealt to Hero [6d Ts]
Player_fd7b571c: folds
Player_ada3fad9: folds
Player_de9b7305: folds
Player_b1cf406a: raises 600 to 600
Player_55a6b91a: folds
Player_daa1cadf: folds
Hero: folds
Player_a95f92ad: calls 400 
*** FLOP *** [9h 8s Qc]
Player_a95f92ad: checks
Player_b1cf406a: bets 600 
Player_a95f92ad: folds
Uncalled bet (600) returned to Player_b1cf406a
Player_b1cf406a: doesn't show hand
Player_b1cf406a collected 1200 from pot
*** SUMMARY ***
Total pot 1200 | Rake 0
Board [9h 8s Qc]
Seat 1: Player_55a6b91a mucked
Seat 2: Player_daa1cadf mucked
Seat 3: Hero (button) mucked
Seat 4: Player_a95f92ad (big blind) mucked
Seat 5: Player_fd7b571c mucked
Seat 6: Player_ada3fad9 mucked
Seat 7: Player_de9b7305 mucked
Seat 8: Player_b1cf406a won (1200)



PokerStars Hand #3661293586: Tournament #21391319, $20+$2 - Hold'em No Limit (100/200) - 2018/04/06 22:55:35
Table '#18' Seat #4 is the button
Seat 1: Player_3d2e9f42 (9,982 in chips)
Seat 2: Player_cc0f32ce (23,097 in chips)
Seat 3: Hero (15,155 in chips)
Seat 4: Player_50e753f0 (10,000 in chips)
Seat 5: Player_3c3a9664 (6,248 in chips)
Seat 6: Player_a723eb63 (9,730 in chips)
Seat 7: Player_71eda343 (15,950 in chips)
Seat 8: Player_5cd46678 (14,130 in chips)
Seat 9: Player_d0547c8e (12,705 in chips)
Player_3c3a9664: posts small blind 100
Player_a723eb63: posts big blind 200
*** HOLE CARDS ***
Dealt to Hero [As 7s]
Player_71eda343: calls 200 
Player_5cd46678: folds
Player_d0547c8e: folds
Player_3d2e9f42: raises 600 to 600
Player_cc0f32ce: folds
Hero: folds
Player_50e753f0: calls 600 
Player_3c3a9664: folds
Player_a723eb63: folds
Player_71eda343: calls 400 
*** FLOP *** [5d 8d 5h]
Player_71eda343: checks
Player_3d2e9f42: bets 600 
Player_50e753f0: folds
Player_71eda343: folds
*** SHOW DOWN ***
Player_3d2e9f42: shows [Ad 7d] (a pair of Fives)
Uncalled bet (600) returned to Player_3d2e9f42
Player_3d2e9f42 collected 2100 from pot
*** SUMMARY ***
Total pot 2100 | Rake 0
Board [5d 8d 5h]
Seat 1: Player_3d2e9f42 showed [Ad 7d] and won (2100) with a pair of Fives
Seat 2: Player_cc0f32ce mucked
Seat 3: Hero mucked
Seat 4: Player_50e753f0 (button) mucked
Seat 5: Player_3c3a9664 (small blind) mucked
Seat 6: Player_a723eb63 (big blind) mucked
Seat 7: Player_71eda343 mucked
Seat 8: Player_5cd46678 mucked
Seat 9: Player_d0547c8e mucked



PokerStars Hand #3661294337: Tournament #21391319, $20+$2 - Hold'em No Limit (100/200) - 2018/04/06 22:56:47
Table '#18' Seat #5 is the button
Seat 1: Player_a1945c28 (11,482 in chips)
Seat 2: Player_733984d2 (23,097 in chips)
Seat 3: Hero (15,155 in chips)
Seat 4: Player_2a4bdd27 (9,400 in chips)
Seat 5: Player_8ba06cd1 (6,148 in chips)
Seat 6: Player_37f54422 (9,530 in chips)
Seat 7: Player_5f67c596 (15,350 in chips)
Seat 8: Player_7f9c2fd9 (14,130 in chips)
Seat 9: Player_46ca2df6 (12,705 in chips)
Player_37f54422: posts small blind 100
Player_5f67c596: posts big blind 200
*** HOLE CARDS ***
Dealt to Hero [Qd Ts]
Player_7f9c2fd9: folds
Player_46ca2df6: folds
Player_a1945c28: folds
Player_733984d2: folds
Hero: folds
Player_2a4bdd27: folds
Player_8ba06cd1: folds
Player_37f54422: folds
Player_5f67c596: doesn't show hand
Uncalled bet (200) returned to Player_5f67c596
Player_5f67c596 collected 100 from pot
*** SUMMARY ***
Total pot 100 | Rake 0
Seat 1: Player_a1945c28 mucked
Seat 2: Player_733984d2 mucked
Seat 3: Hero mucked
Seat 4: Player_2a4bdd27 mucked
Seat 5: Player_8ba06cd1 (button) mucked
Seat 6: Player_37f54422 (small blind) mucked
Seat 7: Player_5f67c596 (big blind) won (100)
Seat 8: Player_7f9c2fd9 mucked
Seat 9: Player_46ca2df6 mucked



PokerStars Hand #3661294653: Tournament #21391319, $20+$2 - Hold'em No Limit (100/200) - 2018/04/06 22:57:17
Table '#18' Seat #6 is the button
Seat 1: Player_5176ab21 (11,482 in chips)
Seat 2: Player_73f18d02 (23,097 in chips)
Seat 3: Hero (15,155 in chips)
Seat 4: Player_32b651d9 (9,400 in chips)
Seat 5: Player_a6cad932 (6,148 in chips)
Seat 6: Player_9dfe8d61 (9,430 in chips)
Seat 7: Player_badc1cc8 (15,450 in chips)
Seat 8: Player_57c4d397 (14,130 in chips)
Seat 9: Player_33cbdb89 (12,705 in chips)
Player_badc1cc8: posts small blind 100
Player_57c4d397: posts big blind 200
*** HOLE CARDS ***
Dealt to Hero [6c 4d]
Player_33cbdb89: folds
Player_5176ab21: folds
Player_73f18d02: folds
Hero: folds
Player_32b651d9: folds
Player_a6cad932: folds
Player_9dfe8d61: folds
Player_badc1cc8: folds
Player_57c4d397: doesn't show hand
Uncalled bet (200) returned to Player_57c4d397
Player_57c4d397 collected 100 from pot
*** SUMMARY ***
Total pot 100 | Rake 0
Seat 1: Player_5176ab21 mucked
Seat 2: Player_73f18d02 mucked
Seat 3: Hero mucked
Seat 4: Player_32b651d9 mucked
Seat 5: Player_a6cad932 mucked
Seat 6: Player_9dfe8d61 (button) mucked
Seat 7: Player_badc1cc8 (small blind) mucked
Seat 8: Player_57c4d397 (big blind) won (100)
Seat 9: Player_33cbdb89 mucked



PokerStars Hand #3661295035: Tournament #21391319, $20+$2 - Hold'em No Limit (100/200) - 2018/04/06 22:57:53
Table '#18' Seat #7 is the button
Seat 1: Player_06a63055 (11,482 in chips)
Seat 2: Player_c31a9caf (23,097 in chips)
Seat 3: Hero (15,155 in chips)
Seat 4: Player_3a8b56e0 (9,400 in chips)
Seat 5: Player_e5056f7c (6,148 in chips)
Seat 6: Player_67fc12c7 (9,430 in chips)
Seat 7: Player_93764466 (15,350 in chips)
Seat 8: Player_9802f89c (14,230 in chips)
Seat 9: Player_f778118c (12,705 in chips)
Player_9802f89c: posts small blind 100
Player_f778118c: posts big blind 200
*** HOLE CARDS ***
Dealt to Hero [Ks 4h]
Player_06a63055: folds
Player_c31a9caf: folds
Hero: folds
Player_3a8b56e0: folds
Player_e5056f7c: folds
Player_67fc12c7: folds
Player_93764466: folds
Player_9802f89c: calls 100 
Player_f778118c: checks
*** FLOP *** [Ac 7c 6s]
Player_9802f89c: bets 200 
Player_f778118c: folds
Uncalled bet (200) returned to Player_9802f89c
Player_9802f89c: doesn't show hand
Player_9802f89c collected 400 from pot
*** SUMMARY ***
Total pot 400 | Rake 0
Board [Ac 7c 6s]
Seat 1: Player_06a63055 mucked
Seat 2: Player_c31a9caf mucked
Seat 3: Hero mucked
Seat 4: Player_3a8b56e0 mucked
Seat 5: Player_e5056f7c mucked
Seat 6: Player_67fc12c7 mucked
Seat 7: Player_93764466 (button) mucked
Seat 8: Player_9802f89c (small blind) won (400)
Seat 9: Player_f778118c (big blind) mucked



PokerStars Hand #3661295390: Tournament #21391319, $20+$2 - Hold'em No Limit (100/200) - 2018/04/06 22:58:26
Table '#18' Seat #8 is the button
Seat 1: Player_a293b639 (11,482 in chips)
Seat 2: Player_59e3a804 (23,097 in chips)
Seat 3: Hero (15,155 in chips)
Seat 4: Player_9a866741 (9,400 in chips)
Seat 5: Player_c262f580 (6,148 in chips)
Seat 6: Player_d27362de (9,430 in chips)
Seat 7: Player_9b6f1646 (15,350 in chips)
Seat 8: Player_1281fcdb (14,430 in chips)
Seat 9: Player_296c85a1 (12,505 in chips)
Player_296c85a1: posts small blind 100
Player_a293b639: posts big blind 200
*** HOLE CARDS ***
Dealt to Hero [6h 7c]
Player_59e3a804: folds
Hero: folds
Player_9a866741: raises 700 to 700
Player_c262f580: folds
Player_d27362de: folds
Player_9b6f1646: folds
Player_1281fcdb: folds
Player_296c85a1: folds
Player_a293b639: folds
Uncalled bet (500) returned to Player_9a866741
Player_9a866741: doesn't show hand
Player_9a866741 collected 500 from pot
*** SUMMARY ***
Total pot 500 | Rake 0
Seat 1: Player_a293b639 (big blind) mucked
Seat 2: Player_59e3a804 mucked
Seat 3: Hero mucked
Seat 4: Player_9a866741 won (500)
Seat 5: Player_c262f580 mucked
Seat 6: Player_d27362de mucked
Seat 7: Player_9b6f1646 mucked
Seat 8: Player_1281fcdb (button) mucked
Seat 9: Player_296c85a1 (small blind) mucked



PokerStars Hand #3661295703: Tournament #21391319, $20+$2 - Hold'em No Limit (100/200) - 2018/04/06 22:58:56
Table '#18' Seat #9 is the button
Seat 1: Player_3056e55a (11,282 in chips)
Seat 2: Player_a0e1515c (23,097 in chips)
Seat 3: Hero (15,155 in chips)
Seat 4: Player_1afd28ca (9,700 in chips)
Seat 5: Player_7eb387e5 (6,148 in chips)
Seat 6: Player_7f0fee80 (9,430 in chips)
Seat 7: Player_c80dd76b (15,350 in chips)
Seat 8: Player_91539dee (14,430 in chips)
Seat 9: Player_99d35373 (12,405 in chips)
Player_3056e55a: posts small blind 100
Player_a0e1515c: posts big blind 200
*** HOLE CARDS ***
Dealt to Hero [4s Jh]
Hero: folds
Player_1afd28ca: folds
Player_7eb387e5: raises 600 to 600
Player_7f0fee80: folds
Player_c80dd76b: folds
Player_91539dee: folds
Player_99d35373: folds
Player_3056e55a: calls 500 
Player_a0e1515c: folds
*** FLOP *** [Tc Kc 3d]
Player_3056e55a: checks
Player_7eb387e5: bets 400 
Player_3056e55a: raises 1200 to 1200
Player_7eb387e5: raises 5148 to 5548 and is all-in
Player_3056e55a: calls 4348 
*** TURN *** [Tc Kc 3d] [Qh]
*** RIVER *** [Tc Kc 3d Qh] [6d]
*** SHOW DOWN ***
Player_3056e55a: shows [Kd Td] (two pair, Kings and Tens)
Player_7eb387e5: shows [Th Ad] (a pair of Tens)
Player_3056e55a collected 12496 from pot
Player_7eb387e5 finished the tournament in 135th place
*** SUMMARY ***
Total pot 12496 | Rake 0
Board [Tc Kc 3d Qh 6d]
Seat 1: Player_3056e55a (small blind) showed [Kd Td] and won (12496) with two pair, Kings and Tens
Seat 2: Player_a0e1515c (big blind) mucked
Seat 3: Hero mucked
Seat 4: Player_1afd28ca mucked
Seat 5: Player_7eb387e5 showed [Th Ad] and lost with a pair of Tens
Seat 6: Player_7f0fee80 mucked
Seat 7: Player_c80dd76b mucked
Seat 8: Player_91539dee mucked
Seat 9: Player_99d35373 (button) mucked



PokerStars Hand #3661296440: Tournament #21391319, $20+$2 - Hold'em No Limit (100/200) - 2018/04/06 22:59:56
Table '#18' Seat #1 is the button
Seat 1: Player_c70c1ad1 (17,630 in chips)
Seat 2: Player_d1ca868f (22,897 in chips)
Seat 3: Hero (15,155 in chips)
Seat 4: Player_1c0714d9 (9,700 in chips)
Seat 5: Player_10c2353b (9,430 in chips)
Seat 6: Player_9838f956 (15,350 in chips)
Seat 7: Player_43660188 (14,430 in chips)
Seat 8: Player_5c054513 (12,405 in chips)
Player_d1ca868f: posts small blind 100
Hero: posts big blind 200
*** HOLE CARDS ***
Dealt to Hero [9h 5d]
Player_1c0714d9: folds
Player_10c2353b: folds
Player_9838f956: folds
Player_43660188: folds
Player_5c054513: calls 200 
Player_c70c1ad1: folds
Player_d1ca868f: folds
Hero: checks
*** FLOP *** [3d 5s Ks]
Hero: checks
Player_5c054513: checks
*** TURN *** [3d 5s Ks] [Th]
Hero: checks
Player_5c054513: checks
*** RIVER *** [3d 5s Ks Th] [Ah]
Hero: checks
Player_5c054513: bets 250 
Hero: folds
Uncalled bet (250) returned to Player_5c054513
Player_5c054513: doesn't show hand
Player_5c054513 collected 500 from pot
*** SUMMARY ***
Total pot 500 | Rake 0
Board [3d 5s Ks Th Ah]
Seat 1: Player_c70c1ad1 (button) mucked
Seat 2: Player_d1ca868f (small blind) mucked
Seat 3: Hero (big blind) mucked
Seat 4: Player_1c0714d9 mucked
Seat 5: Player_10c2353b mucked
Seat 6: Player_9838f956 mucked
Seat 7: Player_43660188 mucked
Seat 8: Player_5c054513 won (500)



PokerStars Hand #3661297399: Tournament #21391319, $20+$2 - Hold'em No Limit (100/200) - 2018/04/06 23:01:20
Table '#18' Seat #2 is the button
Seat 1: Player_4405bf7b (17,630 in chips)
Seat 2: Player_1d108c95 (22,797 in chips)
Seat 3: Hero (14,955 in chips)
Seat 4: Player_7adc25b5 (9,700 in chips)
Seat 5: Player_37d73fb4 (10,000 in chips)
Seat 6: Player_ba895916 (9,430 in chips)
Seat 7: Player_8828f8c3 (15,350 in chips)
Seat 8: Player_88c7bad1 (14,430 in chips)
Seat 9: Player_6acd8076 (12,705 in chips)
Hero: posts small blind 100
Player_7adc25b5: posts big blind 200
*** HOLE CARDS ***
Dealt to Hero [4s 2s]
Player_37d73fb4: raises 600 to 600
Player_ba895916: folds
Player_8828f8c3: folds
Player_88c7bad1: folds
Player_6acd8076: folds
Player_4405bf7b: folds
Player_1d108c95: folds
Hero: folds
Player_7adc25b5: folds
Uncalled bet (400) returned to Player_37d73fb4
Player_37d73fb4: doesn't show hand
Player_37d73fb4 collected 500 from pot
*** SUMMARY ***
Total pot 500 | Rake 0
Seat 1: Player_4405bf7b mucked
Seat 2: Player_1d108c95 (button) mucked
Seat 3: Hero (small blind) mucked
Seat 4: Player_7adc25b5 (big blind) mucked
Seat 5: Player_37d73fb4 won (500)
Seat 6: Player_ba895916 mucked
Seat 7: Player_8828f8c3 mucked
Seat 8: Player_88c7bad1 mucked
Seat 9: Player_6acd8076 mucked



PokerStars Hand #3661298112: Tournament #21391319, $20+$2 - Hold'em No Limit (125/250) - 2018/04/06 23:02:23
Table '#18' Seat #3 is the button
Seat 1: Player_6348081a (17,630 in chips)
Seat 2: Player_a300d855 (22,797 in chips)
Seat 3: Hero (14,855 in chips)
Seat 4: Player_a432d2a9 (9,500 in chips)
Seat 5: Player_5be12998 (10,300 in chips)
Seat 6: Player_44f5b0ef (9,430 in chips)
Seat 7: Player_06ef12cb (15,350 in chips)
Seat 8: Player_321e5feb (14,430 in chips)
Seat 9: Player_8999c085 (12,705 in chips)
Player_6348081a: posts the ante 25
Player_a300d855: posts the ante 25
Hero: posts the ante 25
Player_a432d2a9: posts the ante 25
Player_5be12998: posts the ante 25
Player_44f5b0ef: posts the ante 25
Player_06ef12cb: posts the ante 25
Player_321e5feb: posts the ante 25
Player_8999c085: posts the ante 25
Player_a432d2a9: posts small blind 125
Player_5be12998: posts big blind 250
*** HOLE CARDS ***
Dealt to Hero [3s Tc]
Player_44f5b0ef: folds
Player_06ef12cb: folds
Player_321e5feb: folds
Player_8999c085: folds
Player_6348081a: folds
Player_a300d855: raises 575 to 575
Hero: folds
Player_a432d2a9: calls 450 
Player_5be12998: calls 325 
*** FLOP *** [6s 8s Ac]
Player_a432d2a9: checks
Player_5be12998: checks
Player_a300d855: bets 1325 
Player_a432d2a9: folds
Player_5be12998: calls 1325 
*** TURN *** [6s 8s Ac] [4s]
Player_5be12998: checks
Player_a300d855: checks
*** RIVER *** [6s 8s Ac 4s] [Kc]
Player_5be12998: bets 2027 
Player_a300d855: calls 2027 
*** SHOW DOWN ***
Player_5be12998: shows [5s 5d] (a pair of Fives)
Player_a300d855: shows [9h Ad] (a pair of Aces)
Player_a300d855 collected 8654 from pot
*** SUMMARY ***
Total pot 8654 | Rake 0
Board [6s 8s Ac 4s Kc]
Seat 1: Player_6348081a mucked
Seat 2: Player_a300d855 showed [9h Ad] and won (8654) with a pair of Aces
Seat 3: Hero (button) mucked
Seat 4: Player_a432d2a9 (small blind) mucked
Seat 5: Player_5be12998 (big blind) showed [5s 5d] and lost with a pair of Fives
Seat 6: Player_44f5b0ef mucked
Seat 7: Player_06ef12cb mucked
Seat 8: Player_321e5feb mucked
Seat 9: Player_8999c085 mucked



PokerStars Hand #3661299338: Tournament #21391319, $20+$2 - Hold'em No Limit (125/250) - 2018/04/06 23:04:11
Table '#18' Seat #3 is the button
Seat 1: Player_f26cf01a (17,605 in chips)
Seat 2: Hero (14,830 in chips)
Seat 3: Player_95d54fbd (8,900 in chips)
Seat 4: Player_ea5a30e0 (6,348 in chips)
Seat 5: Player_5398421d (9,405 in chips)
Seat 6: Player_09bfcc32 (15,325 in chips)
Seat 7: Player_d95dc2ae (14,405 in chips)
Seat 8: Player_28fb0f93 (12,680 in chips)
Player_f26cf01a: posts the ante 25
Hero: posts the ante 25
Player_95d54fbd: posts the ante 25
Player_ea5a30e0: posts the ante 25
Player_5398421d: posts the ante 25
Player_09bfcc32: posts the ante 25
Player_d95dc2ae: posts the ante 25
Player_28fb0f93: posts the ante 25
Player_ea5a30e0: posts small blind 125
Player_5398421d: posts big blind 250
*** HOLE CARDS ***
Dealt to Hero [4c 8h]
Player_09bfcc32: folds
Player_d95dc2ae: raises 500 to 500
Player_28fb0f93: folds
Player_f26cf01a: folds
Hero: folds
Player_95d54fbd: folds
Player_ea5a30e0: folds
Player_5398421d: folds
Uncalled bet (250) returned to Player_d95dc2ae
Player_d95dc2ae: doesn't show hand
Player_d95dc2ae collected 825 from pot
*** SUMMARY ***
Total pot 825 | Rake 0
Seat 1: Player_f26cf01a mucked
Seat 2: Hero mucked
Seat 3: Player_95d54fbd (button) mucked
Seat 4: Player_ea5a30e0 (small blind) mucked
Seat 5: Player_5398421d (big blind) mucked
Seat 6: Player_09bfcc32 mucked
Seat 7: Player_d95dc2ae won (825)
Seat 8: Player_28fb0f93 mucked



PokerStars Hand #3661299816: Tournament #21391319, $20+$2 - Hold'em No Limit (125/250) - 2018/04/06 23:04:53
Table '#18' Seat #4 is the button
Seat 1: Player_806ec578 (17,580 in chips)
Seat 2: Hero (14,805 in chips)
Seat 3: Player_480e1f3c (8,875 in chips)
Seat 4: Player_9983c287 (6,198 in chips)
Seat 5: Player_3d534687 (9,130 in chips)
Seat 6: Player_ce18ff45 (15,300 in chips)
Seat 7: Player_79da083c (14,955 in chips)
Seat 8: Player_4855dc7f (12,655 in chips)
Player_806ec578: posts the ante 25
Hero: posts the ante 25
Player_480e1f3c: posts the ante 25
Player_9983c287: posts the ante 25
Player_3d534687: posts the ante 25
Player_ce18ff45: posts the ante 25
Player_79da083c: posts the ante 25
Player_4855dc7f: posts the ante 25
Player_3d534687: posts small blind 125
Player_ce18ff45: posts big blind 250
*** HOLE CARDS ***
Dealt to Hero [9d 7d]
Player_79da083c: folds
Player_4855dc7f: folds
Player_806ec578: folds
Hero: raises 600 to 600
Player_480e1f3c: raises 2375 to 2375
Player_9983c287: folds
Player_3d534687: folds
Player_ce18ff45: folds
Hero: folds
Uncalled bet (1775) returned to Player_480e1f3c
Player_480e1f3c: doesn't show hand
Player_480e1f3c collected 1775 from pot
*** SUMMARY ***
Total pot 1775 | Rake 0
Seat 1: Player_806ec578 mucked
Seat 2: Hero mucked
Seat 3: Player_480e1f3c won (1775)
Seat 4: Player_9983c287 (button) mucked
Seat 5: Player_3d534687 (small blind) mucked
Seat 6: Player_ce18ff45 (big blind) mucked
Seat 7: Player_79da083c mucked
Seat 8: Player_4855dc7f mucked



PokerStars Hand #3661300682: Tournament #21391319, $20+$2 - Hold'em No Limit (125/250) - 2018/04/06 23:06:08
Table '#18' Seat #5 is the button
Seat 1: Player_ebf3447d (17,555 in chips)
Seat 2: Hero (14,180 in chips)
Seat 3: Player_b0f4ac2f (10,025 in chips)
Seat 4: Player_d11c2667 (6,173 in chips)
Seat 5: Player_e22cbd07 (8,980 in chips)
Seat 6: Player_ca4080db (15,025 in chips)
Seat 7: Player_513dd25c (14,930 in chips)
Seat 8: Player_03b70476 (12,630 in chips)
Player_ebf3447d: posts the ante 25
Hero: posts the ante 25
Player_b0f4ac2f: posts the ante 25
Player_d11c2667: posts the ante 25
Player_e22cbd07: posts the ante 25
Player_ca4080db: posts the ante 25
Player_513dd25c: posts the ante 25
Player_03b70476: posts the ante 25
Player_ca4080db: posts small blind 125
Player_513dd25c: posts big blind 250
*** HOLE CARDS ***
Dealt to Hero [2c Qh]
Player_03b70476: folds
Player_ebf3447d: folds
Hero: folds
Player_b0f4ac2f: folds
Player_d11c2667: raises 716 to 716
Player_e22cbd07: folds
Player_ca4080db: folds
Player_513dd25c: calls 466 
*** FLOP *** [8h 2h 6s]
Player_513dd25c: bets 1574 
Player_d11c2667: raises 5432 to 5432 and is all-in
Player_513dd25c: calls 3858 
*** TURN *** [8h 2h 6s] [9h]
*** RIVER *** [8h 2h 6s 9h] [4d]
*** SHOW DOWN ***
Player_d11c2667: shows [Qd Ac] (high card Ace)
Player_513dd25c: shows [9c 7c] (a pair of Nines)
Player_513dd25c collected 12621 from pot
Player_d11c2667 finished the tournament in 138th place
*** SUMMARY ***
Total pot 12621 | Rake 0
Board [8h 2h 6s 9h 4d]
Seat 1: Player_ebf3447d mucked
Seat 2: Hero mucked
Seat 3: Player_b0f4ac2f mucked
Seat 4: Player_d11c2667 showed [Qd Ac] and lost with high card Ace
Seat 5: Player_e22cbd07 (button) mucked
Seat 6: Player_ca4080db (small blind) mucked
Seat 7: Player_513dd25c (big blind) showed [9c 7c] and won (12621) with a pair of Nines
Seat 8: Player_03b70476 mucked



PokerStars Hand #3661301471: Tournament #21391319, $20+$2 - Hold'em No Limit (125/250) - 2018/04/06 23:07:20
Table '#18' Seat #6 is the button
Seat 1: Player_e45f0945 (17,530 in chips)
Seat 2: Player_8c5bade1 (10,000 in chips)
Seat 3: Hero (14,155 in chips)
Seat 4: Player_af2578b1 (10,000 in chips)
Seat 5: Player_22a3f1c9 (8,955 in chips)
Seat 6: Player_120e2b9f (14,875 in chips)
Seat 7: Player_052405a0 (21,378 in chips)
Seat 8: Player_6745ff0a (12,605 in chips)
Player_e45f0945: posts the ante 25
Player_8c5bade1: posts the ante 25
Hero: posts the ante 25
Player_af2578b1: posts the ante 25
Player_22a3f1c9: posts the ante 25
Player_120e2b9f: posts the ante 25
Player_052405a0: posts the ante 25
Player_6745ff0a: posts the ante 25
Player_052405a0: posts small blind 125
Player_6745ff0a: posts big blind 250
*** HOLE CARDS ***
Dealt to Hero [Js Kc]
Player_e45f0945: calls 250 
Player_8c5bade1: folds
Hero: folds
Player_af2578b1: folds
Player_22a3f1c9: folds
Player_120e2b9f: folds
Player_052405a0: folds
Player_6745ff0a: checks
*** FLOP *** [4c 7c Kh]
Player_6745ff0a: checks
Player_e45f0945: checks
*** TURN *** [4c 7c Kh] [Qd]
Player_6745ff0a: checks
Player_e45f0945: bets 450 
Player_6745ff0a: folds
Uncalled bet (450) returned to Player_e45f0945
Player_e45f0945: doesn't show hand
Player_e45f0945 collected 825 from pot
*** SUMMARY ***
Total pot 825 | Rake 0
Board [4c 7c Kh Qd]
Seat 1: Player_e45f0945 won (825)
Seat 2: Player_8c5bade1 mucked
Seat 3: Hero mucked
Seat 4: Player_af2578b1 mucked
Seat 5: Player_22a3f1c9 mucked
Seat 6: Player_120e2b9f (button) mucked
Seat 7: Player_052405a0 (small blind) mucked
Seat 8: Player_6745ff0a (big blind) mucked



PokerStars Hand #3661302332: Tournament #21391319, $20+$2 - Hold'em No Limit (125/250) - 2018/04/06 23:08:38
Table '#18' Seat #8 is the button
Seat 1: Player_e7ad2b47 (18,080 in chips)
Seat 2: Player_c6d64a2e (9,975 in chips)
Seat 3: Hero (14,130 in chips)
Seat 4: Player_f7c66e85 (9,975 in chips)
Seat 5: Player_3b31a2db (10,000 in chips)
Seat 6: Player_3193f655 (8,930 in chips)
Seat 7: Player_ee9c11f8 (14,850 in chips)
Seat 8: Player_b241d854 (21,228 in chips)
Seat 9: Player_4c2093ca (12,330 in chips)
Player_e7ad2b47: posts the ante 25
Player_c6d64a2e: posts the ante 25
Hero: posts the ante 25
Player_f7c66e85: posts the ante 25
Player_3b31a2db: posts the ante 25
Player_3193f655: posts the ante 25
Player_ee9c11f8: posts the ante 25
Player_b241d854: posts the ante 25
Player_4c2093ca: posts the ante 25
Player_4c2093ca: posts small blind 125
Player_e7ad2b47: posts big blind 250
*** HOLE CARDS ***
Dealt to Hero [Ac 8d]
Player_c6d64a2e: folds
Hero: folds
Player_f7c66e85: folds
Player_3b31a2db: folds
Player_3193f655: raises 750 to 750
Player_ee9c11f8: calls 750 
Player_b241d854: folds
Player_4c2093ca: folds
Player_e7ad2b47: calls 500 
*** FLOP *** [2d Jc 6c]
Player_e7ad2b47: checks
Player_3193f655: checks
Player_ee9c11f8: checks
*** TURN *** [2d Jc 6c] [Td]
Player_e7ad2b47: checks
Player_3193f655: checks
Player_ee9c11f8: bets 3607 
Player_e7ad2b47: folds
Player_3193f655: folds
Uncalled bet (3607) returned to Player_ee9c11f8
Player_ee9c11f8: doesn't show hand
Player_ee9c11f8 collected 2600 from pot
*** SUMMARY ***
Total pot 2600 | Rake 0
Board [2d Jc 6c Td]
Seat 1: Player_e7ad2b47 (big blind) mucked
Seat 2: Player_c6d64a2e mucked
Seat 3: Hero mucked
Seat 4: Player_f7c66e85 mucked
Seat 5: Player_3b31a2db mucked
Seat 6: Player_3193f655 mucked
Seat 7: Player_ee9c11f8 won (2600)
Seat 8: Player_b241d854 (button) mucked
Seat 9: Player_4c2093ca (small blind) mucked



PokerStars Hand #3661303270: Tournament #21391319, $20+$2 - Hold'em No Limit (125/250) - 2018/04/06 23:09:59
Table '#18' Seat #9 is the button
Seat 1: Player_26ea1f2a (17,305 in chips)
Seat 2: Player_4dcc33c7 (9,950 in chips)
Seat 3: Hero (14,105 in chips)
Seat 4: Player_30a4b8c6 (9,950 in chips)
Seat 5: Player_1dadd8b8 (9,975 in chips)
Seat 6: Player_b32193bc (8,155 in chips)
Seat 7: Player_f31883fe (16,675 in chips)
Seat 8: Player_7ad923b9 (21,203 in chips)
Seat 9: Player_cc468319 (12,180 in chips)
Player_26ea1f2a: posts the ante 25
Player_4dcc33c7: posts the ante 25
Hero: posts the ante 25
Player_30a4b8c6: posts the ante 25
Player_1dadd8b8: posts the ante 25
Player_b32193bc: posts the ante 25
Player_f31883fe: posts the ante 25
Player_7ad923b9: posts the ante 25
Player_cc468319: posts the ante 25
Player_26ea1f2a: posts small blind 125
Player_4dcc33c7: posts big blind 250
*** HOLE CARDS ***
Dealt to Hero [Jd 9d]
Hero: raises 600 to 600
Player_30a4b8c6: raises 2400 to 2400
Player_1dadd8b8: folds
Player_b32193bc: folds
Player_f31883fe: folds
Player_7ad923b9: folds
Player_cc468319: folds
Player_26ea1f2a: folds
Player_4dcc33c7: folds
Hero: folds
Uncalled bet (1800) returned to Player_30a4b8c6
Player_30a4b8c6: doesn't show hand
Player_30a4b8c6 collected 1800 from pot
*** SUMMARY ***
Total pot 1800 | Rake 0
Seat 1: Player_26ea1f2a (small blind) mucked
Seat 2: Player_4dcc33c7 (big blind) mucked
Seat 3: Hero mucked
Seat 4: Player_30a4b8c6 won (1800)
Seat 5: Player_1dadd8b8 mucked
Seat 6: Player_b32193bc mucked
Seat 7: Player_f31883fe mucked
Seat 8: Player_7ad923b9 mucked
Seat 9: Player_cc468319 (button) mucked



PokerStars Hand #3661304019: Tournament #21391319, $20+$2 - Hold'em No Limit (125/250) - 2018/04/06 23:11:08
Table '#18' Seat #1 is the button
Seat 1: Player_a2ea4f9a (17,155 in chips)
Seat 2: Player_7e8c870c (9,675 in chips)
Seat 3: Hero (13,480 in chips)
Seat 4: Player_6c71fa6a (11,125 in chips)
Seat 5: Player_201ae5db (9,950 in chips)
Seat 6: Player_f00871fb (8,130 in chips)
Seat 7: Player_802c34ac (16,650 in chips)
Seat 8: Player_b6fc3a5a (21,178 in chips)
Seat 9: Player_572c56a7 (12,155 in chips)
Player_a2ea4f9a: posts the ante 25
Player_7e8c870c: posts the ante 25
Hero: posts the ante 25
Player_6c71fa6a: posts the ante 25
Player_201ae5db: posts the ante 25
Player_f00871fb: posts the ante 25
Player_802c34ac: posts the ante 25
Player_b6fc3a5a: posts the ante 25
Player_572c56a7: posts the ante 25
Player_7e8c870c: posts small blind 125
Hero: posts big blind 250
*** HOLE CARDS ***
Dealt to Hero [2d 9c]
Player_6c71fa6a: folds
Player_201ae5db: folds
Player_f00871fb: folds
Player_802c34ac: folds
Player_b6fc3a5a: folds
Player_572c56a7: folds
Player_a2ea4f9a: calls 250 
Player_7e8c870c: folds
Hero: checks
*** FLOP *** [4d Ts 8c]
Hero: checks
Player_a2ea4f9a: checks
*** TURN *** [4d Ts 8c] [2s]
Hero: checks
Player_a2ea4f9a: checks
*** RIVER *** [4d Ts 8c 2s] [3h]
Hero: checks
Player_a2ea4f9a: checks
*** SHOW DOWN ***
Hero: shows [2d 9c] (a pair of Deuces)
Player_a2ea4f9a: Mucks [Kc 9d] (High Card)
Hero collected 850 from pot
*** SUMMARY ***
Total pot 850 | Rake 0
Board [4d Ts 8c 2s 3h]
Seat 1: Player_a2ea4f9a (button) mucked [Kc 9d]
Seat 2: Player_7e8c870c (small blind) mucked
Seat 3: Hero (big blind) showed [2d 9c] and won (850) with a pair of Deuces
Seat 4: Player_6c71fa6a mucked
Seat 5: Player_201ae5db mucked
Seat 6: Player_f00871fb mucked
Seat 7: Player_802c34ac mucked
Seat 8: Player_b6fc3a5a mucked
Seat 9: Player_572c56a7 mucked



PokerStars Hand #3661305229: Tournament #21391319, $20+$2 - Hold'em No Limit (150/300) - 2018/04/06 23:12:59
Table '#18' Seat #2 is the button
Seat 1: Player_3707538f (16,880 in chips)
Seat 2: Player_269e2ed0 (9,525 in chips)
Seat 3: Hero (14,055 in chips)
Seat 4: Player_ad8f1322 (11,100 in chips)
Seat 5: Player_760fb283 (9,925 in chips)
Seat 6: Player_39c781c4 (8,105 in chips)
Seat 7: Player_80f62344 (16,625 in chips)
Seat 8: Player_6aafe8c5 (21,153 in chips)
Seat 9: Player_003d91a6 (12,130 in chips)
Player_3707538f: posts the ante 30
Player_269e2ed0: posts the ante 30
Hero: posts the ante 30
Player_ad8f1322: posts the ante 30
Player_760fb283: posts the ante 30
Player_39c781c4: posts the ante 30
Player_80f62344: posts the ante 30
Player_6aafe8c5: posts the ante 30
Player_003d91a6: posts the ante 30
Hero: posts small blind 150
Player_ad8f1322: posts big blind 300
*** HOLE CARDS ***
Dealt to Hero [4c 2s]
Player_760fb283: folds
Player_39c781c4: folds
Player_80f62344: folds
Player_6aafe8c5: folds
Player_003d91a6: folds
Player_3707538f: folds
Player_269e2ed0: folds
Hero: folds
Player_ad8f1322: doesn't show hand
Uncalled bet (300) returned to Player_ad8f1322
Player_ad8f1322 collected 420 from pot
*** SUMMARY ***
Total pot 420 | Rake 0
Seat 1: Player_3707538f mucked
Seat 2: Player_269e2ed0 (button) mucked
Seat 3: Hero (small blind) mucked
Seat 4: Player_ad8f1322 (big blind) won (420)
Seat 5: Player_760fb283 mucked
Seat 6: Player_39c781c4 mucked
Seat 7: Player_80f62344 mucked
Seat 8: Player_6aafe8c5 mucked
Seat 9: Player_003d91a6 mucked



PokerStars Hand #3661305779: Tournament #21391319, $20+$2 - Hold'em No Limit (150/300) - 2018/04/06 23:13:50
Table '#18' Seat #3 is the button
Seat 1: Player_07b2d412 (16,850 in chips)
Seat 2: Player_e0d7ffed (9,495 in chips)
Seat 3: Hero (13,875 in chips)
Seat 4: Player_96a0d187 (11,490 in chips)
Seat 5: Player_c5f707a5 (9,895 in chips)
Seat 6: Player_8b131a47 (8,075 in chips)
Seat 7: Player_31df00d0 (21,123 in chips)
Seat 8: Player_6febe601 (12,100 in chips)
Player_07b2d412: posts the ante 30
Player_e0d7ffed: posts the ante 30
Hero: posts the ante 30
Player_96a0d187: posts the ante 30
Player_c5f707a5: posts the ante 30
Player_8b131a47: posts the ante 30
Player_31df00d0: posts the ante 30
Player_6febe601: posts the ante 30
Player_96a0d187: posts small blind 150
Player_c5f707a5: posts big blind 300
*** HOLE CARDS ***
Dealt to Hero [6s 7d]
Player_8b131a47: folds
Player_31df00d0: folds
Player_6febe601: folds
Player_07b2d412: calls 300 
Player_e0d7ffed: folds
Hero: folds
Player_96a0d187: calls 150 
Player_c5f707a5: checks
*** FLOP *** [4h Qh Qs]
Player_96a0d187: checks
Player_c5f707a5: checks
Player_07b2d412: checks
*** TURN *** [4h Qh Qs] [4d]
Player_96a0d187: checks
Player_c5f707a5: checks
Player_07b2d412: checks
*** RIVER *** [4h Qh Qs 4d] [3c]
Player_96a0d187: checks
Player_c5f707a5: checks
Player_07b2d412: checks
*** SHOW DOWN ***
Player_96a0d187: shows [9h Kd] (two pair, Queens and Fours)
Player_c5f707a5: Mucks [2s 7h] (Two pair)
Player_07b2d412: shows [7c Ad] (two pair, Queens and Fours)
Player_07b2d412 collected 1140 from pot
*** SUMMARY ***
Total pot 1140 | Rake 0
Board [4h Qh Qs 4d 3c]
Seat 1: Player_07b2d412 showed [7c Ad] and won (1140) with two pair, Queens and Fours
Seat 2: Player_e0d7ffed mucked
Seat 3: Hero (button) mucked
Seat 4: Player_96a0d187 (small blind) showed [9h Kd] and lost with two pair, Queens and Fours
Seat 5: Player_c5f707a5 (big blind) mucked [2s 7h]
Seat 6: Player_8b131a47 mucked
Seat 7: Player_31df00d0 mucked
Seat 8: Player_6febe601 mucked



PokerStars Hand #3661307417: Tournament #21391319, $20+$2 - Hold'em No Limit (150/300) - 2018/04/06 23:16:14
Table '#18' Seat #4 is the button
Seat 1: Player_013a476e (17,660 in chips)
Seat 2: Player_dad55463 (9,465 in chips)
Seat 3: Hero (13,845 in chips)
Seat 4: Player_d1822e2a (11,160 in chips)
Seat 5: Player_85165314 (9,565 in chips)
Seat 6: Player_16b7d7d5 (8,045 in chips)
Seat 7: Player_36f8665c (10,000 in chips)
Seat 8: Player_6ed9b355 (21,093 in chips)
Seat 9: Player_7f0ee1bc (12,070 in chips)
Player_013a476e: posts the ante 30
Player_dad55463: posts the ante 30
Hero: posts the ante 30
Player_d1822e2a: posts the ante 30
Player_85165314: posts the ante 30
Player_16b7d7d5: posts the ante 30
Player_36f8665c: posts the ante 30
Player_6ed9b355: posts the ante 30
Player_7f0ee1bc: posts the ante 30
Player_85165314: posts small blind 150
Player_16b7d7d5: posts big blind 300
*** HOLE CARDS ***
Dealt to Hero [Ah 4h]
Player_36f8665c: folds
Player_6ed9b355: folds
Player_7f0ee1bc: folds
Player_013a476e: folds
Player_dad55463: raises 900 to 900
Hero: folds
Player_d1822e2a: folds
Player_85165314: folds
Player_16b7d7d5: folds
Uncalled bet (600) returned to Player_dad55463
Player_dad55463: doesn't show hand
Player_dad55463 collected 1020 from pot
*** SUMMARY ***
Total pot 1020 | Rake 0
Seat 1: Player_013a476e mucked
Seat 2: Player_dad55463 won (1020)
Seat 3: Hero mucked
Seat 4: Player_d1822e2a (button) mucked
Seat 5: Player_85165314 (small blind) mucked
Seat 6: Player_16b7d7d5 (big blind) mucked
Seat 7: Player_36f8665c mucked
Seat 8: Player_6ed9b355 mucked
Seat 9: Player_7f0ee1bc mucked



PokerStars Hand #3661308142: Tournament #21391319, $20+$2 - Hold'em No Limit (150/300) - 2018/04/06 23:17:17
Table '#18' Seat #5 is the button
Seat 1: Player_68f19186 (17,630 in chips)
Seat 2: Player_f4004e63 (10,155 in chips)
Seat 3: Hero (13,815 in chips)
Seat 4: Player_ab9cd950 (11,130 in chips)
Seat 5: Player_c46f8082 (9,385 in chips)
Seat 6: Player_e3e1c4a5 (7,715 in chips)
Seat 7: Player_47be1f2d (9,970 in chips)
Seat 8: Player_d95c83fa (21,063 in chips)
Seat 9: Player_cd498f1a (12,040 in chips)
Player_68f19186: posts the ante 30
Player_f4004e63: posts the ante 30
Hero: posts the ante 30
Player_ab9cd950: posts the ante 30
Player_c46f8082: posts the ante 30
Player_e3e1c4a5: posts the ante 30
Player_47be1f2d: posts the ante 30
Player_d95c83fa: posts the ante 30
Player_cd498f1a: posts the ante 30
Player_e3e1c4a5: posts small blind 150
Player_47be1f2d: posts big blind 300
*** HOLE CARDS ***
Dealt to Hero [Kh 8s]
Player_d95c83fa: folds
Player_cd498f1a: folds
Player_68f19186: folds
Player_f4004e63: folds
Hero: folds
Player_ab9cd950: raises 1320 to 1320
Player_c46f8082: folds
Player_e3e1c4a5: folds
Player_47be1f2d: folds
Uncalled bet (1020) returned to Player_ab9cd950
Player_ab9cd950: doesn't show hand
Player_ab9cd950 collected 1020 from pot
*** SUMMARY ***
Total pot 1020 | Rake 0
Seat 1: Player_68f19186 mucked
Seat 2: Player_f4004e63 mucked
Seat 3: Hero mucked
Seat 4: Player_ab9cd950 won (1020)
Seat 5: Player_c46f8082 (button) mucked
Seat 6: Player_e3e1c4a5 (small blind) mucked
Seat 7: Player_47be1f2d (big blind) mucked
Seat 8: Player_d95c83fa mucked
Seat 9: Player_cd498f1a mucked



PokerStars Hand #3661308758: Tournament #21391319, $20+$2 - Hold'em No Limit (150/300) - 2018/04/06 23:18:11
Table '#18' Seat #6 is the button
Seat 1: Player_39b8d638 (17,600 in chips)
Seat 2: Player_cda54d20 (10,125 in chips)
Seat 3: Hero (13,785 in chips)
Seat 4: Player_ff9db2fc (11,820 in chips)
Seat 5: Player_d41af15a (9,355 in chips)
Seat 6: Player_e4420fba (7,535 in chips)
Seat 7: Player_25675f78 (9,640 in chips)
Seat 8: Player_ce32ff1f (21,033 in chips)
Seat 9: Player_d0bf734e (12,010 in chips)
Player_39b8d638: posts the ante 30
Player_cda54d20: posts the ante 30
Hero: posts the ante 30
Player_ff9db2fc: posts the ante 30
Player_d41af15a: posts the ante 30
Player_e4420fba: posts the ante 30
Player_25675f78: posts the ante 30
Player_ce32ff1f: posts the ante 30
Player_d0bf734e: posts the ante 30
Player_25675f78: posts small blind 150
Player_ce32ff1f: posts big blind 300
*** HOLE CARDS ***
Dealt to Hero [Js Jd]
Player_d0bf734e: folds
Player_39b8d638: folds
Player_cda54d20: folds
Hero: raises 700 to 700
Player_ff9db2fc: folds
Player_d41af15a: calls 700 
Player_e4420fba: calls 700 
Player_25675f78: folds
Player_ce32ff1f: folds
*** FLOP *** [Ac Qh 6d]
Hero: bets 999 
Player_d41af15a: folds
Player_e4420fba: calls 999 
*** TURN *** [Ac Qh 6d] [Jh]
Hero: bets 2000 
Player_e4420fba: raises 5806 to 5806 and is all-in
Hero: calls 3806 
*** RIVER *** [Ac Qh 6d Jh] [6h]
*** SHOW DOWN ***
Hero: shows [Js Jd] (a full house, Jacks full of Sixes)
Player_e4420fba: shows [Qd Ah] (two pair, Aces and Queens)
Hero collected 16430 from pot
Player_e4420fba finished the tournament in 149th place
*** SUMMARY ***
Total pot 16430 | Rake 0
Board [Ac Qh 6d Jh 6h]
Seat 1: Player_39b8d638 mucked
Seat 2: Player_cda54d20 mucked
Seat 3: Hero showed [Js Jd] and won (16430) with a full house, Jacks full of Sixes
Seat 4: Player_ff9db2fc mucked
Seat 5: Player_d41af15a mucked
Seat 6: Player_e4420fba (button) showed [Qd Ah] and lost with two pair, Aces and Queens
Seat 7: Player_25675f78 (small blind) mucked
Seat 8: Player_ce32ff1f (big blind) mucked
Seat 9: Player_d0bf734e mucked



PokerStars Hand #3661309899: Tournament #21391319, $20+$2 - Hold'em No Limit (150/300) - 2018/04/06 23:19:50
Table '#18' Seat #6 is the button
Seat 1: Player_ebeb4098 (17,570 in chips)
Seat 2: Player_bba6b423 (10,095 in chips)
Seat 3: Hero (22,680 in chips)
Seat 4: Player_c1565211 (11,790 in chips)
Seat 5: Player_53852693 (8,625 in chips)
Seat 6: Player_130e4250 (9,460 in chips)
Seat 7: Player_1e412e5f (20,703 in chips)
Seat 8: Player_ba09762d (11,980 in chips)
Player_ebeb4098: posts the ante 30
Player_bba6b423: posts the ante 30
Hero: posts the ante 30
Player_c1565211: posts the ante 30
Player_53852693: posts the ante 30
Player_130e4250: posts the ante 30
Player_1e412e5f: posts the ante 30
Player_ba09762d: posts the ante 30
Player_1e412e5f: posts small blind 150
Player_ba09762d: posts big blind 300
*** HOLE CARDS ***
Dealt to Hero [5c 9h]
Player_ebeb4098: folds
Player_bba6b423: folds
Hero: folds
Player_c1565211: folds
Player_53852693: folds
Player_130e4250: raises 1200 to 1200
Player_1e412e5f: raises 20523 to 20673 and is all-in
Player_ba09762d: folds
Player_130e4250: calls 8230 and is all-in
*** FLOP *** [Kc 2d Ks]
*** TURN *** [Kc 2d Ks] [8c]
*** RIVER *** [Kc 2d Ks 8c] [4c]
*** SHOW DOWN ***
Player_130e4250: shows [Qd Jc] (a pair of Kings)
Player_1e412e5f: shows [9d Kd] (three of a kind, Kings)
Uncalled bet (11243) returned to Player_1e412e5f
Player_1e412e5f collected 19400 from pot
Player_130e4250 finished the tournament in 148th place
*** SUMMARY ***
Total pot 19400 | Rake 0
Board [Kc 2d Ks 8c 4c]
Seat 1: Player_ebeb4098 mucked
Seat 2: Player_bba6b423 mucked
Seat 3: Hero mucked
Seat 4: Player_c1565211 mucked
Seat 5: Player_53852693 mucked
Seat 6: Player_130e4250 (button) showed [Qd Jc] and lost with a pair of Kings
Seat 7: Player_1e412e5f (small blind) showed [9d Kd] and won (19400) with three of a kind, Kings
Seat 8: Player_ba09762d (big blind) mucked



PokerStars Hand #3661310670: Tournament #21391319, $20+$2 - Hold'em No Limit (150/300) - 2018/04/06 23:20:56
Table '#18' Seat #6 is the button
Seat 1: Player_fcd42b5e (17,540 in chips)
Seat 2: Player_db548e59 (10,065 in chips)
Seat 3: Hero (22,650 in chips)
Seat 4: Player_0ca6fb20 (11,760 in chips)
Seat 5: Player_66649783 (8,595 in chips)
Seat 6: Player_6e26c844 (30,643 in chips)
Seat 7: Player_3f9f2409 (11,650 in chips)
Player_fcd42b5e: posts the ante 30
Player_db548e59: posts the ante 30
Hero: posts the ante 30
Player_0ca6fb20: posts the ante 30
Player_66649783: posts the ante 30
Player_6e26c844: posts the ante 30
Player_3f9f2409: posts the ante 30
Player_3f9f2409: posts small blind 150
Player_fcd42b5e: posts big blind 300
*** HOLE CARDS ***
Dealt to Hero [3c 2h]
Player_db548e59: folds
Hero: folds
Player_0ca6fb20: folds
Player_66649783: folds
Player_6e26c844: folds
Player_3f9f2409: raises 750 to 900
Player_fcd42b5e: folds
Uncalled bet (600) returned to Player_3f9f2409
Player_3f9f2409: doesn't show hand
Player_3f9f2409 collected 810 from pot
*** SUMMARY ***
Total pot 810 | Rake 0
Seat 1: Player_fcd42b5e (big blind) mucked
Seat 2: Player_db548e59 mucked
Seat 3: Hero mucked
Seat 4: Player_0ca6fb20 mucked
Seat 5: Player_66649783 mucked
Seat 6: Player_6e26c844 (button) mucked
Seat 7: Player_3f9f2409 (small blind) won (810)



PokerStars Hand #3661311473: Tournament #21391319, $20+$2 - Hold'em No Limit (200/400) - 2018/04/06 23:22:08
Table '#18' Seat #8 is the button
Seat 1: Player_57b8a93c (17,210 in chips)
Seat 2: Player_89ec0e73 (10,035 in chips)
Seat 3: Hero (22,620 in chips)
Seat 4: Player_f245b713 (11,730 in chips)
Seat 5: Player_da9b1e25 (8,565 in chips)
Seat 6: Player_6c586618 (10,000 in chips)
Seat 7: Player_86bfb5a2 (30,613 in chips)
Seat 8: Player_fa446e11 (12,130 in chips)
Player_57b8a93c: posts the ante 40
Player_89ec0e73: posts the ante 40
Hero: posts the ante 40
Player_f245b713: posts the ante 40
Player_da9b1e25: posts the ante 40
Player_6c586618: posts the ante 40
Player_86bfb5a2: posts the ante 40
Player_fa446e11: posts the ante 40
Player_57b8a93c: posts small blind 200
Player_89ec0e73: posts big blind 400
*** HOLE CARDS ***
Dealt to Hero [2d 5c]
Hero: folds
Player_f245b713: folds
Player_da9b1e25: folds
Player_6c586618: folds
Player_86bfb5a2: raises 800 to 800
Player_fa446e11: folds
Player_57b8a93c: folds
Player_89ec0e73: folds
Uncalled bet (400) returned to Player_86bfb5a2
Player_86bfb5a2: doesn't show hand
Player_86bfb5a2 collected 1320 from pot
*** SUMMARY ***
Total pot 1320 | Rake 0
Seat 1: Player_57b8a93c (small blind) mucked
Seat 2: Player_89ec0e73 (big blind) mucked
Seat 3: Hero mucked
Seat 4: Player_f245b713 mucked
Seat 5: Player_da9b1e25 mucked
Seat 6: Player_6c586618 mucked
Seat 7: Player_86bfb5a2 won (1320)
Seat 8: Player_fa446e11 (button) mucked



PokerStars Hand #3661311997: Tournament #21391319, $20+$2 - Hold'em No Limit (200/400) - 2018/04/06 23:22:59
Table '#18' Seat #1 is the button
Seat 1: Player_c4f6f543 (16,970 in chips)
Seat 2: Player_7d09c89c (9,595 in chips)
Seat 3: Hero (22,580 in chips)
Seat 4: Player_78d8099e (11,690 in chips)
Seat 5: Player_a7d5790e (8,525 in chips)
Seat 6: Player_5acbe78f (9,960 in chips)
Seat 7: Player_855d0104 (10,000 in chips)
Seat 8: Player_fb59fc5b (31,493 in chips)
Seat 9: Player_cfd305a3 (12,090 in chips)
Player_c4f6f543: posts the ante 40
Player_7d09c89c: posts the ante 40
Hero: posts the ante 40
Player_78d8099e: posts the ante 40
Player_a7d5790e: posts the ante 40
Player_5acbe78f: posts the ante 40
Player_855d0104: posts the ante 40
Player_fb59fc5b: posts the ante 40
Player_cfd305a3: posts the ante 40
Player_7d09c89c: posts small blind 200
Hero: posts big blind 400
*** HOLE CARDS ***
Dealt to Hero [2d 5d]
Player_78d8099e: folds
Player_a7d5790e: calls 400 
Player_5acbe78f: folds
Player_855d0104: raises 2800 to 2800
Player_fb59fc5b: folds
Player_cfd305a3: folds
Player_c4f6f543: folds
Player_7d09c89c: folds
Hero: folds
Player_a7d5790e: folds
*** SHOW DOWN ***
Player_855d0104: shows [Ac Kc] (high card Ace)
Uncalled bet (2400) returned to Player_855d0104
Player_855d0104 collected 1760 from pot
*** SUMMARY ***
Total pot 1760 | Rake 0
Seat 1: Player_c4f6f543 (button) mucked
Seat 2: Player_7d09c89c (small blind) mucked
Seat 3: Hero (big blind) mucked
Seat 4: Player_78d8099e mucked
Seat 5: Player_a7d5790e mucked
Seat 6: Player_5acbe78f mucked
Seat 7: Player_855d0104 showed [Ac Kc] and won (1760) with high card Ace
Seat 8: Player_fb59fc5b mucked
Seat 9: Player_cfd305a3 mucked



PokerStars Hand #3661312735: Tournament #21391319, $20+$2 - Hold'em No Limit (200/400) - 2018/04/06 23:24:05
Table '#18' Seat #2 is the button
Seat 1: Player_de3ff44e (16,930 in chips)
Seat 2: Player_68bd4770 (9,355 in chips)
Seat 3: Hero (22,140 in chips)
Seat 4: Player_f5159e21 (11,650 in chips)
Seat 5: Player_c8b26a94 (8,085 in chips)
Seat 6: Player_a554dcae (9,920 in chips)
Seat 7: Player_08c82be1 (11,320 in chips)
Seat 8: Player_1194eee1 (31,453 in chips)
Seat 9: Player_a812ee89 (12,050 in chips)
Player_de3ff44e: posts the ante 40
Player_68bd4770: posts the ante 40
Hero: posts the ante 40
Player_f5159e21: posts the ante 40
Player_c8b26a94: posts the ante 40
Player_a554dcae: posts the ante 40
Player_08c82be1: posts the ante 40
Player_1194eee1: posts the ante 40
Player_a812ee89: posts the ante 40
Hero: posts small blind 200
Player_f5159e21: posts big blind 400
*** HOLE CARDS ***
Dealt to Hero [8c Kh]
Player_c8b26a94: calls 400 
Player_a554dcae: calls 400 
Player_08c82be1: folds
Player_1194eee1: raises 1600 to 1600
Player_a812ee89: folds
Player_de3ff44e: folds
Player_68bd4770: folds
Hero: folds
Player_f5159e21: folds
Player_c8b26a94: calls 1200 
Player_a554dcae: calls 1200 
*** FLOP *** [As 4d 3h]
Player_c8b26a94: checks
Player_a554dcae: checks
Player_1194eee1: bets 1961 
Player_c8b26a94: calls 1961 
Player_a554dcae: calls 1961 
*** TURN *** [As 4d 3h] [6c]
Player_c8b26a94: checks
Player_a554dcae: bets 400 
Player_1194eee1: folds
Player_c8b26a94: raises 2400 to 2400
Player_a554dcae: calls 2000 
*** RIVER *** [As 4d 3h 6c] [9h]
Player_c8b26a94: bets 2084 and is all-in
Player_a554dcae: folds
Uncalled bet (2084) returned to Player_c8b26a94
Player_c8b26a94: doesn't show hand
Player_c8b26a94 collected 16443 from pot
*** SUMMARY ***
Total pot 16443 | Rake 0
Board [As 4d 3h 6c 9h]
Seat 1: Player_de3ff44e mucked
Seat 2: Player_68bd4770 (button) mucked
Seat 3: Hero (small blind) mucked
Seat 4: Player_f5159e21 (big blind) mucked
Seat 5: Player_c8b26a94 won (16443)
Seat 6: Player_a554dcae mucked
Seat 7: Player_08c82be1 mucked
Seat 8: Player_1194eee1 mucked
Seat 9: Player_a812ee89 mucked



PokerStars Hand #3661314035: Tournament #21391319, $20+$2 - Hold'em No Limit (200/400) - 2018/04/06 23:26:02
Table '#18' Seat #3 is the button
Seat 1: Player_3a75a0de (16,890 in chips)
Seat 2: Player_776befdf (9,315 in chips)
Seat 3: Hero (21,900 in chips)
Seat 4: Player_a12c57fb (11,210 in chips)
Seat 5: Player_77e62d27 (18,527 in chips)
Seat 6: Player_7a879a63 (3,919 in chips)
Seat 7: Player_f30d1c94 (11,280 in chips)
Seat 8: Player_dfa60e1a (27,852 in chips)
Seat 9: Player_5819cdd8 (12,010 in chips)
Player_3a75a0de: posts the ante 40
Player_776befdf: posts the ante 40
Hero: posts the ante 40
Player_a12c57fb: posts the ante 40
Player_77e62d27: posts the ante 40
Player_7a879a63: posts the ante 40
Player_f30d1c94: posts the ante 40
Player_dfa60e1a: posts the ante 40
Player_5819cdd8: posts the ante 40
Player_a12c57fb: posts small blind 200
Player_77e62d27: posts big blind 400
*** HOLE CARDS ***
Dealt to Hero [3d As]
Player_7a879a63: folds
Player_f30d1c94: calls 400 
Player_dfa60e1a: folds
Player_5819cdd8: folds
Player_3a75a0de: folds
Player_776befdf: folds
Hero: folds
Player_a12c57fb: calls 200 
Player_77e62d27: checks
*** FLOP *** [4h 4s Qc]
Player_a12c57fb: checks
Player_77e62d27: checks
Player_f30d1c94: bets 1560 
Player_a12c57fb: folds
Player_77e62d27: folds
Uncalled bet (1560) returned to Player_f30d1c94
Player_f30d1c94: doesn't show hand
Player_f30d1c94 collected 1560 from pot
*** SUMMARY ***
Total pot 1560 | Rake 0
Board [4h 4s Qc]
Seat 1: Player_3a75a0de mucked
Seat 2: Player_776befdf mucked
Seat 3: Hero (button) mucked
Seat 4: Player_a12c57fb (small blind) mucked
Seat 5: Player_77e62d27 (big blind) mucked
Seat 6: Player_7a879a63 mucked
Seat 7: Player_f30d1c94 won (1560)
Seat 8: Player_dfa60e1a mucked
Seat 9: Player_5819cdd8 mucked



PokerStars Hand #3661315176: Tournament #21391319, $20+$2 - Hold'em No Limit (200/400) - 2018/04/06 23:27:44
Table '#18' Seat #3 is the button
Seat 1: Player_db20c1d5 (16,850 in chips)
Seat 2: Hero (21,860 in chips)
Seat 3: Player_1b300093 (10,770 in chips)
Seat 4: Player_ef85314a (18,087 in chips)
Seat 5: Player_4ef6666d (3,879 in chips)
Seat 6: Player_afa9dcbd (12,400 in chips)
Seat 7: Player_00be7357 (27,812 in chips)
Seat 8: Player_f022408a (11,970 in chips)
Player_db20c1d5: posts the ante 40
Hero: posts the ante 40
Player_1b300093: posts the ante 40
Player_ef85314a: posts the ante 40
Player_4ef6666d: posts the ante 40
Player_afa9dcbd: posts the ante 40
Player_00be7357: posts the ante 40
Player_f022408a: posts the ante 40
Player_ef85314a: posts small blind 200
Player_4ef6666d: posts big blind 400
*** HOLE CARDS ***
Dealt to Hero [Ad Tc]
Player_afa9dcbd: folds
Player_00be7357: folds
Player_f022408a: folds
Player_db20c1d5: calls 400 
Hero: calls 400 
Player_1b300093: calls 400 
Player_ef85314a: folds
Player_4ef6666d: raises 3439 to 3839 and is all-in
Player_db20c1d5: calls 3439 
Hero: folds
Player_1b300093: folds
*** FLOP *** [6s Td Qs]
*** TURN *** [6s Td Qs] [8d]
*** RIVER *** [6s Td Qs 8d] [6d]
*** SHOW DOWN ***
Player_db20c1d5: shows [9c 9d] (two pair, Nines and Sixes)
Player_4ef6666d: shows [6c Ah] (three of a kind, Sixes)
Player_4ef6666d collected 8998 from pot
*** SUMMARY ***
Total pot 8998 | Rake 0
Board [6s Td Qs 8d 6d]
Seat 1: Player_db20c1d5 showed [9c 9d] and lost with two pair, Nines and Sixes
Seat 2: Hero mucked
Seat 3: Player_1b300093 (button) mucked
Seat 4: Player_ef85314a (small blind) mucked
Seat 5: Player_4ef6666d (big blind) showed [6c Ah] and won (8998) with three of a kind, Sixes
Seat 6: Player_afa9dcbd mucked
Seat 7: Player_00be7357 mucked
Seat 8: Player_f022408a mucked



PokerStars Hand #3661316172: Tournament #21391319, $20+$2 - Hold'em No Limit (200/400) - 2018/04/06 23:29:17
Table '#18' Seat #5 is the button
Seat 1: Player_a1e9c877 (12,971 in chips)
Seat 2: Player_a181cd7a (10,000 in chips)
Seat 3: Hero (21,420 in chips)
Seat 4: Player_b0e45a1d (10,330 in chips)
Seat 5: Player_ea11fb7e (17,847 in chips)
Seat 6: Player_348930a3 (8,998 in chips)
Seat 7: Player_9f740a82 (12,360 in chips)
Seat 8: Player_32b7a0e4 (27,772 in chips)
Seat 9: Player_530ddbf7 (11,930 in chips)
Player_a1e9c877: posts the ante 40
Player_a181cd7a: posts the ante 40
Hero: posts the ante 40
Player_b0e45a1d: posts the ante 40
Player_ea11fb7e: posts the ante 40
Player_348930a3: posts the ante 40
Player_9f740a82: posts the ante 40
Player_32b7a0e4: posts the ante 40
Player_530ddbf7: posts the ante 40
Player_348930a3: posts small blind 200
Player_9f740a82: posts big blind 400
*** HOLE CARDS ***
Dealt to Hero [Ks Ah]
Player_32b7a0e4: folds
Player_530ddbf7: folds
Player_a1e9c877: folds
Player_a181cd7a: folds
Hero: raises 999 to 999
Player_b0e45a1d: folds
Player_ea11fb7e: calls 999 
Player_348930a3: calls 799 
Player_9f740a82: calls 599 
*** FLOP *** [Th Qd Kh]
Player_348930a3: checks
Player_9f740a82: checks
Hero: checks
Player_ea11fb7e: checks
*** TURN *** [Th Qd Kh] [8s]
Player_348930a3: bets 400 
Player_9f740a82: raises 1600 to 1600
Hero: calls 1600 
Player_ea11fb7e: folds
Player_348930a3: calls 1200 
*** RIVER *** [Th Qd Kh 8s] [Kc]
Player_348930a3: checks
Player_9f740a82: bets 9156 
Hero: calls 9156 
Player_348930a3: folds
*** SHOW DOWN ***
Player_9f740a82: shows [Jh 9c] (a straight, Nine to King)
Hero: Mucks [Ks Ah] (Three of a kind)
Player_9f740a82 collected 27468 from pot
*** SUMMARY ***
Total pot 27468 | Rake 0
Board [Th Qd Kh 8s Kc]
Seat 1: Player_a1e9c877 mucked
Seat 2: Player_a181cd7a mucked
Seat 3: Hero mucked [Ks Ah]
Seat 4: Player_b0e45a1d mucked
Seat 5: Player_ea11fb7e (button) mucked
Seat 6: Player_348930a3 (small blind) mucked
Seat 7: Player_9f740a82 (big blind) showed [Jh 9c] and won (27468) with a straight, Nine to King
Seat 8: Player_32b7a0e4 mucked
Seat 9: Player_530ddbf7 mucked



PokerStars Hand #3661317943: Tournament #21391319, $20+$2 - Hold'em No Limit (250/500) - 2018/04/06 23:31:56
Table '#18' Seat #6 is the button
Seat 1: Player_38d2f1a5 (12,931 in chips)
Seat 2: Player_449670f6 (9,960 in chips)
Seat 3: Hero (9,625 in chips)
Seat 4: Player_2f582edf (10,290 in chips)
Seat 5: Player_af1ee518 (16,808 in chips)
Seat 6: Player_8c6d2e70 (6,359 in chips)
Seat 7: Player_43e7c44b (28,033 in chips)
Seat 8: Player_f08d0403 (27,732 in chips)
Seat 9: Player_8c124c8f (11,890 in chips)
Player_38d2f1a5: posts the ante 50
Player_449670f6: posts the ante 50
Hero: posts the ante 50
Player_2f582edf: posts the ante 50
Player_af1ee518: posts the ante 50
Player_8c6d2e70: posts the ante 50
Player_43e7c44b: posts the ante 50
Player_f08d0403: posts the ante 50
Player_8c124c8f: posts the ante 50
Player_43e7c44b: posts small blind 250
Player_f08d0403: posts big blind 500
*** HOLE CARDS ***
Dealt to Hero [Ad Ac]
Player_8c124c8f: folds
Player_38d2f1a5: folds
Player_449670f6: folds
Hero: raises 1222 to 1222
Player_2f582edf: folds
Player_af1ee518: folds
Player_8c6d2e70: calls 1222 
Player_43e7c44b: calls 972 
Player_f08d0403: folds
*** FLOP *** [4d 2d 6s]
Player_43e7c44b: checks
Hero: bets 2333 
Player_8c6d2e70: folds
Player_43e7c44b: folds
Uncalled bet (2333) returned to Hero
Hero: doesn't show hand
Hero collected 4616 from pot
*** SUMMARY ***
Total pot 4616 | Rake 0
Board [4d 2d 6s]
Seat 1: Player_38d2f1a5 mucked
Seat 2: Player_449670f6 mucked
Seat 3: Hero won (4616)
Seat 4: Player_2f582edf mucked
Seat 5: Player_af1ee518 mucked
Seat 6: Player_8c6d2e70 (button) mucked
Seat 7: Player_43e7c44b (small blind) mucked
Seat 8: Player_f08d0403 (big blind) mucked
Seat 9: Player_8c124c8f mucked



PokerStars Hand #3661319421: Tournament #21391319, $20+$2 - Hold'em No Limit (250/500) - 2018/04/06 23:34:08
Table '#18' Seat #7 is the button
Seat 1: Player_8508a011 (12,881 in chips)
Seat 2: Player_c5bab8b1 (9,910 in chips)
Seat 3: Hero (12,969 in chips)
Seat 4: Player_de981a3c (10,240 in chips)
Seat 5: Player_1825858c (16,758 in chips)
Seat 6: Player_5029c470 (5,087 in chips)
Seat 7: Player_2e292e9c (26,761 in chips)
Seat 8: Player_d1b85edb (27,182 in chips)
Seat 9: Player_84a2e4a2 (11,840 in chips)
Player_8508a011: posts the ante 50
Player_c5bab8b1: posts the ante 50
Hero: posts the ante 50
Player_de981a3c: posts the ante 50
Player_1825858c: posts the ante 50
Player_5029c470: posts the ante 50
Player_2e292e9c: posts the ante 50
Player_d1b85edb: posts the ante 50
Player_84a2e4a2: posts the ante 50
Player_d1b85edb: posts small blind 250
Player_84a2e4a2: posts big blind 500
*** HOLE CARDS ***
Dealt to Hero [Ad Ts]
Player_8508a011: calls 500 
Player_c5bab8b1: folds
Hero: folds
Player_de981a3c: folds
Player_1825858c: folds
Player_5029c470: raises 1000 to 1000
Player_2e292e9c: folds
Player_d1b85edb: folds
Player_84a2e4a2: raises 2500 to 3000
Player_8508a011: folds
Player_5029c470: calls 2000 
*** FLOP *** [4d Th Kd]
Player_84a2e4a2: bets 7200 
Player_5029c470: bets 2037 and is all-in
*** TURN *** [4d Th Kd] [3s]
*** RIVER *** [4d Th Kd 3s] [7d]
*** SHOW DOWN ***
Player_5029c470: shows [Ks Qs] (a pair of Kings)
Player_84a2e4a2: shows [3d 3c] (three of a kind, Threes)
Uncalled bet (5163) returned to Player_84a2e4a2
Player_84a2e4a2 collected 11274 from pot
Player_5029c470 finished the tournament in 157th place
*** SUMMARY ***
Total pot 11274 | Rake 0
Board [4d Th Kd 3s 7d]
Seat 1: Player_8508a011 mucked
Seat 2: Player_c5bab8b1 mucked
Seat 3: Hero mucked
Seat 4: Player_de981a3c mucked
Seat 5: Player_1825858c mucked
Seat 6: Player_5029c470 showed [Ks Qs] and lost with a pair of Kings
Seat 7: Player_2e292e9c (button) mucked
Seat 8: Player_d1b85edb (small blind) mucked
Seat 9: Player_84a2e4a2 (big blind) showed [3d 3c] and won (11274) with three of a kind, Threes



PokerStars Hand #3661320640: Tournament #21391319, $20+$2 - Hold'em No Limit (250/500) - 2018/04/06 23:36:02
Table '#18' Seat #7 is the button
Seat 1: Player_b9f0e4d8 (12,331 in chips)
Seat 2: Player_481a47d1 (9,860 in chips)
Seat 3: Hero (12,919 in chips)
Seat 4: Player_52b8ffcc (10,190 in chips)
Seat 5: Player_d7698750 (16,708 in chips)
Seat 6: Player_1360c099 (26,711 in chips)
Seat 7: Player_914a3d5e (26,882 in chips)
Seat 8: Player_db300272 (18,027 in chips)
Player_b9f0e4d8: posts the ante 50
Player_481a47d1: posts the ante 50
Hero: posts the ante 50
Player_52b8ffcc: posts the ante 50
Player_d7698750: posts the ante 50
Player_1360c099: posts the ante 50
Player_914a3d5e: posts the ante 50
Player_db300272: posts the ante 50
Player_db300272: posts small blind 250
Player_b9f0e4d8: posts big blind 500
*** HOLE CARDS ***
Dealt to Hero [3d 6d]
Player_481a47d1: folds
Hero: folds
Player_52b8ffcc: folds
Player_d7698750: calls 500 
Player_1360c099: folds
Player_914a3d5e: folds
Player_db300272: folds
Player_b9f0e4d8: checks
*** FLOP *** [Js 8s 8c]
Player_b9f0e4d8: checks
Player_d7698750: checks
*** TURN *** [Js 8s 8c] [Th]
Player_b9f0e4d8: checks
Player_d7698750: bets 1351 
Player_b9f0e4d8: folds
Uncalled bet (1351) returned to Player_d7698750
Player_d7698750: doesn't show hand
Player_d7698750 collected 1650 from pot
*** SUMMARY ***
Total pot 1650 | Rake 0
Board [Js 8s 8c Th]
Seat 1: Player_b9f0e4d8 (big blind) mucked
Seat 2: Player_481a47d1 mucked
Seat 3: Hero mucked
Seat 4: Player_52b8ffcc mucked
Seat 5: Player_d7698750 won (1650)
Seat 6: Player_1360c099 mucked
Seat 7: Player_914a3d5e (button) mucked
Seat 8: Player_db300272 (small blind) mucked



PokerStars Hand #3661321808: Tournament #21391319, $20+$2 - Hold'em No Limit (250/500) - 2018/04/06 23:37:50
Table '#18' Seat #8 is the button
Seat 1: Player_c4371e76 (11,781 in chips)
Seat 2: Player_346731f0 (9,810 in chips)
Seat 3: Hero (12,869 in chips)
Seat 4: Player_14fd7fc0 (10,140 in chips)
Seat 5: Player_107a89f9 (17,808 in chips)
Seat 6: Player_559f07f8 (26,661 in chips)
Seat 7: Player_cf19450c (26,832 in chips)
Seat 8: Player_e7582b00 (17,727 in chips)
Player_c4371e76: posts the ante 50
Player_346731f0: posts the ante 50
Hero: posts the ante 50
Player_14fd7fc0: posts the ante 50
Player_107a89f9: posts the ante 50
Player_559f07f8: posts the ante 50
Player_cf19450c: posts the ante 50
Player_e7582b00: posts the ante 50
Player_c4371e76: posts small blind 250
Player_346731f0: posts big blind 500
*** HOLE CARDS ***
Dealt to Hero [4h 6s]
Hero: folds
Player_14fd7fc0: folds
Player_107a89f9: folds
Player_559f07f8: calls 500 
Player_cf19450c: raises 2650 to 2650
Player_e7582b00: folds
Player_c4371e76: calls 2400 
Player_346731f0: folds
Player_559f07f8: folds
*** FLOP *** [7s 4c 8s]
Player_c4371e76: bets 1200 
Player_cf19450c: raises 10780 to 10780
Player_c4371e76: calls 7881 and is all-in
*** TURN *** [7s 4c 8s] [Qd]
*** RIVER *** [7s 4c 8s Qd] [2d]
*** SHOW DOWN ***
Player_c4371e76: shows [Ks Js] (high card King)
Player_cf19450c: shows [8h Ah] (a pair of Eights)
Uncalled bet (1699) returned to Player_cf19450c
Player_cf19450c collected 24862 from pot
Player_c4371e76 finished the tournament in 155th place
*** SUMMARY ***
Total pot 24862 | Rake 0
Board [7s 4c 8s Qd 2d]
Seat 1: Player_c4371e76 (small blind) showed [Ks Js] and lost with high card King
Seat 2: Player_346731f0 (big blind) mucked
Seat 3: Hero mucked
Seat 4: Player_14fd7fc0 mucked
Seat 5: Player_107a89f9 mucked
Seat 6: Player_559f07f8 mucked
Seat 7: Player_cf19450c showed [8h Ah] and won (24862) with a pair of Eights
Seat 8: Player_e7582b00 (button) mucked



PokerStars Hand #3661322864: Tournament #21391319, $20+$2 - Hold'em No Limit (250/500) - 2018/04/06 23:39:26
Table '#18' Seat #1 is the button
Seat 1: Player_1fe55026 (10,000 in chips)
Seat 2: Player_d9a7bee1 (9,260 in chips)
Seat 3: Hero (12,819 in chips)
Seat 4: Player_82297e0d (10,090 in chips)
Seat 5: Player_6d7ea568 (17,758 in chips)
Seat 6: Player_61eeb09e (26,111 in chips)
Seat 7: Player_b1f5e3f7 (39,913 in chips)
Seat 8: Player_95e43f0a (17,677 in chips)
Player_1fe55026: posts the ante 50
Player_d9a7bee1: posts the ante 50
Hero: posts the ante 50
Player_82297e0d: posts the ante 50
Player_6d7ea568: posts the ante 50
Player_61eeb09e: posts the ante 50
Player_b1f5e3f7: posts the ante 50
Player_95e43f0a: posts the ante 50
Player_d9a7bee1: posts small blind 250
Hero: posts big blind 500
*** HOLE CARDS ***
Dealt to Hero [Qh 6c]
Player_82297e0d: folds
Player_6d7ea568: calls 500 
Player_61eeb09e: folds
Player_b1f5e3f7: folds
Player_95e43f0a: folds
Player_1fe55026: calls 500 
Player_d9a7bee1: raises 8960 to 9210 and is all-in
Hero: folds
Player_6d7ea568: folds
Player_1fe55026: folds
Uncalled bet (8710) returned to Player_d9a7bee1
Player_d9a7bee1: doesn't show hand
Player_d9a7bee1 collected 2400 from pot
*** SUMMARY ***
Total pot 2400 | Rake 0
Seat 1: Player_1fe55026 (button) mucked
Seat 2: Player_d9a7bee1 (small blind) won (2400)
Seat 3: Hero (big blind) mucked
Seat 4: Player_82297e0d mucked
Seat 5: Player_6d7ea568 mucked
Seat 6: Player_61eeb09e mucked
Seat 7: Player_b1f5e3f7 mucked
Seat 8: Player_95e43f0a mucked



PokerStars Hand #3661323928: Tournament #21391319, $20+$2 - Hold'em No Limit (250/500) - 2018/04/06 23:41:05
Table '#18' Seat #2 is the button
Seat 1: Player_80393e29 (9,450 in chips)
Seat 2: Player_8e970565 (11,110 in chips)
Seat 3: Hero (12,269 in chips)
Seat 4: Player_7232da03 (10,040 in chips)
Seat 5: Player_07b5a932 (17,208 in chips)
Seat 6: Player_a59d693a (26,061 in chips)
Seat 7: Player_e7b47215 (39,863 in chips)
Seat 8: Player_abd5e46d (17,627 in chips)
Player_80393e29: posts the ante 50
Player_8e970565: posts the ante 50
Hero: posts the ante 50
Player_7232da03: posts the ante 50
Player_07b5a932: posts the ante 50
Player_a59d693a: posts the ante 50
Player_e7b47215: posts the ante 50
Player_abd5e46d: posts the ante 50
Hero: posts small blind 250
Player_7232da03: posts big blind 500
*** HOLE CARDS ***
Dealt to Hero [2s Qs]
Player_07b5a932: folds
Player_a59d693a: folds
Player_e7b47215: folds
Player_abd5e46d: folds
Player_80393e29: folds
Player_8e970565: bets 11060 and is all-in
Hero: folds
Player_7232da03: folds
Uncalled bet (10560) returned to Player_8e970565
Player_8e970565: doesn't show hand
Player_8e970565 collected 1650 from pot
*** SUMMARY ***
Total pot 1650 | Rake 0
Seat 1: Player_80393e29 mucked
Seat 2: Player_8e970565 (button) won (1650)
Seat 3: Hero (small blind) mucked
Seat 4: Player_7232da03 (big blind) mucked
Seat 5: Player_07b5a932 mucked
Seat 6: Player_a59d693a mucked
Seat 7: Player_e7b47215 mucked
Seat 8: Player_abd5e46d mucked



PokerStars Hand #3661324554: Tournament #21391319, $20+$2 - Hold'em No Limit (300/600) - 2018/04/06 23:42:02
Table '#18' Seat #3 is the button
Seat 1: Player_f8e5de54 (9,400 in chips)
Seat 2: Player_f50b9eaf (12,210 in chips)
Seat 3: Hero (11,969 in chips)
Seat 4: Player_0871273d (9,490 in chips)
Seat 5: Player_c4c741f1 (17,158 in chips)
Seat 6: Player_64176e06 (26,011 in chips)
Seat 7: Player_9120df33 (39,813 in chips)
Seat 8: Player_f5d68951 (17,577 in chips)
Player_f8e5de54: posts the ante 60
Player_f50b9eaf: posts the ante 60
Hero: posts the ante 60
Player_0871273d: posts the ante 60
Player_c4c741f1: posts the ante 60
Player_64176e06: posts the ante 60
Player_9120df33: posts the ante 60
Player_f5d68951: posts the ante 60
Player_0871273d: posts small blind 300
Player_c4c741f1: posts big blind 600
*** HOLE CARDS ***
Dealt to Hero [Js 8h]
Player_64176e06: folds
Player_9120df33: folds
Player_f5d68951: folds
Player_f8e5de54: folds
Player_f50b9eaf: folds
Hero: raises 1500 to 1500
Player_0871273d: folds
Player_c4c741f1: calls 900 
*** FLOP *** [7c Ac 2d]
Player_c4c741f1: checks
Hero: bets 1900 
Player_c4c741f1: raises 9480 to 9480
Hero: folds
Uncalled bet (7580) returned to Player_c4c741f1
Player_c4c741f1: doesn't show hand
Player_c4c741f1 collected 7580 from pot
*** SUMMARY ***
Total pot 7580 | Rake 0
Board [7c Ac 2d]
Seat 1: Player_f8e5de54 mucked
Seat 2: Player_f50b9eaf mucked
Seat 3: Hero (button) mucked
Seat 4: Player_0871273d (small blind) mucked
Seat 5: Player_c4c741f1 (big blind) won (7580)
Seat 6: Player_64176e06 mucked
Seat 7: Player_9120df33 mucked
Seat 8: Player_f5d68951 mucked



PokerStars Hand #3661325232: Tournament #21391319, $20+$2 - Hold'em No Limit (300/600) - 2018/04/06 23:43:05
Table '#18' Seat #4 is the button
Seat 1: Player_69364112 (9,340 in chips)
Seat 2: Player_364be321 (12,150 in chips)
Seat 3: Hero (8,509 in chips)
Seat 4: Player_4fcaeda7 (9,130 in chips)
Seat 5: Player_1e386525 (21,278 in chips)
Seat 6: Player_84993012 (25,951 in chips)
Seat 7: Player_6a176572 (39,753 in chips)
Seat 8: Player_c9311697 (17,517 in chips)
Player_69364112: posts the ante 60
Player_364be321: posts the ante 60
Hero: posts the ante 60
Player_4fcaeda7: posts the ante 60
Player_1e386525: posts the ante 60
Player_84993012: posts the ante 60
Player_6a176572: posts the ante 60
Player_c9311697: posts the ante 60
Player_1e386525: posts small blind 300
Player_84993012: posts big blind 600
*** HOLE CARDS ***
Dealt to Hero [2s Ah]
Player_6a176572: folds
Player_c9311697: folds
Player_69364112: folds
Player_364be321: folds
Hero: folds
Player_4fcaeda7: folds
Player_1e386525: folds
Player_84993012: doesn't show hand
Uncalled bet (600) returned to Player_84993012
Player_84993012 collected 780 from pot
*** SUMMARY ***
Total pot 780 | Rake 0
Seat 1: Player_69364112 mucked
Seat 2: Player_364be321 mucked
Seat 3: Hero mucked
Seat 4: Player_4fcaeda7 (button) mucked
Seat 5: Player_1e386525 (small blind) mucked
Seat 6: Player_84993012 (big blind) won (780)
Seat 7: Player_6a176572 mucked
Seat 8: Player_c9311697 mucked



PokerStars Hand #3661325977: Tournament #21391319, $20+$2 - Hold'em No Limit (300/600) - 2018/04/06 23:44:14
Table '#18' Seat #5 is the button
Seat 1: Player_5ed3eedc (9,280 in chips)
Seat 2: Player_7a260a63 (12,090 in chips)
Seat 3: Hero (8,449 in chips)
Seat 4: Player_36700fa9 (9,070 in chips)
Seat 5: Player_104ebc0f (20,918 in chips)
Seat 6: Player_04aa1c2a (26,671 in chips)
Seat 7: Player_8d987feb (39,693 in chips)
Seat 8: Player_b0d36a16 (17,457 in chips)
Player_5ed3eedc: posts the ante 60
Player_7a260a63: posts the ante 60
Hero: posts the ante 60
Player_36700fa9: posts the ante 60
Player_104ebc0f: posts the ante 60
Player_04aa1c2a: posts the ante 60
Player_8d987feb: posts the ante 60
Player_b0d36a16: posts the ante 60
Player_04aa1c2a: posts small blind 300
Player_8d987feb: posts big blind 600
*** HOLE CARDS ***
Dealt to Hero [6s 9c]
Player_b0d36a16: folds
Player_5ed3eedc: folds
Player_7a260a63: folds
Hero: folds
Player_36700fa9: raises 2580 to 2580
Player_104ebc0f: folds
Player_04aa1c2a: raises 10860 to 11160
Player_8d987feb: folds
Player_36700fa9: calls 6430 and is all-in
*** FLOP *** [Qc 9s Jh]
*** TURN *** [Qc 9s Jh] [8h]
*** RIVER *** [Qc 9s Jh 8h] [7h]
*** SHOW DOWN ***
Player_36700fa9: shows [Jc Jd] (three of a kind, Jacks)
Player_04aa1c2a: shows [Ts As] (a straight, Eight to Queen)
Uncalled bet (2150) returned to Player_04aa1c2a
Player_04aa1c2a collected 19100 from pot
Player_36700fa9 finished the tournament in 148th place
*** SUMMARY ***
Total pot 19100 | Rake 0
Board [Qc 9s Jh 8h 7h]
Seat 1: Player_5ed3eedc mucked
Seat 2: Player_7a260a63 mucked
Seat 3: Hero mucked
Seat 4: Player_36700fa9 showed [Jc Jd] and lost with three of a kind, Jacks
Seat 5: Player_104ebc0f (button) mucked
Seat 6: Player_04aa1c2a (small blind) showed [Ts As] and won (19100) with a straight, Eight to Queen
Seat 7: Player_8d987feb (big blind) mucked
Seat 8: Player_b0d36a16 mucked



PokerStars Hand #3661326713: Tournament #21391319, $20+$2 - Hold'em No Limit (300/600) - 2018/04/06 23:45:23
Table '#18' Seat #5 is the button
Seat 1: Player_c05f25da (9,220 in chips)
Seat 2: Player_b6a60462 (12,030 in chips)
Seat 3: Hero (8,389 in chips)
Seat 4: Player_6d81b908 (20,858 in chips)
Seat 5: Player_3337483d (36,701 in chips)
Seat 6: Player_f9bb28c1 (39,033 in chips)
Seat 7: Player_4bfd9195 (17,397 in chips)
Player_c05f25da: posts the ante 60
Player_b6a60462: posts the ante 60
Hero: posts the ante 60
Player_6d81b908: posts the ante 60
Player_3337483d: posts the ante 60
Player_f9bb28c1: posts the ante 60
Player_4bfd9195: posts the ante 60
Player_f9bb28c1: posts small blind 300
Player_4bfd9195: posts big blind 600
*** HOLE CARDS ***
Dealt to Hero [9h 2c]
Player_c05f25da: folds
Player_b6a60462: folds
Hero: folds
Player_6d81b908: calls 600 
Player_3337483d: folds
Player_f9bb28c1: calls 300 
Player_4bfd9195: checks
*** FLOP *** [Ac 7c 3c]
Player_f9bb28c1: checks
Player_4bfd9195: checks
Player_6d81b908: checks
*** TURN *** [Ac 7c 3c] [Ah]
Player_f9bb28c1: checks
Player_4bfd9195: checks
Player_6d81b908: checks
*** RIVER *** [Ac 7c 3c Ah] [Jd]
Player_f9bb28c1: checks
Player_4bfd9195: checks
Player_6d81b908: checks
*** SHOW DOWN ***
Player_f9bb28c1: shows [6s Ts] (a pair of Aces)
Player_4bfd9195: shows [3s 8c] (two pair, Aces and Threes)
Player_6d81b908: Mucks [5h 6h] (One pair)
Player_4bfd9195 collected 2220 from pot
*** SUMMARY ***
Total pot 2220 | Rake 0
Board [Ac 7c 3c Ah Jd]
Seat 1: Player_c05f25da mucked
Seat 2: Player_b6a60462 mucked
Seat 3: Hero mucked
Seat 4: Player_6d81b908 mucked [5h 6h]
Seat 5: Player_3337483d (button) mucked
Seat 6: Player_f9bb28c1 (small blind) showed [6s Ts] and lost with a pair of Aces
Seat 7: Player_4bfd9195 (big blind) showed [3s 8c] and won (2220) with two pair, Aces and Threes



PokerStars Hand #3661327504: Tournament #21391319, $20+$2 - Hold'em No Limit (300/600) - 2018/04/06 23:46:35
Table '#18' Seat #7 is the button
Seat 1: Player_5c1a71a3 (9,160 in chips)
Seat 2: Player_02d63af6 (11,970 in chips)
Seat 3: Hero (8,329 in chips)
Seat 4: Player_a9afa518 (10,000 in chips)
Seat 5: Player_965141fb (20,198 in chips)
Seat 6: Player_6d6d7344 (36,641 in chips)
Seat 7: Player_2bb02aa3 (38,373 in chips)
Seat 8: Player_09b2c7a4 (18,957 in chips)
Player_5c1a71a3: posts the ante 60
Player_02d63af6: posts the ante 60
Hero: posts the ante 60
Player_a9afa518: posts the ante 60
Player_965141fb: posts the ante 60
Player_6d6d7344: posts the ante 60
Player_2bb02aa3: posts the ante 60
Player_09b2c7a4: posts the ante 60
Player_09b2c7a4: posts small blind 300
Player_5c1a71a3: posts big blind 600
*** HOLE CARDS ***
Dealt to Hero [3s 5s]
Player_02d63af6: folds
Hero: folds
Player_a9afa518: folds
Player_965141fb: folds
Player_6d6d7344: calls 600 
Player_2bb02aa3: raises 3011 to 3011
Player_09b2c7a4: folds
Player_5c1a71a3: folds
Player_6d6d7344: folds
Uncalled bet (2411) returned to Player_2bb02aa3
Player_2bb02aa3: doesn't show hand
Player_2bb02aa3 collected 2580 from pot
*** SUMMARY ***
Total pot 2580 | Rake 0
Seat 1: Player_5c1a71a3 (big blind) mucked
Seat 2: Player_02d63af6 mucked
Seat 3: Hero mucked
Seat 4: Player_a9afa518 mucked
Seat 5: Player_965141fb mucked
Seat 6: Player_6d6d7344 mucked
Seat 7: Player_2bb02aa3 (button) won (2580)
Seat 8: Player_09b2c7a4 (small blind) mucked



PokerStars Hand #3661328383: Tournament #21391319, $20+$2 - Hold'em No Limit (300/600) - 2018/04/06 23:47:59
Table '#18' Seat #9 is the button
Seat 1: Player_17b1e6e2 (8,500 in chips)
Seat 2: Player_e5651d83 (11,910 in chips)
Seat 3: Hero (8,269 in chips)
Seat 4: Player_03d5db4a (9,940 in chips)
Seat 5: Player_5db4d9fa (20,138 in chips)
Seat 6: Player_245dec08 (10,000 in chips)
Seat 7: Player_749cf00e (35,981 in chips)
Seat 8: Player_4c71ff7c (40,293 in chips)
Seat 9: Player_639ffdcd (18,597 in chips)
Player_17b1e6e2: posts the ante 60
Player_e5651d83: posts the ante 60
Hero: posts the ante 60
Player_03d5db4a: posts the ante 60
Player_5db4d9fa: posts the ante 60
Player_245dec08: posts the ante 60
Player_749cf00e: posts the ante 60
Player_4c71ff7c: posts the ante 60
Player_639ffdcd: posts the ante 60
Player_17b1e6e2: posts small blind 300
Player_e5651d83: posts big blind 600
*** HOLE CARDS ***
Dealt to Hero [Qh 9h]
Hero: bets 8209 and is all-in
Player_03d5db4a: folds
Player_5db4d9fa: folds
Player_245dec08: folds
Player_749cf00e: folds
Player_4c71ff7c: calls 8209 
Player_639ffdcd: folds
Player_17b1e6e2: folds
Player_e5651d83: folds
*** FLOP *** [3s 2s Ah]
*** TURN *** [3s 2s Ah] [8s]
*** RIVER *** [3s 2s Ah 8s] [8d]
*** SHOW DOWN ***
Hero: shows [Qh 9h] (a pair of Eights)
Player_4c71ff7c: shows [Ac Ad] (a full house, Aces full of Eights)
Player_4c71ff7c collected 17858 from pot
Hero finished the tournament in 139th place
*** SUMMARY ***
Total pot 17858 | Rake 0
Board [3s 2s Ah 8s 8d]
Seat 1: Player_17b1e6e2 (small blind) mucked
Seat 2: Player_e5651d83 (big blind) mucked
Seat 3: Hero showed [Qh 9h] and lost with a pair of Eights
Seat 4: Player_03d5db4a mucked
Seat 5: Player_5db4d9fa mucked
Seat 6: Player_245dec08 mucked
Seat 7: Player_749cf00e mucked
Seat 8: Player_4c71ff7c showed [Ac Ad] and won (17858) with a full house, Aces full of Eights
Seat 9: Player_639ffdcd (button) mucked




