PokerStars Hand #3661260797: Tournament #21391319, $20+$2 - Hold'em No Limit (30/60) - 2018/04/06 22:06:14
Table '#18' Seat #5 is the button
Seat 1: Player_ecbed538 (10,000 in chips)
Seat 2: Player_159082c0 (9,980 in chips)
Seat 3: Hero (10,000 in chips)
Seat 4: Player_0bdba337 (10,000 in chips)
Seat 5: Player_43d0a217 (10,020 in chips)
Seat 6: Player_eec03df0 (10,029 in chips)
Seat 7: Player_8053668f (14,870 in chips)
Player_eec03df0: posts small blind 30
Player_8053668f: posts big blind 60
*** HOLE CARDS ***
Dealt to Hero [Qd 7h]
Player_ecbed538: folds
Player_159082c0: folds
Hero: folds
Player_0bdba337: folds
Player_43d0a217: folds
Player_eec03df0: raises 150 to 180
Player_8053668f: calls 120 
*** FLOP *** [Ac 4c Qh]
Player_eec03df0: bets 200 
Player_8053668f: calls 200 
*** TURN *** [Ac 4c Qh] [Jh]
Player_eec03df0: bets 400 
Player_8053668f: calls 400 
*** RIVER *** [Ac 4c Qh Jh] [2c]
Player_eec03df0: bets 750 
Player_8053668f: calls 750 
*** SHOW DOWN ***
Player_eec03df0: shows [Ad Jd] (two pair, Aces and Jacks)
Player_8053668f: Mucks [Td Ah] (One pair)
Player_eec03df0 collected 3060 from pot
*** SUMMARY ***
Total pot 3060 | Rake 0
Board [Ac 4c Qh Jh 2c]
Seat 1: Player_ecbed538 mucked
Seat 2: Player_159082c0 mucked
Seat 3: Hero mucked
Seat 4: Player_0bdba337 mucked
Seat 5: Player_43d0a217 (button) mucked
Seat 6: Player_eec03df0 (small blind) showed [Ad Jd] and won (3060) with two pair, Aces and Jacks
Seat 7: Player_8053668f (big blind) mucked [Td Ah]



PokerStars Hand #3661261701: Tournament #21391319, $20+$2 - Hold'em No Limit (30/60) - 2018/04/06 22:07:41
Table '#18' Seat #8 is the button
Seat 1: Player_9b34a8ac (10,000 in chips)
Seat 2: Player_8e763e4b (9,980 in chips)
Seat 3: Hero (10,000 in chips)
Seat 4: Player_59700bbb (10,020 in chips)
Seat 5: Player_112179f3 (10,000 in chips)
Seat 6: Player_29818c6b (10,000 in chips)
Seat 7: Player_7371f84f (11,559 in chips)
Seat 8: Player_6c6a266a (13,340 in chips)
Player_6c6a266a: posts small blind 30
Player_9b34a8ac: posts big blind 60
*** HOLE CARDS ***
Dealt to Hero [5h Th]
Player_8e763e4b: folds
Hero: folds
Player_59700bbb: folds
Player_112179f3: folds
Player_29818c6b: raises 120 to 120
Player_7371f84f: calls 120 
Player_6c6a266a: folds
Player_9b34a8ac: folds
*** FLOP *** [Jh 7h 8c]
Player_29818c6b: bets 60 
Player_7371f84f: calls 60 
*** TURN *** [Jh 7h 8c] [6d]
Player_29818c6b: bets 60 
Player_7371f84f: raises 222 to 222
Player_29818c6b: folds
Uncalled bet (162) returned to Player_7371f84f
Player_7371f84f: doesn't show hand
Player_7371f84f collected 570 from pot
*** SUMMARY ***
Total pot 570 | Rake 0
Board [Jh 7h 8c 6d]
Seat 1: Player_9b34a8ac (big blind) mucked
Seat 2: Player_8e763e4b mucked
Seat 3: Hero mucked
Seat 4: Player_59700bbb mucked
Seat 5: Player_112179f3 mucked
Seat 6: Player_29818c6b mucked
Seat 7: Player_7371f84f (button) won (570)
Seat 8: Player_6c6a266a (small blind) mucked



PokerStars Hand #3661262348: Tournament #21391319, $20+$2 - Hold'em No Limit (30/60) - 2018/04/06 22:08:41
Table '#18' Seat #9 is the button
Seat 1: Player_14898aa9 (9,940 in chips)
Seat 2: Player_d7aedb81 (9,980 in chips)
Seat 3: Hero (10,000 in chips)
Seat 4: Player_a258b452 (10,000 in chips)
Seat 5: Player_e3e8f997 (10,020 in chips)
Seat 6: Player_cb7ba291 (10,000 in chips)
Seat 7: Player_98cc5b72 (9,760 in chips)
Seat 8: Player_f33bf2f0 (11,889 in chips)
Seat 9: Player_03b59fe2 (13,310 in chips)
Player_14898aa9: posts small blind 30
Player_d7aedb81: posts big blind 60
*** HOLE CARDS ***
Dealt to Hero [Ah Qs]
Hero: raises 180 to 180
Player_a258b452: folds
Player_e3e8f997: folds
Player_cb7ba291: folds
Player_98cc5b72: calls 180 
Player_f33bf2f0: folds
Player_03b59fe2: folds
Player_14898aa9: calls 150 
Player_d7aedb81: folds
*** FLOP *** [Qh 8d Jd]
Player_14898aa9: checks
Hero: bets 400 
Player_98cc5b72: folds
Player_14898aa9: folds
Uncalled bet (400) returned to Hero
Hero: doesn't show hand
Hero collected 600 from pot
*** SUMMARY ***
Total pot 600 | Rake 0
Board [Qh 8d Jd]
Seat 1: Player_14898aa9 (small blind) mucked
Seat 2: Player_d7aedb81 (big blind) mucked
Seat 3: Hero won (600)
Seat 4: Player_a258b452 mucked
Seat 5: Player_e3e8f997 mucked
Seat 6: Player_cb7ba291 mucked
Seat 7: Player_98cc5b72 mucked
Seat 8: Player_f33bf2f0 mucked
Seat 9: Player_03b59fe2 (button) mucked



PokerStars Hand #3661263420: Tournament #21391319, $20+$2 - Hold'em No Limit (30/60) - 2018/04/06 22:10:26
Table '#18' Seat #1 is the button
Seat 1: Player_7d104d5f (9,760 in chips)
Seat 2: Player_e44969c3 (9,920 in chips)
Seat 3: Hero (10,420 in chips)
Seat 4: Player_fa484b2b (10,000 in chips)
Seat 5: Player_27a4855c (10,020 in chips)
Seat 6: Player_d3cb9029 (10,000 in chips)
Seat 7: Player_a3373c5b (9,580 in chips)
Seat 8: Player_7e24b5ed (11,889 in chips)
Seat 9: Player_cf6e184f (13,310 in chips)
Player_e44969c3: posts small blind 30
Hero: posts big blind 60
*** HOLE CARDS ***
Dealt to Hero [8d 3h]
Player_fa484b2b: folds
Player_27a4855c: folds
Player_d3cb9029: folds
Player_a3373c5b: calls 60 
Player_7e24b5ed: raises 270 to 270
Player_cf6e184f: calls 270 
Player_7d104d5f: folds
Player_e44969c3: folds
Hero: folds
Player_a3373c5b: calls 210 
*** FLOP *** [2c 8s 9d]
Player_a3373c5b: checks
Player_7e24b5ed: bets 360 
Player_cf6e184f: calls 360 
Player_a3373c5b: folds
*** TURN *** [2c 8s 9d] [7d]
Player_7e24b5ed: bets 890 
Player_cf6e184f: folds
Uncalled bet (890) returned to Player_7e24b5ed
Player_7e24b5ed: doesn't show hand
Player_7e24b5ed collected 1620 from pot
*** SUMMARY ***
Total pot 1620 | Rake 0
Board [2c 8s 9d 7d]
Seat 1: Player_7d104d5f (button) mucked
Seat 2: Player_e44969c3 (small blind) mucked
Seat 3: Hero (big blind) mucked
Seat 4: Player_fa484b2b mucked
Seat 5: Player_27a4855c mucked
Seat 6: Player_d3cb9029 mucked
Seat 7: Player_a3373c5b mucked
Seat 8: Player_7e24b5ed won (1620)
Seat 9: Player_cf6e184f mucked



PokerStars Hand #3661264773: Tournament #21391319, $20+$2 - Hold'em No Limit (30/60) - 2018/04/06 22:12:35
Table '#18' Seat #2 is the button
Seat 1: Player_ec55a775 (9,760 in chips)
Seat 2: Player_68258206 (9,890 in chips)
Seat 3: Hero (10,360 in chips)
Seat 4: Player_de7534b7 (10,000 in chips)
Seat 5: Player_060878f5 (10,020 in chips)
Seat 6: Player_dd7d29ca (10,000 in chips)
Seat 7: Player_0429eeb5 (9,310 in chips)
Seat 8: Player_e72d8222 (12,879 in chips)
Seat 9: Player_e1f25be9 (12,680 in chips)
Hero: posts small blind 30
Player_de7534b7: posts big blind 60
*** HOLE CARDS ***
Dealt to Hero [3d 9c]
Player_060878f5: folds
Player_dd7d29ca: folds
Player_0429eeb5: raises 207 to 207
Player_e72d8222: calls 207 
Player_e1f25be9: folds
Player_ec55a775: folds
Player_68258206: folds
Hero: folds
Player_de7534b7: folds
*** FLOP *** [5h Qd 4c]
Player_0429eeb5: bets 254 
Player_e72d8222: calls 254 
*** TURN *** [5h Qd 4c] [7d]
Player_0429eeb5: bets 509 
Player_e72d8222: calls 509 
*** RIVER *** [5h Qd 4c 7d] [Ks]
Player_0429eeb5: checks
Player_e72d8222: checks
*** SHOW DOWN ***
Player_0429eeb5: shows [Td Ac] (high card Ace)
Player_e72d8222: shows [Qh Jh] (a pair of Queens)
Player_e72d8222 collected 2030 from pot
*** SUMMARY ***
Total pot 2030 | Rake 0
Board [5h Qd 4c 7d Ks]
Seat 1: Player_ec55a775 mucked
Seat 2: Player_68258206 (button) mucked
Seat 3: Hero (small blind) mucked
Seat 4: Player_de7534b7 (big blind) mucked
Seat 5: Player_060878f5 mucked
Seat 6: Player_dd7d29ca mucked
Seat 7: Player_0429eeb5 showed [Td Ac] and lost with high card Ace
Seat 8: Player_e72d8222 showed [Qh Jh] and won (2030) with a pair of Queens
Seat 9: Player_e1f25be9 mucked



PokerStars Hand #3661265930: Tournament #21391319, $20+$2 - Hold'em No Limit (30/60) - 2018/04/06 22:14:23
Table '#18' Seat #3 is the button
Seat 1: Player_772040da (9,760 in chips)
Seat 2: Player_7e6f367c (9,890 in chips)
Seat 3: Hero (10,330 in chips)
Seat 4: Player_fc5f479b (9,940 in chips)
Seat 5: Player_e8d05cd7 (10,020 in chips)
Seat 6: Player_429c16ef (10,000 in chips)
Seat 7: Player_d1eea649 (8,340 in chips)
Seat 8: Player_85d1d9f4 (13,939 in chips)
Seat 9: Player_2f79ad6e (12,680 in chips)
Player_fc5f479b: posts small blind 30
Player_e8d05cd7: posts big blind 60
*** HOLE CARDS ***
Dealt to Hero [6s Ks]
Player_429c16ef: folds
Player_d1eea649: raises 320 to 320
Player_85d1d9f4: raises 818 to 818
Player_2f79ad6e: folds
Player_772040da: calls 818 
Player_7e6f367c: folds
Hero: folds
Player_fc5f479b: folds
Player_e8d05cd7: folds
Player_d1eea649: calls 498 
*** FLOP *** [4c 6h 7h]
Player_d1eea649: bets 60 
Player_85d1d9f4: raises 1418 to 1418
Player_772040da: folds
Player_d1eea649: folds
Uncalled bet (1358) returned to Player_85d1d9f4
Player_85d1d9f4: doesn't show hand
Player_85d1d9f4 collected 2664 from pot
*** SUMMARY ***
Total pot 2664 | Rake 0
Board [4c 6h 7h]
Seat 1: Player_772040da mucked
Seat 2: Player_7e6f367c mucked
Seat 3: Hero (button) mucked
Seat 4: Player_fc5f479b (small blind) mucked
Seat 5: Player_e8d05cd7 (big blind) mucked
Seat 6: Player_429c16ef mucked
Seat 7: Player_d1eea649 mucked
Seat 8: Player_85d1d9f4 won (2664)
Seat 9: Player_2f79ad6e mucked



PokerStars Hand #3661267605: Tournament #21391319, $20+$2 - Hold'em No Limit (40/80) - 2018/04/06 22:16:56
Table '#18' Seat #4 is the button
Seat 1: Player_85ce86df (8,942 in chips)
Seat 2: Player_9d549c8b (9,890 in chips)
Seat 3: Hero (10,330 in chips)
Seat 4: Player_2effacb1 (9,910 in chips)
Seat 5: Player_fc417051 (9,960 in chips)
Seat 6: Player_bc4cc957 (10,000 in chips)
Seat 7: Player_abc127b9 (7,462 in chips)
Seat 8: Player_bae09db1 (15,725 in chips)
Seat 9: Player_35987f50 (12,680 in chips)
Player_fc417051: posts small blind 40
Player_bc4cc957: posts big blind 80
*** HOLE CARDS ***
Dealt to Hero [Ts 4s]
Player_abc127b9: calls 80 
Player_bae09db1: folds
Player_35987f50: calls 80 
Player_85ce86df: folds
Player_9d549c8b: folds
Hero: folds
Player_2effacb1: folds
Player_fc417051: calls 40 
Player_bc4cc957: folds
*** FLOP *** [5c 5d Qh]
Player_fc417051: checks
Player_abc127b9: checks
Player_35987f50: checks
*** TURN *** [5c 5d Qh] [Ac]
Player_fc417051: checks
Player_abc127b9: bets 80 
Player_35987f50: folds
Player_fc417051: folds
Uncalled bet (80) returned to Player_abc127b9
Player_abc127b9: doesn't show hand
Player_abc127b9 collected 320 from pot
*** SUMMARY ***
Total pot 320 | Rake 0
Board [5c 5d Qh Ac]
Seat 1: Player_85ce86df mucked
Seat 2: Player_9d549c8b mucked
Seat 3: Hero mucked
Seat 4: Player_2effacb1 (button) mucked
Seat 5: Player_fc417051 (small blind) mucked
Seat 6: Player_bc4cc957 (big blind) mucked
Seat 7: Player_abc127b9 won (320)
Seat 8: Player_bae09db1 mucked
Seat 9: Player_35987f50 mucked



PokerStars Hand #3661268213: Tournament #21391319, $20+$2 - Hold'em No Limit (40/80) - 2018/04/06 22:17:50
Table '#18' Seat #5 is the button
Seat 1: Player_704065a7 (8,942 in chips)
Seat 2: Player_ac528fd2 (9,890 in chips)
Seat 3: Hero (10,330 in chips)
Seat 4: Player_e6f729f6 (9,910 in chips)
Seat 5: Player_5266ed24 (9,880 in chips)
Seat 6: Player_82c967e9 (9,920 in chips)
Seat 7: Player_d2b10cb1 (7,702 in chips)
Seat 8: Player_41bee7fb (15,725 in chips)
Seat 9: Player_fbba6b69 (12,600 in chips)
Player_82c967e9: posts small blind 40
Player_d2b10cb1: posts big blind 80
*** HOLE CARDS ***
Dealt to Hero [4h Qc]
Player_41bee7fb: folds
Player_fbba6b69: folds
Player_704065a7: calls 80 
Player_ac528fd2: folds
Hero: folds
Player_e6f729f6: folds
Player_5266ed24: calls 80 
Player_82c967e9: folds
Player_d2b10cb1: checks
*** FLOP *** [Ah 6c 7c]
Player_d2b10cb1: bets 359 
Player_704065a7: calls 359 
Player_5266ed24: folds
*** TURN *** [Ah 6c 7c] [Qh]
Player_d2b10cb1: bets 486 
Player_704065a7: raises 1640 to 1640
Player_d2b10cb1: folds
*** SHOW DOWN ***
Player_704065a7: shows [As 7h] (two pair, Aces and Sevens)
Uncalled bet (1154) returned to Player_704065a7
Player_704065a7 collected 1970 from pot
*** SUMMARY ***
Total pot 1970 | Rake 0
Board [Ah 6c 7c Qh]
Seat 1: Player_704065a7 showed [As 7h] and won (1970) with two pair, Aces and Sevens
Seat 2: Player_ac528fd2 mucked
Seat 3: Hero mucked
Seat 4: Player_e6f729f6 mucked
Seat 5: Player_5266ed24 (button) mucked
Seat 6: Player_82c967e9 (small blind) mucked
Seat 7: Player_d2b10cb1 (big blind) mucked
Seat 8: Player_41bee7fb mucked
Seat 9: Player_fbba6b69 mucked



PokerStars Hand #3661268828: Tournament #21391319, $20+$2 - Hold'em No Limit (40/80) - 2018/04/06 22:18:47
Table '#18' Seat #6 is the button
Seat 1: Player_dbb591e4 (9,987 in chips)
Seat 2: Player_9630b2ec (9,890 in chips)
Seat 3: Hero (10,330 in chips)
Seat 4: Player_190313dd (9,910 in chips)
Seat 5: Player_25d6997d (9,800 in chips)
Seat 6: Player_e4344773 (9,880 in chips)
Seat 7: Player_85ecf9f5 (6,777 in chips)
Seat 8: Player_3a618293 (15,725 in chips)
Seat 9: Player_220bdf2f (12,600 in chips)
Player_85ecf9f5: posts small blind 40
Player_3a618293: posts big blind 80
*** HOLE CARDS ***
Dealt to Hero [5d 4c]
Player_220bdf2f: folds
Player_dbb591e4: folds
Player_9630b2ec: folds
Hero: folds
Player_190313dd: raises 280 to 280
Player_25d6997d: folds
Player_e4344773: folds
Player_85ecf9f5: calls 240 
Player_3a618293: raises 1040 to 1120
Player_190313dd: calls 840 
Player_85ecf9f5: calls 840 
*** FLOP *** [As 2c Kh]
Player_85ecf9f5: bets 80 
Player_3a618293: calls 80 
Player_190313dd: calls 80 
*** TURN *** [As 2c Kh] [Jc]
Player_85ecf9f5: bets 478 
Player_3a618293: folds
Player_190313dd: calls 478 
*** RIVER *** [As 2c Kh Jc] [2d]
Player_85ecf9f5: bets 1401 
Player_190313dd: folds
Uncalled bet (1401) returned to Player_85ecf9f5
Player_85ecf9f5: doesn't show hand
Player_85ecf9f5 collected 4556 from pot
*** SUMMARY ***
Total pot 4556 | Rake 0
Board [As 2c Kh Jc 2d]
Seat 1: Player_dbb591e4 mucked
Seat 2: Player_9630b2ec mucked
Seat 3: Hero mucked
Seat 4: Player_190313dd mucked
Seat 5: Player_25d6997d mucked
Seat 6: Player_e4344773 (button) mucked
Seat 7: Player_85ecf9f5 (small blind) won (4556)
Seat 8: Player_3a618293 (big blind) mucked
Seat 9: Player_220bdf2f mucked



PokerStars Hand #3661269645: Tournament #21391319, $20+$2 - Hold'em No Limit (40/80) - 2018/04/06 22:19:59
Table '#18' Seat #7 is the button
Seat 1: Player_46692169 (9,987 in chips)
Seat 2: Player_c88d088f (9,890 in chips)
Seat 3: Hero (10,330 in chips)
Seat 4: Player_e245e868 (8,232 in chips)
Seat 5: Player_900161aa (9,800 in chips)
Seat 6: Player_ad16434d (9,880 in chips)
Seat 7: Player_4e3357a1 (9,655 in chips)
Seat 8: Player_d929634b (14,525 in chips)
Seat 9: Player_276db5d4 (12,600 in chips)
Player_d929634b: posts small blind 40
Player_276db5d4: posts big blind 80
*** HOLE CARDS ***
Dealt to Hero [9c 8c]
Player_46692169: calls 80 
Player_c88d088f: folds
Hero: raises 320 to 320
Player_e245e868: folds
Player_900161aa: folds
Player_ad16434d: folds
Player_4e3357a1: calls 320 
Player_d929634b: folds
Player_276db5d4: folds
Player_46692169: calls 240 
*** FLOP *** [Ts 6s Jd]
Player_46692169: checks
Hero: checks
Player_4e3357a1: checks
*** TURN *** [Ts 6s Jd] [5h]
Player_46692169: checks
Hero: checks
Player_4e3357a1: checks
*** RIVER *** [Ts 6s Jd 5h] [Ks]
Player_46692169: checks
Hero: checks
Player_4e3357a1: checks
*** SHOW DOWN ***
Player_46692169: shows [2s Ac] (high card Ace)
Hero: Mucks [9c 8c] (High Card)
Player_4e3357a1: shows [9h Kh] (a pair of Kings)
Player_4e3357a1 collected 1080 from pot
*** SUMMARY ***
Total pot 1080 | Rake 0
Board [Ts 6s Jd 5h Ks]
Seat 1: Player_46692169 showed [2s Ac] and lost with high card Ace
Seat 2: Player_c88d088f mucked
Seat 3: Hero mucked [9c 8c]
Seat 4: Player_e245e868 mucked
Seat 5: Player_900161aa mucked
Seat 6: Player_ad16434d mucked
Seat 7: Player_4e3357a1 (button) showed [9h Kh] and won (1080) with a pair of Kings
Seat 8: Player_d929634b (small blind) mucked
Seat 9: Player_276db5d4 (big blind) mucked



PokerStars Hand #3661271006: Tournament #21391319, $20+$2 - Hold'em No Limit (40/80) - 2018/04/06 22:22:02
Table '#18' Seat #8 is the button
Seat 1: Player_9e8acc05 (9,667 in chips)
Seat 2: Player_e999ca31 (9,890 in chips)
Seat 3: Hero (10,010 in chips)
Seat 4: Player_c480d6e4 (8,232 in chips)
Seat 5: Player_f935c7c9 (9,800 in chips)
Seat 6: Player_5f1ea7b3 (9,880 in chips)
Seat 7: Player_7122f626 (10,415 in chips)
Seat 8: Player_96efa06b (14,485 in chips)
Seat 9: Player_c7bb7412 (12,520 in chips)
Player_c7bb7412: posts small blind 40
Player_9e8acc05: posts big blind 80
*** HOLE CARDS ***
Dealt to Hero [As 2c]
Player_e999ca31: folds
Hero: folds
Player_c480d6e4: folds
Player_f935c7c9: folds
Player_5f1ea7b3: folds
Player_7122f626: calls 80 
Player_96efa06b: folds
Player_c7bb7412: folds
Player_9e8acc05: checks
*** FLOP *** [Js Th 6d]
Player_9e8acc05: checks
Player_7122f626: checks
*** TURN *** [Js Th 6d] [Ah]
Player_9e8acc05: checks
Player_7122f626: checks
*** RIVER *** [Js Th 6d Ah] [4c]
Player_9e8acc05: checks
Player_7122f626: checks
*** SHOW DOWN ***
Player_9e8acc05: shows [3d 8h] (high card Ace)
Player_7122f626: Mucks [7d 2s] (High Card)
Player_9e8acc05 collected 200 from pot
*** SUMMARY ***
Total pot 200 | Rake 0
Board [Js Th 6d Ah 4c]
Seat 1: Player_9e8acc05 (big blind) showed [3d 8h] and won (200) with high card Ace
Seat 2: Player_e999ca31 mucked
Seat 3: Hero mucked
Seat 4: Player_c480d6e4 mucked
Seat 5: Player_f935c7c9 mucked
Seat 6: Player_5f1ea7b3 mucked
Seat 7: Player_7122f626 mucked [7d 2s]
Seat 8: Player_96efa06b (button) mucked
Seat 9: Player_c7bb7412 (small blind) mucked



PokerStars Hand #3661271715: Tournament #21391319, $20+$2 - Hold'em No Limit (40/80) - 2018/04/06 22:23:05
Table '#18' Seat #9 is the button
Seat 1: Player_d949f96e (9,787 in chips)
Seat 2: Player_0f329b17 (9,890 in chips)
Seat 3: Hero (10,010 in chips)
Seat 4: Player_8866f72c (8,232 in chips)
Seat 5: Player_32b805bd (9,800 in chips)
Seat 6: Player_6ec52bdb (9,880 in chips)
Seat 7: Player_201bb265 (10,335 in chips)
Seat 8: Player_a9eb52b6 (14,485 in chips)
Seat 9: Player_9c8dd5f4 (12,480 in chips)
Player_d949f96e: posts small blind 40
Player_0f329b17: posts big blind 80
*** HOLE CARDS ***
Dealt to Hero [Ts 8s]
Hero: raises 180 to 180
Player_8866f72c: calls 180 
Player_32b805bd: calls 180 
Player_6ec52bdb: folds
Player_201bb265: folds
Player_a9eb52b6: calls 180 
Player_9c8dd5f4: folds
Player_d949f96e: folds
Player_0f329b17: calls 100 
*** FLOP *** [9h Qc 6s]
Player_0f329b17: checks
Hero: bets 500 
Player_8866f72c: raises 1000 to 1000
Player_32b805bd: folds
Player_a9eb52b6: folds
Player_0f329b17: raises 2500 to 2500
Hero: folds
Player_8866f72c: raises 7052 to 8052 and is all-in
Player_0f329b17: calls 5552 
*** TURN *** [9h Qc 6s] [5h]
*** RIVER *** [9h Qc 6s 5h] [Kc]
*** SHOW DOWN ***
Player_0f329b17: shows [9d 6d] (two pair, Nines and Sixes)
Player_8866f72c: shows [Js Jc] (a pair of Jacks)
Player_0f329b17 collected 17544 from pot
Player_8866f72c finished the tournament in 102nd place
*** SUMMARY ***
Total pot 17544 | Rake 0
Board [9h Qc 6s 5h Kc]
Seat 1: Player_d949f96e (small blind) mucked
Seat 2: Player_0f329b17 (big blind) showed [9d 6d] and won (17544) with two pair, Nines and Sixes
Seat 3: Hero mucked
Seat 4: Player_8866f72c showed [Js Jc] and lost with a pair of Jacks
Seat 5: Player_32b805bd mucked
Seat 6: Player_6ec52bdb mucked
Seat 7: Player_201bb265 mucked
Seat 8: Player_a9eb52b6 mucked
Seat 9: Player_9c8dd5f4 (button) mucked



PokerStars Hand #3661273462: Tournament #21391319, $20+$2 - Hold'em No Limit (50/100) - 2018/04/06 22:25:44
Table '#18' Seat #1 is the button
Seat 1: Player_f75b942c (9,747 in chips)
Seat 2: Player_9ac0fcfc (19,202 in chips)
Seat 3: Hero (9,330 in chips)
Seat 4: Player_fe2ac831 (9,620 in chips)
Seat 5: Player_14d6261b (9,880 in chips)
Seat 6: Player_93d63be6 (10,335 in chips)
Seat 7: Player_cb967b73 (14,305 in chips)
Seat 8: Player_3ed335f7 (12,480 in chips)
Player_9ac0fcfc: posts small blind 50
Hero: posts big blind 100
*** HOLE CARDS ***
Dealt to Hero [3d 8c]
Player_fe2ac831: folds
Player_14d6261b: folds
Player_93d63be6: folds
Player_cb967b73: folds
Player_3ed335f7: folds
Player_f75b942c: calls 100 
Player_9ac0fcfc: calls 50 
Hero: checks
*** FLOP *** [Ks Ah Qs]
Player_9ac0fcfc: bets 150 
Hero: folds
Player_f75b942c: calls 150 
*** TURN *** [Ks Ah Qs] [4c]
Player_9ac0fcfc: checks
Player_f75b942c: checks
*** RIVER *** [Ks Ah Qs 4c] [9d]
Player_9ac0fcfc: bets 150 
Player_f75b942c: folds
Uncalled bet (150) returned to Player_9ac0fcfc
Player_9ac0fcfc: doesn't show hand
Player_9ac0fcfc collected 600 from pot
*** SUMMARY ***
Total pot 600 | Rake 0
Board [Ks Ah Qs 4c 9d]
Seat 1: Player_f75b942c (button) mucked
Seat 2: Player_9ac0fcfc (small blind) won (600)
Seat 3: Hero (big blind) mucked
Seat 4: Player_fe2ac831 mucked
Seat 5: Player_14d6261b mucked
Seat 6: Player_93d63be6 mucked
Seat 7: Player_cb967b73 mucked
Seat 8: Player_3ed335f7 mucked



PokerStars Hand #3661274519: Tournament #21391319, $20+$2 - Hold'em No Limit (50/100) - 2018/04/06 22:27:17
Table '#18' Seat #2 is the button
Seat 1: Player_9740775a (9,497 in chips)
Seat 2: Player_3b274a91 (19,552 in chips)
Seat 3: Hero (9,230 in chips)
Seat 4: Player_6064d5c9 (9,620 in chips)
Seat 5: Player_af670486 (9,880 in chips)
Seat 6: Player_5ed78975 (10,335 in chips)
Seat 7: Player_4a2e84d7 (14,305 in chips)
Seat 8: Player_5aa5a9db (12,480 in chips)
Hero: posts small blind 50
Player_6064d5c9: posts big blind 100
*** HOLE CARDS ***
Dealt to Hero [Qs 7c]
Player_af670486: folds
Player_5ed78975: raises 200 to 200
Player_4a2e84d7: folds
Player_5aa5a9db: folds
Player_9740775a: calls 200 
Player_3b274a91: folds
Hero: folds
Player_6064d5c9: calls 100 
*** FLOP *** [4s 5h Ks]
Player_6064d5c9: checks
Player_5ed78975: bets 797 
Player_9740775a: folds
Player_6064d5c9: calls 797 
*** TURN *** [4s 5h Ks] [7d]
Player_6064d5c9: checks
Player_5ed78975: bets 930 
Player_6064d5c9: calls 930 
*** RIVER *** [4s 5h Ks 7d] [Ah]
Player_6064d5c9: checks
Player_5ed78975: checks
*** SHOW DOWN ***
Player_6064d5c9: shows [2h Kh] (a pair of Kings)
Player_5ed78975: shows [Jh Kc] (a pair of Kings)
Player_5ed78975 collected 4104 from pot
*** SUMMARY ***
Total pot 4104 | Rake 0
Board [4s 5h Ks 7d Ah]
Seat 1: Player_9740775a mucked
Seat 2: Player_3b274a91 (button) mucked
Seat 3: Hero (small blind) mucked
Seat 4: Player_6064d5c9 (big blind) showed [2h Kh] and lost with a pair of Kings
Seat 5: Player_af670486 mucked
Seat 6: Player_5ed78975 showed [Jh Kc] and won (4104) with a pair of Kings
Seat 7: Player_4a2e84d7 mucked
Seat 8: Player_5aa5a9db mucked



PokerStars Hand #3661275691: Tournament #21391319, $20+$2 - Hold'em No Limit (50/100) - 2018/04/06 22:29:02
Table '#18' Seat #3 is the button
Seat 1: Player_a2b97985 (9,297 in chips)
Seat 2: Player_acc55d30 (19,552 in chips)
Seat 3: Hero (9,180 in chips)
Seat 4: Player_b995aedc (7,693 in chips)
Seat 5: Player_120a3c7e (9,880 in chips)
Seat 6: Player_850cfa1c (12,512 in chips)
Seat 7: Player_21ae05a6 (14,305 in chips)
Seat 8: Player_ae589fb2 (12,480 in chips)
Player_b995aedc: posts small blind 50
Player_120a3c7e: posts big blind 100
*** HOLE CARDS ***
Dealt to Hero [8s 5d]
Player_850cfa1c: calls 100 
Player_21ae05a6: raises 400 to 400
Player_ae589fb2: folds
Player_a2b97985: calls 400 
Player_acc55d30: folds
Hero: folds
Player_b995aedc: folds
Player_120a3c7e: folds
Player_850cfa1c: calls 300 
*** FLOP *** [9s 2s 6s]
Player_850cfa1c: bets 538 
Player_21ae05a6: folds
Player_a2b97985: calls 538 
*** TURN *** [9s 2s 6s] [7d]
Player_850cfa1c: bets 1143 
Player_a2b97985: calls 1143 
*** RIVER *** [9s 2s 6s 7d] [3h]
Player_850cfa1c: bets 1554 
Player_a2b97985: calls 1554 
*** SHOW DOWN ***
Player_850cfa1c: shows [4h 9h] (a pair of Nines)
Player_a2b97985: shows [Kc 9c] (a pair of Nines)
Player_a2b97985 collected 7820 from pot
*** SUMMARY ***
Total pot 7820 | Rake 0
Board [9s 2s 6s 7d 3h]
Seat 1: Player_a2b97985 showed [Kc 9c] and won (7820) with a pair of Nines
Seat 2: Player_acc55d30 mucked
Seat 3: Hero (button) mucked
Seat 4: Player_b995aedc (small blind) mucked
Seat 5: Player_120a3c7e (big blind) mucked
Seat 6: Player_850cfa1c showed [4h 9h] and lost with a pair of Nines
Seat 7: Player_21ae05a6 mucked
Seat 8: Player_ae589fb2 mucked



PokerStars Hand #3661276545: Tournament #21391319, $20+$2 - Hold'em No Limit (50/100) - 2018/04/06 22:30:20
Table '#18' Seat #5 is the button
Seat 1: Player_ede0577d (13,482 in chips)
Seat 2: Player_e939e594 (19,552 in chips)
Seat 3: Hero (9,180 in chips)
Seat 4: Player_ca65c9cc (7,643 in chips)
Seat 5: Player_cf4832ce (9,780 in chips)
Seat 6: Player_e8fa8333 (8,877 in chips)
Seat 7: Player_ae0bb167 (13,905 in chips)
Seat 8: Player_efb54f77 (12,480 in chips)
Player_cf4832ce: posts small blind 50
Player_e8fa8333: posts big blind 100
*** HOLE CARDS ***
Dealt to Hero [7s 4s]
Player_ae0bb167: folds
Player_efb54f77: folds
Player_ede0577d: folds
Player_e939e594: raises 300 to 300
Hero: folds
Player_ca65c9cc: calls 300 
Player_cf4832ce: folds
Player_e8fa8333: folds
*** FLOP *** [Jc Td 7h]
Player_e939e594: bets 300 
Player_ca65c9cc: calls 300 
*** TURN *** [Jc Td 7h] [As]
Player_e939e594: checks
Player_ca65c9cc: checks
*** RIVER *** [Jc Td 7h As] [Jh]
Player_e939e594: bets 420 
Player_ca65c9cc: calls 420 
*** SHOW DOWN ***
Player_e939e594: shows [Kc Qs] (a straight, Ten to Ace)
Player_ca65c9cc: Mucks [Tc Kh] (Two pair)
Player_e939e594 collected 2190 from pot
*** SUMMARY ***
Total pot 2190 | Rake 0
Board [Jc Td 7h As Jh]
Seat 1: Player_ede0577d mucked
Seat 2: Player_e939e594 showed [Kc Qs] and won (2190) with a straight, Ten to Ace
Seat 3: Hero mucked
Seat 4: Player_ca65c9cc (button) mucked [Tc Kh]
Seat 5: Player_cf4832ce (small blind) mucked
Seat 6: Player_e8fa8333 (big blind) mucked
Seat 7: Player_ae0bb167 mucked
Seat 8: Player_efb54f77 mucked



PokerStars Hand #3661277240: Tournament #21391319, $20+$2 - Hold'em No Limit (50/100) - 2018/04/06 22:31:23
Table '#18' Seat #6 is the button
Seat 1: Player_6533afa4 (13,482 in chips)
Seat 2: Player_0d0ef954 (20,722 in chips)
Seat 3: Hero (9,180 in chips)
Seat 4: Player_bb59effe (6,623 in chips)
Seat 5: Player_4a6db02b (9,730 in chips)
Seat 6: Player_99d8d306 (8,777 in chips)
Seat 7: Player_43afb8d5 (13,905 in chips)
Seat 8: Player_2657c2b6 (12,480 in chips)
Player_99d8d306: posts small blind 50
Player_43afb8d5: posts big blind 100
*** HOLE CARDS ***
Dealt to Hero [8c Ks]
Player_2657c2b6: folds
Player_6533afa4: folds
Player_0d0ef954: folds
Hero: folds
Player_bb59effe: folds
Player_4a6db02b: folds
Player_99d8d306: folds
Player_43afb8d5: doesn't show hand
Uncalled bet (100) returned to Player_43afb8d5
Player_43afb8d5 collected 50 from pot
*** SUMMARY ***
Total pot 50 | Rake 0
Seat 1: Player_6533afa4 mucked
Seat 2: Player_0d0ef954 mucked
Seat 3: Hero mucked
Seat 4: Player_bb59effe mucked
Seat 5: Player_4a6db02b (button) mucked
Seat 6: Player_99d8d306 (small blind) mucked
Seat 7: Player_43afb8d5 (big blind) won (50)
Seat 8: Player_2657c2b6 mucked



PokerStars Hand #3661277747: Tournament #21391319, $20+$2 - Hold'em No Limit (50/100) - 2018/04/06 22:32:11
Table '#18' Seat #7 is the button
Seat 1: Player_0eb6dc6c (13,482 in chips)
Seat 2: Player_ef68e76c (20,722 in chips)
Seat 3: Hero (9,180 in chips)
Seat 4: Player_a902422b (6,623 in chips)
Seat 5: Player_28958495 (9,730 in chips)
Seat 6: Player_1e4f05ce (8,727 in chips)
Seat 7: Player_7a2ae435 (13,955 in chips)
Seat 8: Player_017373bc (12,480 in chips)
Player_7a2ae435: posts small blind 50
Player_017373bc: posts big blind 100
*** HOLE CARDS ***
Dealt to Hero [As Jh]
Player_0eb6dc6c: folds
Player_ef68e76c: folds
Hero: raises 300 to 300
Player_a902422b: folds
Player_28958495: folds
Player_1e4f05ce: folds
Player_7a2ae435: calls 250 
Player_017373bc: folds
*** FLOP *** [5h 5d 7c]
Player_7a2ae435: checks
Hero: checks
*** TURN *** [5h 5d 7c] [6c]
Player_7a2ae435: bets 300 
Hero: calls 300 
*** RIVER *** [5h 5d 7c 6c] [4h]
Player_7a2ae435: bets 1000 
Hero: folds
Uncalled bet (1000) returned to Player_7a2ae435
Player_7a2ae435: doesn't show hand
Player_7a2ae435 collected 1300 from pot
*** SUMMARY ***
Total pot 1300 | Rake 0
Board [5h 5d 7c 6c 4h]
Seat 1: Player_0eb6dc6c mucked
Seat 2: Player_ef68e76c mucked
Seat 3: Hero mucked
Seat 4: Player_a902422b mucked
Seat 5: Player_28958495 mucked
Seat 6: Player_1e4f05ce (button) mucked
Seat 7: Player_7a2ae435 (small blind) won (1300)
Seat 8: Player_017373bc (big blind) mucked



PokerStars Hand #3661278554: Tournament #21391319, $20+$2 - Hold'em No Limit (50/100) - 2018/04/06 22:33:26
Table '#18' Seat #8 is the button
Seat 1: Player_b6b2b245 (13,482 in chips)
Seat 2: Player_95cb2873 (20,722 in chips)
Seat 3: Hero (8,580 in chips)
Seat 4: Player_9c4970e2 (6,623 in chips)
Seat 5: Player_2203def3 (9,730 in chips)
Seat 6: Player_a6b97469 (8,727 in chips)
Seat 7: Player_a49c7b99 (14,655 in chips)
Seat 8: Player_3e7f3ae5 (12,380 in chips)
Player_3e7f3ae5: posts small blind 50
Player_b6b2b245: posts big blind 100
*** HOLE CARDS ***
Dealt to Hero [9d 4s]
Player_95cb2873: folds
Hero: folds
Player_9c4970e2: folds
Player_2203def3: folds
Player_a6b97469: calls 100 
Player_a49c7b99: calls 100 
Player_3e7f3ae5: folds
Player_b6b2b245: folds
*** FLOP *** [9h 5d 9c]
Player_a6b97469: bets 100 
Player_a49c7b99: calls 100 
*** TURN *** [9h 5d 9c] [6h]
Player_a6b97469: bets 100 
Player_a49c7b99: raises 500 to 500
Player_a6b97469: folds
Uncalled bet (400) returned to Player_a49c7b99
Player_a49c7b99: doesn't show hand
Player_a49c7b99 collected 750 from pot
*** SUMMARY ***
Total pot 750 | Rake 0
Board [9h 5d 9c 6h]
Seat 1: Player_b6b2b245 (big blind) mucked
Seat 2: Player_95cb2873 mucked
Seat 3: Hero mucked
Seat 4: Player_9c4970e2 mucked
Seat 5: Player_2203def3 mucked
Seat 6: Player_a6b97469 mucked
Seat 7: Player_a49c7b99 (button) won (750)
Seat 8: Player_3e7f3ae5 (small blind) mucked



PokerStars Hand #3661279293: Tournament #21391319, $20+$2 - Hold'em No Limit (50/100) - 2018/04/06 22:34:32
Table '#18' Seat #9 is the button
Seat 1: Player_2d8d915c (13,382 in chips)
Seat 2: Player_f8d25bdc (20,722 in chips)
Seat 3: Hero (8,580 in chips)
Seat 4: Player_f187ecbe (10,000 in chips)
Seat 5: Player_e65df27c (6,623 in chips)
Seat 6: Player_161a4b76 (9,730 in chips)
Seat 7: Player_128907b2 (8,427 in chips)
Seat 8: Player_b284ffde (15,105 in chips)
Seat 9: Player_389b2c21 (12,330 in chips)
Player_2d8d915c: posts small blind 50
Player_f8d25bdc: posts big blind 100
*** HOLE CARDS ***
Dealt to Hero [6c Ah]
Hero: folds
Player_f187ecbe: folds
Player_e65df27c: raises 300 to 300
Player_161a4b76: folds
Player_128907b2: calls 300 
Player_b284ffde: folds
Player_389b2c21: folds
Player_2d8d915c: folds
Player_f8d25bdc: folds
*** FLOP *** [As Kh Jc]
Player_e65df27c: bets 200 
Player_128907b2: folds
Uncalled bet (200) returned to Player_e65df27c
Player_e65df27c: doesn't show hand
Player_e65df27c collected 750 from pot
*** SUMMARY ***
Total pot 750 | Rake 0
Board [As Kh Jc]
Seat 1: Player_2d8d915c (small blind) mucked
Seat 2: Player_f8d25bdc (big blind) mucked
Seat 3: Hero mucked
Seat 4: Player_f187ecbe mucked
Seat 5: Player_e65df27c won (750)
Seat 6: Player_161a4b76 mucked
Seat 7: Player_128907b2 mucked
Seat 8: Player_b284ffde mucked
Seat 9: Player_389b2c21 (button) mucked



PokerStars Hand #3661280038: Tournament #21391319, $20+$2 - Hold'em No Limit (75/150) - 2018/04/06 22:35:35
Table '#18' Seat #1 is the button
Seat 1: Player_09364242 (13,332 in chips)
Seat 2: Player_44da777d (20,622 in chips)
Seat 3: Hero (8,580 in chips)
Seat 4: Player_23b40c53 (10,000 in chips)
Seat 5: Player_90a43143 (7,073 in chips)
Seat 6: Player_c7e707f6 (9,730 in chips)
Seat 7: Player_4f6cf022 (8,127 in chips)
Seat 8: Player_b7ca3654 (15,105 in chips)
Seat 9: Player_7628b36b (12,330 in chips)
Player_44da777d: posts small blind 75
Hero: posts big blind 150
*** HOLE CARDS ***
Dealt to Hero [Qs 7d]
Player_23b40c53: folds
Player_90a43143: raises 450 to 450
Player_c7e707f6: folds
Player_4f6cf022: folds
Player_b7ca3654: folds
Player_7628b36b: folds
Player_09364242: folds
Player_44da777d: folds
Hero: folds
Uncalled bet (300) returned to Player_90a43143
Player_90a43143: doesn't show hand
Player_90a43143 collected 375 from pot
*** SUMMARY ***
Total pot 375 | Rake 0
Seat 1: Player_09364242 (button) mucked
Seat 2: Player_44da777d (small blind) mucked
Seat 3: Hero (big blind) mucked
Seat 4: Player_23b40c53 mucked
Seat 5: Player_90a43143 won (375)
Seat 6: Player_c7e707f6 mucked
Seat 7: Player_4f6cf022 mucked
Seat 8: Player_b7ca3654 mucked
Seat 9: Player_7628b36b mucked



PokerStars Hand #3661280543: Tournament #21391319, $20+$2 - Hold'em No Limit (75/150) - 2018/04/06 22:36:20
Table '#18' Seat #2 is the button
Seat 1: Player_edc40872 (13,332 in chips)
Seat 2: Player_cf23a8a9 (20,547 in chips)
Seat 3: Hero (8,430 in chips)
Seat 4: Player_929ebcd8 (10,000 in chips)
Seat 5: Player_1176c8dc (7,298 in chips)
Seat 6: Player_2c59e5f3 (9,730 in chips)
Seat 7: Player_a0f351b1 (15,105 in chips)
Seat 8: Player_d4a88eb6 (12,330 in chips)
Hero: posts small blind 75
Player_929ebcd8: posts big blind 150
*** HOLE CARDS ***
Dealt to Hero [Td 8d]
Player_1176c8dc: calls 150 
Player_2c59e5f3: folds
Player_a0f351b1: folds
Player_d4a88eb6: folds
Player_edc40872: folds
Player_cf23a8a9: folds
Hero: calls 75 
Player_929ebcd8: checks
*** FLOP *** [9h 5h Js]
Hero: bets 300 
Player_929ebcd8: calls 300 
Player_1176c8dc: calls 300 
*** TURN *** [9h 5h Js] [Ac]
Hero: bets 1000 
Player_929ebcd8: calls 1000 
Player_1176c8dc: folds
*** RIVER *** [9h 5h Js Ac] [2d]
Hero: bets 3000 
Player_929ebcd8: folds
Uncalled bet (3000) returned to Hero
Hero: doesn't show hand
Hero collected 3350 from pot
*** SUMMARY ***
Total pot 3350 | Rake 0
Board [9h 5h Js Ac 2d]
Seat 1: Player_edc40872 mucked
Seat 2: Player_cf23a8a9 (button) mucked
Seat 3: Hero (small blind) won (3350)
Seat 4: Player_929ebcd8 (big blind) mucked
Seat 5: Player_1176c8dc mucked
Seat 6: Player_2c59e5f3 mucked
Seat 7: Player_a0f351b1 mucked
Seat 8: Player_d4a88eb6 mucked



PokerStars Hand #3661281886: Tournament #21391319, $20+$2 - Hold'em No Limit (75/150) - 2018/04/06 22:38:20
Table '#18' Seat #3 is the button
Seat 1: Player_4c681933 (13,332 in chips)
Seat 2: Player_e570a9e5 (20,547 in chips)
Seat 3: Hero (10,330 in chips)
Seat 4: Player_93282fec (8,550 in chips)
Seat 5: Player_bd17f7de (6,848 in chips)
Seat 6: Player_6d7e4b3d (9,730 in chips)
Seat 7: Player_34cae5d0 (15,105 in chips)
Seat 8: Player_3aecedc7 (12,330 in chips)
Player_93282fec: posts small blind 75
Player_bd17f7de: posts big blind 150
*** HOLE CARDS ***
Dealt to Hero [9h 5s]
Player_6d7e4b3d: folds
Player_34cae5d0: folds
Player_3aecedc7: folds
Player_4c681933: folds
Player_e570a9e5: raises 350 to 350
Hero: folds
Player_93282fec: calls 275 
Player_bd17f7de: folds
*** FLOP *** [8d 2c 5h]
Player_93282fec: checks
Player_e570a9e5: checks
*** TURN *** [8d 2c 5h] [6s]
Player_93282fec: bets 425 
Player_e570a9e5: folds
Uncalled bet (425) returned to Player_93282fec
Player_93282fec: doesn't show hand
Player_93282fec collected 850 from pot
*** SUMMARY ***
Total pot 850 | Rake 0
Board [8d 2c 5h 6s]
Seat 1: Player_4c681933 mucked
Seat 2: Player_e570a9e5 mucked
Seat 3: Hero (button) mucked
Seat 4: Player_93282fec (small blind) won (850)
Seat 5: Player_bd17f7de (big blind) mucked
Seat 6: Player_6d7e4b3d mucked
Seat 7: Player_34cae5d0 mucked
Seat 8: Player_3aecedc7 mucked



PokerStars Hand #3661282910: Tournament #21391319, $20+$2 - Hold'em No Limit (75/150) - 2018/04/06 22:39:50
Table '#18' Seat #4 is the button
Seat 1: Player_fed7af48 (13,332 in chips)
Seat 2: Player_aa85adb1 (20,197 in chips)
Seat 3: Hero (10,330 in chips)
Seat 4: Player_0e61bc4b (9,050 in chips)
Seat 5: Player_854a9bfe (6,698 in chips)
Seat 6: Player_96051eee (9,730 in chips)
Seat 7: Player_6dca8315 (15,105 in chips)
Seat 8: Player_4bd8810f (12,330 in chips)
Player_854a9bfe: posts small blind 75
Player_96051eee: posts big blind 150
*** HOLE CARDS ***
Dealt to Hero [Ah Kd]
Player_6dca8315: folds
Player_4bd8810f: folds
Player_fed7af48: folds
Player_aa85adb1: folds
Hero: raises 400 to 400
Player_0e61bc4b: folds
Player_854a9bfe: folds
Player_96051eee: folds
Uncalled bet (250) returned to Hero
Hero: doesn't show hand
Hero collected 375 from pot
*** SUMMARY ***
Total pot 375 | Rake 0
Seat 1: Player_fed7af48 mucked
Seat 2: Player_aa85adb1 mucked
Seat 3: Hero won (375)
Seat 4: Player_0e61bc4b (button) mucked
Seat 5: Player_854a9bfe (small blind) mucked
Seat 6: Player_96051eee (big blind) mucked
Seat 7: Player_6dca8315 mucked
Seat 8: Player_4bd8810f mucked



PokerStars Hand #3661283352: Tournament #21391319, $20+$2 - Hold'em No Limit (75/150) - 2018/04/06 22:40:29
Table '#18' Seat #5 is the button
Seat 1: Player_9a894cbc (13,332 in chips)
Seat 2: Player_7beec4ac (20,197 in chips)
Seat 3: Hero (10,555 in chips)
Seat 4: Player_28eeceb0 (9,050 in chips)
Seat 5: Player_4e97ade6 (6,623 in chips)
Seat 6: Player_7f0f7ced (9,580 in chips)
Seat 7: Player_335c7f59 (10,000 in chips)
Seat 8: Player_fac0b224 (15,105 in chips)
Seat 9: Player_4e911432 (12,330 in chips)
Player_7f0f7ced: posts small blind 75
Player_335c7f59: posts big blind 150
*** HOLE CARDS ***
Dealt to Hero [Qc 5c]
Player_fac0b224: folds
Player_4e911432: folds
Player_9a894cbc: folds
Player_7beec4ac: folds
Hero: folds
Player_28eeceb0: folds
Player_4e97ade6: raises 450 to 450
Player_7f0f7ced: folds
Player_335c7f59: folds
Uncalled bet (300) returned to Player_4e97ade6
Player_4e97ade6: doesn't show hand
Player_4e97ade6 collected 375 from pot
*** SUMMARY ***
Total pot 375 | Rake 0
Seat 1: Player_9a894cbc mucked
Seat 2: Player_7beec4ac mucked
Seat 3: Hero mucked
Seat 4: Player_28eeceb0 mucked
Seat 5: Player_4e97ade6 (button) won (375)
Seat 6: Player_7f0f7ced (small blind) mucked
Seat 7: Player_335c7f59 (big blind) mucked
Seat 8: Player_fac0b224 mucked
Seat 9: Player_4e911432 mucked



PokerStars Hand #3661283849: Tournament #21391319, $20+$2 - Hold'em No Limit (75/150) - 2018/04/06 22:41:14
Table '#18' Seat #6 is the button
Seat 1: Player_36e8975c (13,332 in chips)
Seat 2: Player_5d08ef9f (20,197 in chips)
Seat 3: Hero (10,555 in chips)
Seat 4: Player_61c9f841 (9,050 in chips)
Seat 5: Player_decd3890 (6,848 in chips)
Seat 6: Player_146c1ce6 (9,505 in chips)
Seat 7: Player_8f1cc799 (9,850 in chips)
Seat 8: Player_9d145127 (15,105 in chips)
Seat 9: Player_76769f64 (12,330 in chips)
Player_8f1cc799: posts small blind 75
Player_9d145127: posts big blind 150
*** HOLE CARDS ***
Dealt to Hero [3c 5h]
Player_76769f64: folds
Player_36e8975c: folds
Player_5d08ef9f: raises 350 to 350
Hero: folds
Player_61c9f841: folds
Player_decd3890: folds
Player_146c1ce6: folds
Player_8f1cc799: folds
Player_9d145127: calls 200 
*** FLOP *** [8d 6h Qc]
Player_9d145127: checks
Player_5d08ef9f: bets 325 
Player_9d145127: calls 325 
*** TURN *** [8d 6h Qc] [Qs]
Player_9d145127: checks
Player_5d08ef9f: bets 600 
Player_9d145127: folds
Uncalled bet (600) returned to Player_5d08ef9f
Player_5d08ef9f: doesn't show hand
Player_5d08ef9f collected 1425 from pot
*** SUMMARY ***
Total pot 1425 | Rake 0
Board [8d 6h Qc Qs]
Seat 1: Player_36e8975c mucked
Seat 2: Player_5d08ef9f won (1425)
Seat 3: Hero mucked
Seat 4: Player_61c9f841 mucked
Seat 5: Player_decd3890 mucked
Seat 6: Player_146c1ce6 (button) mucked
Seat 7: Player_8f1cc799 (small blind) mucked
Seat 8: Player_9d145127 (big blind) mucked
Seat 9: Player_76769f64 mucked



PokerStars Hand #3661284499: Tournament #21391319, $20+$2 - Hold'em No Limit (75/150) - 2018/04/06 22:42:11
Table '#18' Seat #7 is the button
Seat 1: Player_9179c3e3 (13,332 in chips)
Seat 2: Player_95462489 (20,947 in chips)
Seat 3: Hero (10,555 in chips)
Seat 4: Player_057272ea (9,050 in chips)
Seat 5: Player_34fd062e (6,848 in chips)
Seat 6: Player_9f1f2345 (9,505 in chips)
Seat 7: Player_72f63025 (9,775 in chips)
Seat 8: Player_916aa9e4 (14,430 in chips)
Seat 9: Player_866ff49d (12,330 in chips)
Player_916aa9e4: posts small blind 75
Player_866ff49d: posts big blind 150
*** HOLE CARDS ***
Dealt to Hero [2d Ah]
Player_9179c3e3: folds
Player_95462489: folds
Hero: folds
Player_057272ea: folds
Player_34fd062e: folds
Player_9f1f2345: folds
Player_72f63025: folds
Player_916aa9e4: raises 375 to 450
Player_866ff49d: folds
Uncalled bet (300) returned to Player_916aa9e4
Player_916aa9e4: doesn't show hand
Player_916aa9e4 collected 300 from pot
*** SUMMARY ***
Total pot 300 | Rake 0
Seat 1: Player_9179c3e3 mucked
Seat 2: Player_95462489 mucked
Seat 3: Hero mucked
Seat 4: Player_057272ea mucked
Seat 5: Player_34fd062e mucked
Seat 6: Player_9f1f2345 mucked
Seat 7: Player_72f63025 (button) mucked
Seat 8: Player_916aa9e4 (small blind) won (300)
Seat 9: Player_866ff49d (big blind) mucked



PokerStars Hand #3661284950: Tournament #21391319, $20+$2 - Hold'em No Limit (75/150) - 2018/04/06 22:42:53
Table '#18' Seat #8 is the button
Seat 1: Player_1f8749e9 (13,332 in chips)
Seat 2: Player_42bc7e41 (20,947 in chips)
Seat 3: Hero (10,555 in chips)
Seat 4: Player_7b7779b7 (9,050 in chips)
Seat 5: Player_fc90a2a0 (6,848 in chips)
Seat 6: Player_9f3e1855 (9,505 in chips)
Seat 7: Player_e49aa6aa (9,775 in chips)
Seat 8: Player_aff9de65 (14,580 in chips)
Seat 9: Player_f96c59cd (12,180 in chips)
Player_f96c59cd: posts small blind 75
Player_1f8749e9: posts big blind 150
*** HOLE CARDS ***
Dealt to Hero [7s 5d]
Player_42bc7e41: folds
Hero: folds
Player_7b7779b7: folds
Player_fc90a2a0: folds
Player_9f3e1855: raises 300 to 300
Player_e49aa6aa: folds
Player_aff9de65: folds
Player_f96c59cd: folds
Player_1f8749e9: folds
Uncalled bet (150) returned to Player_9f3e1855
Player_9f3e1855: doesn't show hand
Player_9f3e1855 collected 375 from pot
*** SUMMARY ***
Total pot 375 | Rake 0
Seat 1: Player_1f8749e9 (big blind) mucked
Seat 2: Player_42bc7e41 mucked
Seat 3: Hero mucked
Seat 4: Player_7b7779b7 mucked
Seat 5: Player_fc90a2a0 mucked
Seat 6: Player_9f3e1855 won (375)
Seat 7: Player_e49aa6aa mucked
Seat 8: Player_aff9de65 (button) mucked
Seat 9: Player_f96c59cd (small blind) mucked



PokerStars Hand #3661285701: Tournament #21391319, $20+$2 - Hold'em No Limit (75/150) - 2018/04/06 22:43:59
Table '#18' Seat #9 is the button
Seat 1: Player_75611e4c (13,182 in chips)
Seat 2: Player_0742bce0 (20,947 in chips)
Seat 3: Hero (10,555 in chips)
Seat 4: Player_fc7e0ae7 (9,050 in chips)
Seat 5: Player_31d3b6ee (6,848 in chips)
Seat 6: Player_798898f3 (9,730 in chips)
Seat 7: Player_10f401ae (14,580 in chips)
Seat 8: Player_453de07d (12,105 in chips)
Player_75611e4c: posts small blind 75
Player_0742bce0: posts big blind 150
*** HOLE CARDS ***
Dealt to Hero [3c 7d]
Hero: folds
Player_fc7e0ae7: folds
Player_31d3b6ee: folds
Player_798898f3: folds
Player_10f401ae: raises 450 to 450
Player_453de07d: folds
Player_75611e4c: calls 375 
Player_0742bce0: calls 300 
*** FLOP *** [2s 2d 5c]
Player_75611e4c: checks
Player_0742bce0: bets 350 
Player_10f401ae: folds
Player_75611e4c: calls 350 
*** TURN *** [2s 2d 5c] [5s]
Player_75611e4c: bets 500 
Player_0742bce0: calls 500 
*** RIVER *** [2s 2d 5c 5s] [8s]
Player_75611e4c: bets 500 
Player_0742bce0: raises 1750 to 1750
Player_75611e4c: folds
Uncalled bet (1250) returned to Player_0742bce0
Player_0742bce0: doesn't show hand
Player_0742bce0 collected 4050 from pot
*** SUMMARY ***
Total pot 4050 | Rake 0
Board [2s 2d 5c 5s 8s]
Seat 1: Player_75611e4c (small blind) mucked
Seat 2: Player_0742bce0 (big blind) won (4050)
Seat 3: Hero mucked
Seat 4: Player_fc7e0ae7 mucked
Seat 5: Player_31d3b6ee mucked
Seat 6: Player_798898f3 mucked
Seat 7: Player_10f401ae mucked
Seat 8: Player_453de07d (button) mucked



PokerStars Hand #3661290922: Tournament #21391319, $20+$2 - Hold'em No Limit (100/200) - 2018/04/06 22:51:32
Table '#18' Seat #1 is the button
Seat 1: Player_8f48bf10 (11,382 in chips)
Seat 2: Player_81643de0 (23,197 in chips)
Seat 3: Hero (10,555 in chips)
Seat 4: Player_01e3bf3c (9,050 in chips)
Seat 5: Player_3180f4fb (6,848 in chips)
Seat 6: Player_be09a4d6 (9,730 in chips)
Seat 7: Player_3b538994 (10,000 in chips)
Seat 8: Player_639dfa5f (14,130 in chips)
Seat 9: Player_9ca9d6c2 (12,105 in chips)
Player_81643de0: posts small blind 100
Hero: posts big blind 200
*** HOLE CARDS ***
Dealt to Hero [3d 4h]
Player_01e3bf3c: raises 600 to 600
Player_3180f4fb: folds
Player_be09a4d6: folds
Player_3b538994: calls 600 
Player_639dfa5f: folds
Player_9ca9d6c2: folds
Player_8f48bf10: calls 600 
Player_81643de0: folds
Hero: folds
*** FLOP *** [8c 8h Ac]
Player_01e3bf3c: bets 1050 
Player_3b538994: calls 1050 
Player_8f48bf10: folds
*** TURN *** [8c 8h Ac] [As]
Player_01e3bf3c: checks
Player_3b538994: checks
*** RIVER *** [8c 8h Ac As] [3h]
Player_01e3bf3c: bets 3400 
Player_3b538994: raises 8350 to 8350 and is all-in
Player_01e3bf3c: folds
Uncalled bet (4950) returned to Player_3b538994
Player_3b538994: doesn't show hand
Player_3b538994 collected 11000 from pot
*** SUMMARY ***
Total pot 11000 | Rake 0
Board [8c 8h Ac As 3h]
Seat 1: Player_8f48bf10 (button) mucked
Seat 2: Player_81643de0 (small blind) mucked
Seat 3: Hero (big blind) mucked
Seat 4: Player_01e3bf3c mucked
Seat 5: Player_3180f4fb mucked
Seat 6: Player_be09a4d6 mucked
Seat 7: Player_3b538994 won (11000)
Seat 8: Player_639dfa5f mucked
Seat 9: Player_9ca9d6c2 mucked



PokerStars Hand #3661291903: Tournament #21391319, $20+$2 - Hold'em No Limit (100/200) - 2018/04/06 22:52:56
Table '#18' Seat #2 is the button
Seat 1: Player_c265573c (10,782 in chips)
Seat 2: Player_6201c4f9 (23,097 in chips)
Seat 3: Hero (10,355 in chips)
Seat 4: Player_7b5d6c01 (4,000 in chips)
Seat 5: Player_62269c7b (6,848 in chips)
Seat 6: Player_90e6f114 (9,730 in chips)
Seat 7: Player_5d8fe010 (15,950 in chips)
Seat 8: Player_603449ce (14,130 in chips)
Seat 9: Player_c46e5264 (12,105 in chips)
Hero: posts small blind 100
Player_7b5d6c01: posts big blind 200
*** HOLE CARDS ***
Dealt to Hero [7d Ad]
Player_62269c7b: folds
Player_90e6f114: folds
Player_5d8fe010: folds
Player_603449ce: folds
Player_c46e5264: folds
Player_c265573c: calls 200 
Player_6201c4f9: folds
Hero: raises 700 to 800
Player_7b5d6c01: calls 600 
Player_c265573c: calls 600 
*** FLOP *** [3c 6h 7c]
Hero: bets 1500 
Player_7b5d6c01: raises 3200 to 3200 and is all-in
Player_c265573c: folds
Hero: calls 1700 
*** TURN *** [3c 6h 7c] [9c]
*** RIVER *** [3c 6h 7c 9c] [Js]
*** SHOW DOWN ***
Hero: shows [7d Ad] (a pair of Sevens)
Player_7b5d6c01: shows [2d 3d] (a pair of Threes)
Hero collected 8800 from pot
Player_7b5d6c01 finished the tournament in 134th place
*** SUMMARY ***
Total pot 8800 | Rake 0
Board [3c 6h 7c 9c Js]
Seat 1: Player_c265573c mucked
Seat 2: Player_6201c4f9 (button) mucked
Seat 3: Hero (small blind) showed [7d Ad] and won (8800) with a pair of Sevens
Seat 4: Player_7b5d6c01 (big blind) showed [2d 3d] and lost with a pair of Threes
Seat 5: Player_62269c7b mucked
Seat 6: Player_90e6f114 mucked
Seat 7: Player_5d8fe010 mucked
Seat 8: Player_603449ce mucked
Seat 9: Player_c46e5264 mucked



PokerStars Hand #3661292973: Tournament #21391319, $20+$2 - Hold'em No Limit (100/200) - 2018/04/06 22:54:38
Table '#18' Seat #3 is the button
Seat 1: Player_e07c6dd3 (9,982 in chips)
Seat 2: Player_55b70c4d (23,097 in chips)
Seat 3: Hero (15,155 in chips)
Seat 4: Player_57ca4581 (6,848 in chips)
Seat 5: Player_c14d8303 (9,730 in chips)
Seat 6: Player_2943cd77 (15,950 in chips)
Seat 7: Player_d1a9bc3d (14,130 in chips)
Seat 8: Player_7c91a223 (12,105 in chips)
Player_57ca4581: posts big blind 200
*** HOLE CARDS ***
Dealt to Hero [6d Ts]
Player_c14d8303: folds
Player_2943cd77: folds
Player_d1a9bc3d: folds
Player_7c91a223: raises 600 to 600
Player_e07c6dd3: folds
Player_55b70c4d: folds
Hero: folds
Player_57ca4581: calls 400 
*** FLOP *** [9h 8s Qc]
Player_57ca4581: checks
Player_7c91a223: bets 600 
Player_57ca4581: folds
Uncalled bet (600) returned to Player_7c91a223
Player_7c91a223: doesn't show hand
Player_7c91a223 collected 1200 from pot
*** SUMMARY ***
Total pot 1200 | Rake 0
Board [9h 8s Qc]
Seat 1: Player_e07c6dd3 mucked
Seat 2: Player_55b70c4d mucked
Seat 3: Hero (button) mucked
Seat 4: Player_57ca4581 (big blind) mucked
Seat 5: Player_c14d8303 mucked
Seat 6: Player_2943cd77 mucked
Seat 7: Player_d1a9bc3d mucked
Seat 8: Player_7c91a223 won (1200)



PokerStars Hand #3661293586: Tournament #21391319, $20+$2 - Hold'em No Limit (100/200) - 2018/04/06 22:55:35
Table '#18' Seat #4 is the button
Seat 1: Player_21735420 (9,982 in chips)
Seat 2: Player_43183fef (23,097 in chips)
Seat 3: Hero (15,155 in chips)
Seat 4: Player_5bae10a4 (10,000 in chips)
Seat 5: Player_35638f3f (6,248 in chips)
Seat 6: Player_e0e12592 (9,730 in chips)
Seat 7: Player_f852b25b (15,950 in chips)
Seat 8: Player_07b6dc2f (14,130 in chips)
Seat 9: Player_3a433392 (12,705 in chips)
Player_35638f3f: posts small blind 100
Player_e0e12592: posts big blind 200
*** HOLE CARDS ***
Dealt to Hero [As 7s]
Player_f852b25b: calls 200 
Player_07b6dc2f: folds
Player_3a433392: folds
Player_21735420: raises 600 to 600
Player_43183fef: folds
Hero: folds
Player_5bae10a4: calls 600 
Player_35638f3f: folds
Player_e0e12592: folds
Player_f852b25b: calls 400 
*** FLOP *** [5d 8d 5h]
Player_f852b25b: checks
Player_21735420: bets 600 
Player_5bae10a4: folds
Player_f852b25b: folds
*** SHOW DOWN ***
Player_21735420: shows [Ad 7d] (a pair of Fives)
Uncalled bet (600) returned to Player_21735420
Player_21735420 collected 2100 from pot
*** SUMMARY ***
Total pot 2100 | Rake 0
Board [5d 8d 5h]
Seat 1: Player_21735420 showed [Ad 7d] and won (2100) with a pair of Fives
Seat 2: Player_43183fef mucked
Seat 3: Hero mucked
Seat 4: Player_5bae10a4 (button) mucked
Seat 5: Player_35638f3f (small blind) mucked
Seat 6: Player_e0e12592 (big blind) mucked
Seat 7: Player_f852b25b mucked
Seat 8: Player_07b6dc2f mucked
Seat 9: Player_3a433392 mucked



PokerStars Hand #3661294337: Tournament #21391319, $20+$2 - Hold'em No Limit (100/200) - 2018/04/06 22:56:47
Table '#18' Seat #5 is the button
Seat 1: Player_61b9d75a (11,482 in chips)
Seat 2: Player_a761e933 (23,097 in chips)
Seat 3: Hero (15,155 in chips)
Seat 4: Player_b3fc8c3d (9,400 in chips)
Seat 5: Player_99cbd790 (6,148 in chips)
Seat 6: Player_62244ef7 (9,530 in chips)
Seat 7: Player_66c83908 (15,350 in chips)
Seat 8: Player_19a75f9d (14,130 in chips)
Seat 9: Player_81ba4e55 (12,705 in chips)
Player_62244ef7: posts small blind 100
Player_66c83908: posts big blind 200
*** HOLE CARDS ***
Dealt to Hero [Qd Ts]
Player_19a75f9d: folds
Player_81ba4e55: folds
Player_61b9d75a: folds
Player_a761e933: folds
Hero: folds
Player_b3fc8c3d: folds
Player_99cbd790: folds
Player_62244ef7: folds
Player_66c83908: doesn't show hand
Uncalled bet (200) returned to Player_66c83908
Player_66c83908 collected 100 from pot
*** SUMMARY ***
Total pot 100 | Rake 0
Seat 1: Player_61b9d75a mucked
Seat 2: Player_a761e933 mucked
Seat 3: Hero mucked
Seat 4: Player_b3fc8c3d mucked
Seat 5: Player_99cbd790 (button) mucked
Seat 6: Player_62244ef7 (small blind) mucked
Seat 7: Player_66c83908 (big blind) won (100)
Seat 8: Player_19a75f9d mucked
Seat 9: Player_81ba4e55 mucked



PokerStars Hand #3661294653: Tournament #21391319, $20+$2 - Hold'em No Limit (100/200) - 2018/04/06 22:57:17
Table '#18' Seat #6 is the button
Seat 1: Player_8038ce03 (11,482 in chips)
Seat 2: Player_82efce57 (23,097 in chips)
Seat 3: Hero (15,155 in chips)
Seat 4: Player_bfa679fe (9,400 in chips)
Seat 5: Player_9c5d1e6c (6,148 in chips)
Seat 6: Player_78134493 (9,430 in chips)
Seat 7: Player_e7ece9aa (15,450 in chips)
Seat 8: Player_8cc182c0 (14,130 in chips)
Seat 9: Player_77fd694b (12,705 in chips)
Player_e7ece9aa: posts small blind 100
Player_8cc182c0: posts big blind 200
*** HOLE CARDS ***
Dealt to Hero [6c 4d]
Player_77fd694b: folds
Player_8038ce03: folds
Player_82efce57: folds
Hero: folds
Player_bfa679fe: folds
Player_9c5d1e6c: folds
Player_78134493: folds
Player_e7ece9aa: folds
Player_8cc182c0: doesn't show hand
Uncalled bet (200) returned to Player_8cc182c0
Player_8cc182c0 collected 100 from pot
*** SUMMARY ***
Total pot 100 | Rake 0
Seat 1: Player_8038ce03 mucked
Seat 2: Player_82efce57 mucked
Seat 3: Hero mucked
Seat 4: Player_bfa679fe mucked
Seat 5: Player_9c5d1e6c mucked
Seat 6: Player_78134493 (button) mucked
Seat 7: Player_e7ece9aa (small blind) mucked
Seat 8: Player_8cc182c0 (big blind) won (100)
Seat 9: Player_77fd694b mucked



PokerStars Hand #3661295035: Tournament #21391319, $20+$2 - Hold'em No Limit (100/200) - 2018/04/06 22:57:53
Table '#18' Seat #7 is the button
Seat 1: Player_b21e7365 (11,482 in chips)
Seat 2: Player_2f23ead8 (23,097 in chips)
Seat 3: Hero (15,155 in chips)
Seat 4: Player_c5c22346 (9,400 in chips)
Seat 5: Player_bf963a6b (6,148 in chips)
Seat 6: Player_dab0ce43 (9,430 in chips)
Seat 7: Player_01f1aaef (15,350 in chips)
Seat 8: Player_7b631d39 (14,230 in chips)
Seat 9: Player_b8872a0b (12,705 in chips)
Player_7b631d39: posts small blind 100
Player_b8872a0b: posts big blind 200
*** HOLE CARDS ***
Dealt to Hero [Ks 4h]
Player_b21e7365: folds
Player_2f23ead8: folds
Hero: folds
Player_c5c22346: folds
Player_bf963a6b: folds
Player_dab0ce43: folds
Player_01f1aaef: folds
Player_7b631d39: calls 100 
Player_b8872a0b: checks
*** FLOP *** [Ac 7c 6s]
Player_7b631d39: bets 200 
Player_b8872a0b: folds
Uncalled bet (200) returned to Player_7b631d39
Player_7b631d39: doesn't show hand
Player_7b631d39 collected 400 from pot
*** SUMMARY ***
Total pot 400 | Rake 0
Board [Ac 7c 6s]
Seat 1: Player_b21e7365 mucked
Seat 2: Player_2f23ead8 mucked
Seat 3: Hero mucked
Seat 4: Player_c5c22346 mucked
Seat 5: Player_bf963a6b mucked
Seat 6: Player_dab0ce43 mucked
Seat 7: Player_01f1aaef (button) mucked
Seat 8: Player_7b631d39 (small blind) won (400)
Seat 9: Player_b8872a0b (big blind) mucked



PokerStars Hand #3661295390: Tournament #21391319, $20+$2 - Hold'em No Limit (100/200) - 2018/04/06 22:58:26
Table '#18' Seat #8 is the button
Seat 1: Player_c002a055 (11,482 in chips)
Seat 2: Player_f257bfa3 (23,097 in chips)
Seat 3: Hero (15,155 in chips)
Seat 4: Player_d478b3cf (9,400 in chips)
Seat 5: Player_b7cb9aec (6,148 in chips)
Seat 6: Player_54d8848a (9,430 in chips)
Seat 7: Player_d265982b (15,350 in chips)
Seat 8: Player_4b4b8141 (14,430 in chips)
Seat 9: Player_95669c2d (12,505 in chips)
Player_95669c2d: posts small blind 100
Player_c002a055: posts big blind 200
*** HOLE CARDS ***
Dealt to Hero [6h 7c]
Player_f257bfa3: folds
Hero: folds
Player_d478b3cf: raises 700 to 700
Player_b7cb9aec: folds
Player_54d8848a: folds
Player_d265982b: folds
Player_4b4b8141: folds
Player_95669c2d: folds
Player_c002a055: folds
Uncalled bet (500) returned to Player_d478b3cf
Player_d478b3cf: doesn't show hand
Player_d478b3cf collected 500 from pot
*** SUMMARY ***
Total pot 500 | Rake 0
Seat 1: Player_c002a055 (big blind) mucked
Seat 2: Player_f257bfa3 mucked
Seat 3: Hero mucked
Seat 4: Player_d478b3cf won (500)
Seat 5: Player_b7cb9aec mucked
Seat 6: Player_54d8848a mucked
Seat 7: Player_d265982b mucked
Seat 8: Player_4b4b8141 (button) mucked
Seat 9: Player_95669c2d (small blind) mucked



PokerStars Hand #3661295703: Tournament #21391319, $20+$2 - Hold'em No Limit (100/200) - 2018/04/06 22:58:56
Table '#18' Seat #9 is the button
Seat 1: Player_21b82313 (11,282 in chips)
Seat 2: Player_038b0bd1 (23,097 in chips)
Seat 3: Hero (15,155 in chips)
Seat 4: Player_832d5302 (9,700 in chips)
Seat 5: Player_a11bf9c2 (6,148 in chips)
Seat 6: Player_4b089297 (9,430 in chips)
Seat 7: Player_656865b8 (15,350 in chips)
Seat 8: Player_2ae28513 (14,430 in chips)
Seat 9: Player_8af88dd0 (12,405 in chips)
Player_21b82313: posts small blind 100
Player_038b0bd1: posts big blind 200
*** HOLE CARDS ***
Dealt to Hero [4s Jh]
Hero: folds
Player_832d5302: folds
Player_a11bf9c2: raises 600 to 600
Player_4b089297: folds
Player_656865b8: folds
Player_2ae28513: folds
Player_8af88dd0: folds
Player_21b82313: calls 500 
Player_038b0bd1: folds
*** FLOP *** [Tc Kc 3d]
Player_21b82313: checks
Player_a11bf9c2: bets 400 
Player_21b82313: raises 1200 to 1200
Player_a11bf9c2: raises 5148 to 5548 and is all-in
Player_21b82313: calls 4348 
*** TURN *** [Tc Kc 3d] [Qh]
*** RIVER *** [Tc Kc 3d Qh] [6d]
*** SHOW DOWN ***
Player_21b82313: shows [Kd Td] (two pair, Kings and Tens)
Player_a11bf9c2: shows [Th Ad] (a pair of Tens)
Player_21b82313 collected 12496 from pot
Player_a11bf9c2 finished the tournament in 135th place
*** SUMMARY ***
Total pot 12496 | Rake 0
Board [Tc Kc 3d Qh 6d]
Seat 1: Player_21b82313 (small blind) showed [Kd Td] and won (12496) with two pair, Kings and Tens
Seat 2: Player_038b0bd1 (big blind) mucked
Seat 3: Hero mucked
Seat 4: Player_832d5302 mucked
Seat 5: Player_a11bf9c2 showed [Th Ad] and lost with a pair of Tens
Seat 6: Player_4b089297 mucked
Seat 7: Player_656865b8 mucked
Seat 8: Player_2ae28513 mucked
Seat 9: Player_8af88dd0 (button) mucked



PokerStars Hand #3661296440: Tournament #21391319, $20+$2 - Hold'em No Limit (100/200) - 2018/04/06 22:59:56
Table '#18' Seat #1 is the button
Seat 1: Player_99a52ec1 (17,630 in chips)
Seat 2: Player_9c4996c4 (22,897 in chips)
Seat 3: Hero (15,155 in chips)
Seat 4: Player_cac79667 (9,700 in chips)
Seat 5: Player_eaf1c2cc (9,430 in chips)
Seat 6: Player_30655cc1 (15,350 in chips)
Seat 7: Player_4f6a610e (14,430 in chips)
Seat 8: Player_5db3e220 (12,405 in chips)
Player_9c4996c4: posts small blind 100
Hero: posts big blind 200
*** HOLE CARDS ***
Dealt to Hero [9h 5d]
Player_cac79667: folds
Player_eaf1c2cc: folds
Player_30655cc1: folds
Player_4f6a610e: folds
Player_5db3e220: calls 200 
Player_99a52ec1: folds
Player_9c4996c4: folds
Hero: checks
*** FLOP *** [3d 5s Ks]
Hero: checks
Player_5db3e220: checks
*** TURN *** [3d 5s Ks] [Th]
Hero: checks
Player_5db3e220: checks
*** RIVER *** [3d 5s Ks Th] [Ah]
Hero: checks
Player_5db3e220: bets 250 
Hero: folds
Uncalled bet (250) returned to Player_5db3e220
Player_5db3e220: doesn't show hand
Player_5db3e220 collected 500 from pot
*** SUMMARY ***
Total pot 500 | Rake 0
Board [3d 5s Ks Th Ah]
Seat 1: Player_99a52ec1 (button) mucked
Seat 2: Player_9c4996c4 (small blind) mucked
Seat 3: Hero (big blind) mucked
Seat 4: Player_cac79667 mucked
Seat 5: Player_eaf1c2cc mucked
Seat 6: Player_30655cc1 mucked
Seat 7: Player_4f6a610e mucked
Seat 8: Player_5db3e220 won (500)



PokerStars Hand #3661297399: Tournament #21391319, $20+$2 - Hold'em No Limit (100/200) - 2018/04/06 23:01:20
Table '#18' Seat #2 is the button
Seat 1: Player_076bf585 (17,630 in chips)
Seat 2: Player_1242836a (22,797 in chips)
Seat 3: Hero (14,955 in chips)
Seat 4: Player_20c4f882 (9,700 in chips)
Seat 5: Player_a59d83e6 (10,000 in chips)
Seat 6: Player_4522381e (9,430 in chips)
Seat 7: Player_7b105567 (15,350 in chips)
Seat 8: Player_9cc38640 (14,430 in chips)
Seat 9: Player_af05f80b (12,705 in chips)
Hero: posts small blind 100
Player_20c4f882: posts big blind 200
*** HOLE CARDS ***
Dealt to Hero [4s 2s]
Player_a59d83e6: raises 600 to 600
Player_4522381e: folds
Player_7b105567: folds
Player_9cc38640: folds
Player_af05f80b: folds
Player_076bf585: folds
Player_1242836a: folds
Hero: folds
Player_20c4f882: folds
Uncalled bet (400) returned to Player_a59d83e6
Player_a59d83e6: doesn't show hand
Player_a59d83e6 collected 500 from pot
*** SUMMARY ***
Total pot 500 | Rake 0
Seat 1: Player_076bf585 mucked
Seat 2: Player_1242836a (button) mucked
Seat 3: Hero (small blind) mucked
Seat 4: Player_20c4f882 (big blind) mucked
Seat 5: Player_a59d83e6 won (500)
Seat 6: Player_4522381e mucked
Seat 7: Player_7b105567 mucked
Seat 8: Player_9cc38640 mucked
Seat 9: Player_af05f80b mucked



PokerStars Hand #3661298112: Tournament #21391319, $20+$2 - Hold'em No Limit (125/250) - 2018/04/06 23:02:23
Table '#18' Seat #3 is the button
Seat 1: Player_a8029063 (17,630 in chips)
Seat 2: Player_c4041f31 (22,797 in chips)
Seat 3: Hero (14,855 in chips)
Seat 4: Player_82d29815 (9,500 in chips)
Seat 5: Player_c8cb7381 (10,300 in chips)
Seat 6: Player_e6604190 (9,430 in chips)
Seat 7: Player_21c7ec4d (15,350 in chips)
Seat 8: Player_e658c41e (14,430 in chips)
Seat 9: Player_17a0265c (12,705 in chips)
Player_a8029063: posts the ante 25
Player_c4041f31: posts the ante 25
Hero: posts the ante 25
Player_82d29815: posts the ante 25
Player_c8cb7381: posts the ante 25
Player_e6604190: posts the ante 25
Player_21c7ec4d: posts the ante 25
Player_e658c41e: posts the ante 25
Player_17a0265c: posts the ante 25
Player_82d29815: posts small blind 125
Player_c8cb7381: posts big blind 250
*** HOLE CARDS ***
Dealt to Hero [3s Tc]
Player_e6604190: folds
Player_21c7ec4d: folds
Player_e658c41e: folds
Player_17a0265c: folds
Player_a8029063: folds
Player_c4041f31: raises 575 to 575
Hero: folds
Player_82d29815: calls 450 
Player_c8cb7381: calls 325 
*** FLOP *** [6s 8s Ac]
Player_82d29815: checks
Player_c8cb7381: checks
Player_c4041f31: bets 1325 
Player_82d29815: folds
Player_c8cb7381: calls 1325 
*** TURN *** [6s 8s Ac] [4s]
Player_c8cb7381: checks
Player_c4041f31: checks
*** RIVER *** [6s 8s Ac 4s] [Kc]
Player_c8cb7381: bets 2027 
Player_c4041f31: calls 2027 
*** SHOW DOWN ***
Player_c8cb7381: shows [5s 5d] (a pair of Fives)
Player_c4041f31: shows [9h Ad] (a pair of Aces)
Player_c4041f31 collected 8654 from pot
*** SUMMARY ***
Total pot 8654 | Rake 0
Board [6s 8s Ac 4s Kc]
Seat 1: Player_a8029063 mucked
Seat 2: Player_c4041f31 showed [9h Ad] and won (8654) with a pair of Aces
Seat 3: Hero (button) mucked
Seat 4: Player_82d29815 (small blind) mucked
Seat 5: Player_c8cb7381 (big blind) showed [5s 5d] and lost with a pair of Fives
Seat 6: Player_e6604190 mucked
Seat 7: Player_21c7ec4d mucked
Seat 8: Player_e658c41e mucked
Seat 9: Player_17a0265c mucked



PokerStars Hand #3661299338: Tournament #21391319, $20+$2 - Hold'em No Limit (125/250) - 2018/04/06 23:04:11
Table '#18' Seat #4 is the button
Seat 1: Player_d79f09f8 (17,605 in chips)
Seat 2: Hero (14,830 in chips)
Seat 3: Player_59994082 (8,900 in chips)
Seat 4: Player_d6e8fe49 (6,348 in chips)
Seat 5: Player_9ddbccfb (9,405 in chips)
Seat 6: Player_d416c293 (15,325 in chips)
Seat 7: Player_cccdfef8 (14,405 in chips)
Seat 8: Player_6883ee60 (12,680 in chips)
Player_d79f09f8: posts the ante 25
Hero: posts the ante 25
Player_59994082: posts the ante 25
Player_d6e8fe49: posts the ante 25
Player_9ddbccfb: posts the ante 25
Player_d416c293: posts the ante 25
Player_cccdfef8: posts the ante 25
Player_6883ee60: posts the ante 25
Player_d6e8fe49: posts small blind 125
Player_9ddbccfb: posts big blind 250
*** HOLE CARDS ***
Dealt to Hero [4c 8h]
Player_d416c293: folds
Player_cccdfef8: raises 500 to 500
Player_6883ee60: folds
Player_d79f09f8: folds
Hero: folds
Player_59994082: folds
Player_d6e8fe49: folds
Player_9ddbccfb: folds
Uncalled bet (250) returned to Player_cccdfef8
Player_cccdfef8: doesn't show hand
Player_cccdfef8 collected 825 from pot
*** SUMMARY ***
Total pot 825 | Rake 0
Seat 1: Player_d79f09f8 mucked
Seat 2: Hero mucked
Seat 3: Player_59994082 (button) mucked
Seat 4: Player_d6e8fe49 (small blind) mucked
Seat 5: Player_9ddbccfb (big blind) mucked
Seat 6: Player_d416c293 mucked
Seat 7: Player_cccdfef8 won (825)
Seat 8: Player_6883ee60 mucked



PokerStars Hand #3661299816: Tournament #21391319, $20+$2 - Hold'em No Limit (125/250) - 2018/04/06 23:04:53
Table '#18' Seat #5 is the button
Seat 1: Player_7ebde90e (17,580 in chips)
Seat 2: Hero (14,805 in chips)
Seat 3: Player_f6cc9cf7 (8,875 in chips)
Seat 4: Player_6592e195 (6,198 in chips)
Seat 5: Player_18b863a9 (9,130 in chips)
Seat 6: Player_8d09cf90 (15,300 in chips)
Seat 7: Player_24062553 (14,955 in chips)
Seat 8: Player_9cd6e8d3 (12,655 in chips)
Player_7ebde90e: posts the ante 25
Hero: posts the ante 25
Player_f6cc9cf7: posts the ante 25
Player_6592e195: posts the ante 25
Player_18b863a9: posts the ante 25
Player_8d09cf90: posts the ante 25
Player_24062553: posts the ante 25
Player_9cd6e8d3: posts the ante 25
Player_18b863a9: posts small blind 125
Player_8d09cf90: posts big blind 250
*** HOLE CARDS ***
Dealt to Hero [9d 7d]
Player_24062553: folds
Player_9cd6e8d3: folds
Player_7ebde90e: folds
Hero: raises 600 to 600
Player_f6cc9cf7: raises 2375 to 2375
Player_6592e195: folds
Player_18b863a9: folds
Player_8d09cf90: folds
Hero: folds
Uncalled bet (1775) returned to Player_f6cc9cf7
Player_f6cc9cf7: doesn't show hand
Player_f6cc9cf7 collected 1775 from pot
*** SUMMARY ***
Total pot 1775 | Rake 0
Seat 1: Player_7ebde90e mucked
Seat 2: Hero mucked
Seat 3: Player_f6cc9cf7 won (1775)
Seat 4: Player_6592e195 (button) mucked
Seat 5: Player_18b863a9 (small blind) mucked
Seat 6: Player_8d09cf90 (big blind) mucked
Seat 7: Player_24062553 mucked
Seat 8: Player_9cd6e8d3 mucked



PokerStars Hand #3661300682: Tournament #21391319, $20+$2 - Hold'em No Limit (125/250) - 2018/04/06 23:06:08
Table '#18' Seat #6 is the button
Seat 1: Player_217cec8f (17,555 in chips)
Seat 2: Hero (14,180 in chips)
Seat 3: Player_a5757315 (10,025 in chips)
Seat 4: Player_7b2fcb96 (6,173 in chips)
Seat 5: Player_5d2c162e (8,980 in chips)
Seat 6: Player_7bc4e4f2 (15,025 in chips)
Seat 7: Player_a3e6ee1f (14,930 in chips)
Seat 8: Player_6411ae75 (12,630 in chips)
Player_217cec8f: posts the ante 25
Hero: posts the ante 25
Player_a5757315: posts the ante 25
Player_7b2fcb96: posts the ante 25
Player_5d2c162e: posts the ante 25
Player_7bc4e4f2: posts the ante 25
Player_a3e6ee1f: posts the ante 25
Player_6411ae75: posts the ante 25
Player_7bc4e4f2: posts small blind 125
Player_a3e6ee1f: posts big blind 250
*** HOLE CARDS ***
Dealt to Hero [2c Qh]
Player_6411ae75: folds
Player_217cec8f: folds
Hero: folds
Player_a5757315: folds
Player_7b2fcb96: raises 716 to 716
Player_5d2c162e: folds
Player_7bc4e4f2: folds
Player_a3e6ee1f: calls 466 
*** FLOP *** [8h 2h 6s]
Player_a3e6ee1f: bets 1574 
Player_7b2fcb96: raises 5432 to 5432 and is all-in
Player_a3e6ee1f: calls 3858 
*** TURN *** [8h 2h 6s] [9h]
*** RIVER *** [8h 2h 6s 9h] [4d]
*** SHOW DOWN ***
Player_7b2fcb96: shows [Qd Ac] (high card Ace)
Player_a3e6ee1f: shows [9c 7c] (a pair of Nines)
Player_a3e6ee1f collected 12621 from pot
Player_7b2fcb96 finished the tournament in 138th place
*** SUMMARY ***
Total pot 12621 | Rake 0
Board [8h 2h 6s 9h 4d]
Seat 1: Player_217cec8f mucked
Seat 2: Hero mucked
Seat 3: Player_a5757315 mucked
Seat 4: Player_7b2fcb96 showed [Qd Ac] and lost with high card Ace
Seat 5: Player_5d2c162e (button) mucked
Seat 6: Player_7bc4e4f2 (small blind) mucked
Seat 7: Player_a3e6ee1f (big blind) showed [9c 7c] and won (12621) with a pair of Nines
Seat 8: Player_6411ae75 mucked



PokerStars Hand #3661301471: Tournament #21391319, $20+$2 - Hold'em No Limit (125/250) - 2018/04/06 23:07:20
Table '#18' Seat #7 is the button
Seat 1: Player_814f733c (17,530 in chips)
Seat 2: Player_7a710c17 (10,000 in chips)
Seat 3: Hero (14,155 in chips)
Seat 4: Player_dc21248e (10,000 in chips)
Seat 5: Player_0c8843fe (8,955 in chips)
Seat 6: Player_4a0d6aaf (14,875 in chips)
Seat 7: Player_35575055 (21,378 in chips)
Seat 8: Player_a1b08930 (12,605 in chips)
Player_814f733c: posts the ante 25
Player_7a710c17: posts the ante 25
Hero: posts the ante 25
Player_dc21248e: posts the ante 25
Player_0c8843fe: posts the ante 25
Player_4a0d6aaf: posts the ante 25
Player_35575055: posts the ante 25
Player_a1b08930: posts the ante 25
Player_35575055: posts small blind 125
Player_a1b08930: posts big blind 250
*** HOLE CARDS ***
Dealt to Hero [Js Kc]
Player_814f733c: calls 250 
Player_7a710c17: folds
Hero: folds
Player_dc21248e: folds
Player_0c8843fe: folds
Player_4a0d6aaf: folds
Player_35575055: folds
Player_a1b08930: checks
*** FLOP *** [4c 7c Kh]
Player_a1b08930: checks
Player_814f733c: checks
*** TURN *** [4c 7c Kh] [Qd]
Player_a1b08930: checks
Player_814f733c: bets 450 
Player_a1b08930: folds
Uncalled bet (450) returned to Player_814f733c
Player_814f733c: doesn't show hand
Player_814f733c collected 825 from pot
*** SUMMARY ***
Total pot 825 | Rake 0
Board [4c 7c Kh Qd]
Seat 1: Player_814f733c won (825)
Seat 2: Player_7a710c17 mucked
Seat 3: Hero mucked
Seat 4: Player_dc21248e mucked
Seat 5: Player_0c8843fe mucked
Seat 6: Player_4a0d6aaf (button) mucked
Seat 7: Player_35575055 (small blind) mucked
Seat 8: Player_a1b08930 (big blind) mucked



PokerStars Hand #3661302332: Tournament #21391319, $20+$2 - Hold'em No Limit (125/250) - 2018/04/06 23:08:38
Table '#18' Seat #8 is the button
Seat 1: Player_5c92cbcd (18,080 in chips)
Seat 2: Player_44ee9f9e (9,975 in chips)
Seat 3: Hero (14,130 in chips)
Seat 4: Player_fcedce68 (9,975 in chips)
Seat 5: Player_8e17f2c4 (10,000 in chips)
Seat 6: Player_e98beb4c (8,930 in chips)
Seat 7: Player_4e6e238a (14,850 in chips)
Seat 8: Player_67a8e96e (21,228 in chips)
Seat 9: Player_306bd526 (12,330 in chips)
Player_5c92cbcd: posts the ante 25
Player_44ee9f9e: posts the ante 25
Hero: posts the ante 25
Player_fcedce68: posts the ante 25
Player_8e17f2c4: posts the ante 25
Player_e98beb4c: posts the ante 25
Player_4e6e238a: posts the ante 25
Player_67a8e96e: posts the ante 25
Player_306bd526: posts the ante 25
Player_306bd526: posts small blind 125
Player_5c92cbcd: posts big blind 250
*** HOLE CARDS ***
Dealt to Hero [Ac 8d]
Player_44ee9f9e: folds
Hero: folds
Player_fcedce68: folds
Player_8e17f2c4: folds
Player_e98beb4c: raises 750 to 750
Player_4e6e238a: calls 750 
Player_67a8e96e: folds
Player_306bd526: folds
Player_5c92cbcd: calls 500 
*** FLOP *** [2d Jc 6c]
Player_5c92cbcd: checks
Player_e98beb4c: checks
Player_4e6e238a: checks
*** TURN *** [2d Jc 6c] [Td]
Player_5c92cbcd: checks
Player_e98beb4c: checks
Player_4e6e238a: bets 3607 
Player_5c92cbcd: folds
Player_e98beb4c: folds
Uncalled bet (3607) returned to Player_4e6e238a
Player_4e6e238a: doesn't show hand
Player_4e6e238a collected 2600 from pot
*** SUMMARY ***
Total pot 2600 | Rake 0
Board [2d Jc 6c Td]
Seat 1: Player_5c92cbcd (big blind) mucked
Seat 2: Player_44ee9f9e mucked
Seat 3: Hero mucked
Seat 4: Player_fcedce68 mucked
Seat 5: Player_8e17f2c4 mucked
Seat 6: Player_e98beb4c mucked
Seat 7: Player_4e6e238a won (2600)
Seat 8: Player_67a8e96e (button) mucked
Seat 9: Player_306bd526 (small blind) mucked



PokerStars Hand #3661303270: Tournament #21391319, $20+$2 - Hold'em No Limit (125/250) - 2018/04/06 23:09:59
Table '#18' Seat #9 is the button
Seat 1: Player_b041f881 (17,305 in chips)
Seat 2: Player_d76117d5 (9,950 in chips)
Seat 3: Hero (14,105 in chips)
Seat 4: Player_e0ffd57e (9,950 in chips)
Seat 5: Player_93460ba4 (9,975 in chips)
Seat 6: Player_03e34a24 (8,155 in chips)
Seat 7: Player_1de11aef (16,675 in chips)
Seat 8: Player_525abd33 (21,203 in chips)
Seat 9: Player_fdfc5c5d (12,180 in chips)
Player_b041f881: posts the ante 25
Player_d76117d5: posts the ante 25
Hero: posts the ante 25
Player_e0ffd57e: posts the ante 25
Player_93460ba4: posts the ante 25
Player_03e34a24: posts the ante 25
Player_1de11aef: posts the ante 25
Player_525abd33: posts the ante 25
Player_fdfc5c5d: posts the ante 25
Player_b041f881: posts small blind 125
Player_d76117d5: posts big blind 250
*** HOLE CARDS ***
Dealt to Hero [Jd 9d]
Hero: raises 600 to 600
Player_e0ffd57e: raises 2400 to 2400
Player_93460ba4: folds
Player_03e34a24: folds
Player_1de11aef: folds
Player_525abd33: folds
Player_fdfc5c5d: folds
Player_b041f881: folds
Player_d76117d5: folds
Hero: folds
Uncalled bet (1800) returned to Player_e0ffd57e
Player_e0ffd57e: doesn't show hand
Player_e0ffd57e collected 1800 from pot
*** SUMMARY ***
Total pot 1800 | Rake 0
Seat 1: Player_b041f881 (small blind) mucked
Seat 2: Player_d76117d5 (big blind) mucked
Seat 3: Hero mucked
Seat 4: Player_e0ffd57e won (1800)
Seat 5: Player_93460ba4 mucked
Seat 6: Player_03e34a24 mucked
Seat 7: Player_1de11aef mucked
Seat 8: Player_525abd33 mucked
Seat 9: Player_fdfc5c5d (button) mucked



PokerStars Hand #3661304019: Tournament #21391319, $20+$2 - Hold'em No Limit (125/250) - 2018/04/06 23:11:08
Table '#18' Seat #1 is the button
Seat 1: Player_b7bb2144 (17,155 in chips)
Seat 2: Player_239bfbee (9,675 in chips)
Seat 3: Hero (13,480 in chips)
Seat 4: Player_9e438a78 (11,125 in chips)
Seat 5: Player_93f1eeac (9,950 in chips)
Seat 6: Player_59686950 (8,130 in chips)
Seat 7: Player_67681e83 (16,650 in chips)
Seat 8: Player_60b36dc7 (21,178 in chips)
Seat 9: Player_393759f1 (12,155 in chips)
Player_b7bb2144: posts the ante 25
Player_239bfbee: posts the ante 25
Hero: posts the ante 25
Player_9e438a78: posts the ante 25
Player_93f1eeac: posts the ante 25
Player_59686950: posts the ante 25
Player_67681e83: posts the ante 25
Player_60b36dc7: posts the ante 25
Player_393759f1: posts the ante 25
Player_239bfbee: posts small blind 125
Hero: posts big blind 250
*** HOLE CARDS ***
Dealt to Hero [2d 9c]
Player_9e438a78: folds
Player_93f1eeac: folds
Player_59686950: folds
Player_67681e83: folds
Player_60b36dc7: folds
Player_393759f1: folds
Player_b7bb2144: calls 250 
Player_239bfbee: folds
Hero: checks
*** FLOP *** [4d Ts 8c]
Hero: checks
Player_b7bb2144: checks
*** TURN *** [4d Ts 8c] [2s]
Hero: checks
Player_b7bb2144: checks
*** RIVER *** [4d Ts 8c 2s] [3h]
Hero: checks
Player_b7bb2144: checks
*** SHOW DOWN ***
Hero: shows [2d 9c] (a pair of Deuces)
Player_b7bb2144: Mucks [Kc 9d] (High Card)
Hero collected 850 from pot
*** SUMMARY ***
Total pot 850 | Rake 0
Board [4d Ts 8c 2s 3h]
Seat 1: Player_b7bb2144 (button) mucked [Kc 9d]
Seat 2: Player_239bfbee (small blind) mucked
Seat 3: Hero (big blind) showed [2d 9c] and won (850) with a pair of Deuces
Seat 4: Player_9e438a78 mucked
Seat 5: Player_93f1eeac mucked
Seat 6: Player_59686950 mucked
Seat 7: Player_67681e83 mucked
Seat 8: Player_60b36dc7 mucked
Seat 9: Player_393759f1 mucked



PokerStars Hand #3661305229: Tournament #21391319, $20+$2 - Hold'em No Limit (150/300) - 2018/04/06 23:12:59
Table '#18' Seat #2 is the button
Seat 1: Player_4f889391 (16,880 in chips)
Seat 2: Player_335f8212 (9,525 in chips)
Seat 3: Hero (14,055 in chips)
Seat 4: Player_2b980d71 (11,100 in chips)
Seat 5: Player_7680b8c6 (9,925 in chips)
Seat 6: Player_5a66d68f (8,105 in chips)
Seat 7: Player_46e58eb1 (16,625 in chips)
Seat 8: Player_a7d3386d (21,153 in chips)
Seat 9: Player_7a6d649e (12,130 in chips)
Player_4f889391: posts the ante 30
Player_335f8212: posts the ante 30
Hero: posts the ante 30
Player_2b980d71: posts the ante 30
Player_7680b8c6: posts the ante 30
Player_5a66d68f: posts the ante 30
Player_46e58eb1: posts the ante 30
Player_a7d3386d: posts the ante 30
Player_7a6d649e: posts the ante 30
Hero: posts small blind 150
Player_2b980d71: posts big blind 300
*** HOLE CARDS ***
Dealt to Hero [4c 2s]
Player_7680b8c6: folds
Player_5a66d68f: folds
Player_46e58eb1: folds
Player_a7d3386d: folds
Player_7a6d649e: folds
Player_4f889391: folds
Player_335f8212: folds
Hero: folds
Player_2b980d71: doesn't show hand
Uncalled bet (300) returned to Player_2b980d71
Player_2b980d71 collected 420 from pot
*** SUMMARY ***
Total pot 420 | Rake 0
Seat 1: Player_4f889391 mucked
Seat 2: Player_335f8212 (button) mucked
Seat 3: Hero (small blind) mucked
Seat 4: Player_2b980d71 (big blind) won (420)
Seat 5: Player_7680b8c6 mucked
Seat 6: Player_5a66d68f mucked
Seat 7: Player_46e58eb1 mucked
Seat 8: Player_a7d3386d mucked
Seat 9: Player_7a6d649e mucked



PokerStars Hand #3661305779: Tournament #21391319, $20+$2 - Hold'em No Limit (150/300) - 2018/04/06 23:13:50
Table '#18' Seat #3 is the button
Seat 1: Player_30fd8c43 (16,850 in chips)
Seat 2: Player_a09983ed (9,495 in chips)
Seat 3: Hero (13,875 in chips)
Seat 4: Player_94a136b7 (11,490 in chips)
Seat 5: Player_fe08d0a7 (9,895 in chips)
Seat 6: Player_3a4afb94 (8,075 in chips)
Seat 7: Player_86195a9a (21,123 in chips)
Seat 8: Player_a968a0cf (12,100 in chips)
Player_30fd8c43: posts the ante 30
Player_a09983ed: posts the ante 30
Hero: posts the ante 30
Player_94a136b7: posts the ante 30
Player_fe08d0a7: posts the ante 30
Player_3a4afb94: posts the ante 30
Player_86195a9a: posts the ante 30
Player_a968a0cf: posts the ante 30
Player_94a136b7: posts small blind 150
Player_fe08d0a7: posts big blind 300
*** HOLE CARDS ***
Dealt to Hero [6s 7d]
Player_3a4afb94: folds
Player_86195a9a: folds
Player_a968a0cf: folds
Player_30fd8c43: calls 300 
Player_a09983ed: folds
Hero: folds
Player_94a136b7: calls 150 
Player_fe08d0a7: checks
*** FLOP *** [4h Qh Qs]
Player_94a136b7: checks
Player_fe08d0a7: checks
Player_30fd8c43: checks
*** TURN *** [4h Qh Qs] [4d]
Player_94a136b7: checks
Player_fe08d0a7: checks
Player_30fd8c43: checks
*** RIVER *** [4h Qh Qs 4d] [3c]
Player_94a136b7: checks
Player_fe08d0a7: checks
Player_30fd8c43: checks
*** SHOW DOWN ***
Player_94a136b7: shows [9h Kd] (two pair, Queens and Fours)
Player_fe08d0a7: Mucks [2s 7h] (Two pair)
Player_30fd8c43: shows [7c Ad] (two pair, Queens and Fours)
Player_30fd8c43 collected 1140 from pot
*** SUMMARY ***
Total pot 1140 | Rake 0
Board [4h Qh Qs 4d 3c]
Seat 1: Player_30fd8c43 showed [7c Ad] and won (1140) with two pair, Queens and Fours
Seat 2: Player_a09983ed mucked
Seat 3: Hero (button) mucked
Seat 4: Player_94a136b7 (small blind) showed [9h Kd] and lost with two pair, Queens and Fours
Seat 5: Player_fe08d0a7 (big blind) mucked [2s 7h]
Seat 6: Player_3a4afb94 mucked
Seat 7: Player_86195a9a mucked
Seat 8: Player_a968a0cf mucked



PokerStars Hand #3661307417: Tournament #21391319, $20+$2 - Hold'em No Limit (150/300) - 2018/04/06 23:16:14
Table '#18' Seat #4 is the button
Seat 1: Player_4bc7e342 (17,660 in chips)
Seat 2: Player_08645795 (9,465 in chips)
Seat 3: Hero (13,845 in chips)
Seat 4: Player_6c6c0247 (11,160 in chips)
Seat 5: Player_62443d67 (9,565 in chips)
Seat 6: Player_7958d1a7 (8,045 in chips)
Seat 7: Player_d9d2288d (10,000 in chips)
Seat 8: Player_05eb4a72 (21,093 in chips)
Seat 9: Player_403fe431 (12,070 in chips)
Player_4bc7e342: posts the ante 30
Player_08645795: posts the ante 30
Hero: posts the ante 30
Player_6c6c0247: posts the ante 30
Player_62443d67: posts the ante 30
Player_7958d1a7: posts the ante 30
Player_d9d2288d: posts the ante 30
Player_05eb4a72: posts the ante 30
Player_403fe431: posts the ante 30
Player_62443d67: posts small blind 150
Player_7958d1a7: posts big blind 300
*** HOLE CARDS ***
Dealt to Hero [Ah 4h]
Player_d9d2288d: folds
Player_05eb4a72: folds
Player_403fe431: folds
Player_4bc7e342: folds
Player_08645795: raises 900 to 900
Hero: folds
Player_6c6c0247: folds
Player_62443d67: folds
Player_7958d1a7: folds
Uncalled bet (600) returned to Player_08645795
Player_08645795: doesn't show hand
Player_08645795 collected 1020 from pot
*** SUMMARY ***
Total pot 1020 | Rake 0
Seat 1: Player_4bc7e342 mucked
Seat 2: Player_08645795 won (1020)
Seat 3: Hero mucked
Seat 4: Player_6c6c0247 (button) mucked
Seat 5: Player_62443d67 (small blind) mucked
Seat 6: Player_7958d1a7 (big blind) mucked
Seat 7: Player_d9d2288d mucked
Seat 8: Player_05eb4a72 mucked
Seat 9: Player_403fe431 mucked



PokerStars Hand #3661308142: Tournament #21391319, $20+$2 - Hold'em No Limit (150/300) - 2018/04/06 23:17:17
Table '#18' Seat #5 is the button
Seat 1: Player_b9e63ac2 (17,630 in chips)
Seat 2: Player_31beed4c (10,155 in chips)
Seat 3: Hero (13,815 in chips)
Seat 4: Player_d1ee03c7 (11,130 in chips)
Seat 5: Player_191a017e (9,385 in chips)
Seat 6: Player_deb39423 (7,715 in chips)
Seat 7: Player_08966166 (9,970 in chips)
Seat 8: Player_9146cf61 (21,063 in chips)
Seat 9: Player_b569aea3 (12,040 in chips)
Player_b9e63ac2: posts the ante 30
Player_31beed4c: posts the ante 30
Hero: posts the ante 30
Player_d1ee03c7: posts the ante 30
Player_191a017e: posts the ante 30
Player_deb39423: posts the ante 30
Player_08966166: posts the ante 30
Player_9146cf61: posts the ante 30
Player_b569aea3: posts the ante 30
Player_deb39423: posts small blind 150
Player_08966166: posts big blind 300
*** HOLE CARDS ***
Dealt to Hero [Kh 8s]
Player_9146cf61: folds
Player_b569aea3: folds
Player_b9e63ac2: folds
Player_31beed4c: folds
Hero: folds
Player_d1ee03c7: raises 1320 to 1320
Player_191a017e: folds
Player_deb39423: folds
Player_08966166: folds
Uncalled bet (1020) returned to Player_d1ee03c7
Player_d1ee03c7: doesn't show hand
Player_d1ee03c7 collected 1020 from pot
*** SUMMARY ***
Total pot 1020 | Rake 0
Seat 1: Player_b9e63ac2 mucked
Seat 2: Player_31beed4c mucked
Seat 3: Hero mucked
Seat 4: Player_d1ee03c7 won (1020)
Seat 5: Player_191a017e (button) mucked
Seat 6: Player_deb39423 (small blind) mucked
Seat 7: Player_08966166 (big blind) mucked
Seat 8: Player_9146cf61 mucked
Seat 9: Player_b569aea3 mucked



PokerStars Hand #3661308758: Tournament #21391319, $20+$2 - Hold'em No Limit (150/300) - 2018/04/06 23:18:11
Table '#18' Seat #6 is the button
Seat 1: Player_c23cf83a (17,600 in chips)
Seat 2: Player_12f7d499 (10,125 in chips)
Seat 3: Hero (13,785 in chips)
Seat 4: Player_8ee7a8ff (11,820 in chips)
Seat 5: Player_fcd0f8d3 (9,355 in chips)
Seat 6: Player_1ff99c9b (7,535 in chips)
Seat 7: Player_9a8e8436 (9,640 in chips)
Seat 8: Player_d1b29ab0 (21,033 in chips)
Seat 9: Player_1faec1db (12,010 in chips)
Player_c23cf83a: posts the ante 30
Player_12f7d499: posts the ante 30
Hero: posts the ante 30
Player_8ee7a8ff: posts the ante 30
Player_fcd0f8d3: posts the ante 30
Player_1ff99c9b: posts the ante 30
Player_9a8e8436: posts the ante 30
Player_d1b29ab0: posts the ante 30
Player_1faec1db: posts the ante 30
Player_9a8e8436: posts small blind 150
Player_d1b29ab0: posts big blind 300
*** HOLE CARDS ***
Dealt to Hero [Js Jd]
Player_1faec1db: folds
Player_c23cf83a: folds
Player_12f7d499: folds
Hero: raises 700 to 700
Player_8ee7a8ff: folds
Player_fcd0f8d3: calls 700 
Player_1ff99c9b: calls 700 
Player_9a8e8436: folds
Player_d1b29ab0: folds
*** FLOP *** [Ac Qh 6d]
Hero: bets 999 
Player_fcd0f8d3: folds
Player_1ff99c9b: calls 999 
*** TURN *** [Ac Qh 6d] [Jh]
Hero: bets 2000 
Player_1ff99c9b: raises 5806 to 5806 and is all-in
Hero: calls 3806 
*** RIVER *** [Ac Qh 6d Jh] [6h]
*** SHOW DOWN ***
Hero: shows [Js Jd] (a full house, Jacks full of Sixes)
Player_1ff99c9b: shows [Qd Ah] (two pair, Aces and Queens)
Hero collected 16430 from pot
Player_1ff99c9b finished the tournament in 149th place
*** SUMMARY ***
Total pot 16430 | Rake 0
Board [Ac Qh 6d Jh 6h]
Seat 1: Player_c23cf83a mucked
Seat 2: Player_12f7d499 mucked
Seat 3: Hero showed [Js Jd] and won (16430) with a full house, Jacks full of Sixes
Seat 4: Player_8ee7a8ff mucked
Seat 5: Player_fcd0f8d3 mucked
Seat 6: Player_1ff99c9b (button) showed [Qd Ah] and lost with two pair, Aces and Queens
Seat 7: Player_9a8e8436 (small blind) mucked
Seat 8: Player_d1b29ab0 (big blind) mucked
Seat 9: Player_1faec1db mucked



PokerStars Hand #3661309899: Tournament #21391319, $20+$2 - Hold'em No Limit (150/300) - 2018/04/06 23:19:50
Table '#18' Seat #7 is the button
Seat 1: Player_4583896e (17,570 in chips)
Seat 2: Player_dfe57ad1 (10,095 in chips)
Seat 3: Hero (22,680 in chips)
Seat 4: Player_0701e596 (11,790 in chips)
Seat 5: Player_6a634c11 (8,625 in chips)
Seat 6: Player_88b3c115 (9,460 in chips)
Seat 7: Player_85f644ca (20,703 in chips)
Seat 8: Player_d4fc88bd (11,980 in chips)
Player_4583896e: posts the ante 30
Player_dfe57ad1: posts the ante 30
Hero: posts the ante 30
Player_0701e596: posts the ante 30
Player_6a634c11: posts the ante 30
Player_88b3c115: posts the ante 30
Player_85f644ca: posts the ante 30
Player_d4fc88bd: posts the ante 30
Player_85f644ca: posts small blind 150
Player_d4fc88bd: posts big blind 300
*** HOLE CARDS ***
Dealt to Hero [5c 9h]
Player_4583896e: folds
Player_dfe57ad1: folds
Hero: folds
Player_0701e596: folds
Player_6a634c11: folds
Player_88b3c115: raises 1200 to 1200
Player_85f644ca: raises 20523 to 20673 and is all-in
Player_d4fc88bd: folds
Player_88b3c115: calls 8230 and is all-in
*** FLOP *** [Kc 2d Ks]
*** TURN *** [Kc 2d Ks] [8c]
*** RIVER *** [Kc 2d Ks 8c] [4c]
*** SHOW DOWN ***
Player_88b3c115: shows [Qd Jc] (a pair of Kings)
Player_85f644ca: shows [9d Kd] (three of a kind, Kings)
Uncalled bet (11243) returned to Player_85f644ca
Player_85f644ca collected 19400 from pot
Player_88b3c115 finished the tournament in 148th place
*** SUMMARY ***
Total pot 19400 | Rake 0
Board [Kc 2d Ks 8c 4c]
Seat 1: Player_4583896e mucked
Seat 2: Player_dfe57ad1 mucked
Seat 3: Hero mucked
Seat 4: Player_0701e596 mucked
Seat 5: Player_6a634c11 mucked
Seat 6: Player_88b3c115 (button) showed [Qd Jc] and lost with a pair of Kings
Seat 7: Player_85f644ca (small blind) showed [9d Kd] and won (19400) with three of a kind, Kings
Seat 8: Player_d4fc88bd (big blind) mucked



PokerStars Hand #3661310670: Tournament #21391319, $20+$2 - Hold'em No Limit (150/300) - 2018/04/06 23:20:56
Table '#18' Seat #8 is the button
Seat 1: Player_6ddf737c (17,540 in chips)
Seat 2: Player_ed8c3458 (10,065 in chips)
Seat 3: Hero (22,650 in chips)
Seat 4: Player_f38dfcf8 (11,760 in chips)
Seat 5: Player_04292853 (8,595 in chips)
Seat 6: Player_b3f008ec (30,643 in chips)
Seat 7: Player_e9e5906e (11,650 in chips)
Player_6ddf737c: posts the ante 30
Player_ed8c3458: posts the ante 30
Hero: posts the ante 30
Player_f38dfcf8: posts the ante 30
Player_04292853: posts the ante 30
Player_b3f008ec: posts the ante 30
Player_e9e5906e: posts the ante 30
Player_e9e5906e: posts small blind 150
Player_6ddf737c: posts big blind 300
*** HOLE CARDS ***
Dealt to Hero [3c 2h]
Player_ed8c3458: folds
Hero: folds
Player_f38dfcf8: folds
Player_04292853: folds
Player_b3f008ec: folds
Player_e9e5906e: raises 750 to 900
Player_6ddf737c: folds
Uncalled bet (600) returned to Player_e9e5906e
Player_e9e5906e: doesn't show hand
Player_e9e5906e collected 810 from pot
*** SUMMARY ***
Total pot 810 | Rake 0
Seat 1: Player_6ddf737c (big blind) mucked
Seat 2: Player_ed8c3458 mucked
Seat 3: Hero mucked
Seat 4: Player_f38dfcf8 mucked
Seat 5: Player_04292853 mucked
Seat 6: Player_b3f008ec (button) mucked
Seat 7: Player_e9e5906e (small blind) won (810)



PokerStars Hand #3661311473: Tournament #21391319, $20+$2 - Hold'em No Limit (200/400) - 2018/04/06 23:22:08
Table '#18' Seat #9 is the button
Seat 1: Player_1af933f5 (17,210 in chips)
Seat 2: Player_41d8b5a0 (10,035 in chips)
Seat 3: Hero (22,620 in chips)
Seat 4: Player_c675fa65 (11,730 in chips)
Seat 5: Player_622299e8 (8,565 in chips)
Seat 6: Player_24216909 (10,000 in chips)
Seat 7: Player_7636b5af (30,613 in chips)
Seat 8: Player_e6c3d2f3 (12,130 in chips)
Player_1af933f5: posts the ante 40
Player_41d8b5a0: posts the ante 40
Hero: posts the ante 40
Player_c675fa65: posts the ante 40
Player_622299e8: posts the ante 40
Player_24216909: posts the ante 40
Player_7636b5af: posts the ante 40
Player_e6c3d2f3: posts the ante 40
Player_1af933f5: posts small blind 200
Player_41d8b5a0: posts big blind 400
*** HOLE CARDS ***
Dealt to Hero [2d 5c]
Hero: folds
Player_c675fa65: folds
Player_622299e8: folds
Player_24216909: folds
Player_7636b5af: raises 800 to 800
Player_e6c3d2f3: folds
Player_1af933f5: folds
Player_41d8b5a0: folds
Uncalled bet (400) returned to Player_7636b5af
Player_7636b5af: doesn't show hand
Player_7636b5af collected 1320 from pot
*** SUMMARY ***
Total pot 1320 | Rake 0
Seat 1: Player_1af933f5 (small blind) mucked
Seat 2: Player_41d8b5a0 (big blind) mucked
Seat 3: Hero mucked
Seat 4: Player_c675fa65 mucked
Seat 5: Player_622299e8 mucked
Seat 6: Player_24216909 mucked
Seat 7: Player_7636b5af won (1320)
Seat 8: Player_e6c3d2f3 (button) mucked



PokerStars Hand #3661311997: Tournament #21391319, $20+$2 - Hold'em No Limit (200/400) - 2018/04/06 23:22:59
Table '#18' Seat #1 is the button
Seat 1: Player_3666e4ba (16,970 in chips)
Seat 2: Player_54dd8d1d (9,595 in chips)
Seat 3: Hero (22,580 in chips)
Seat 4: Player_ad555496 (11,690 in chips)
Seat 5: Player_2941ddff (8,525 in chips)
Seat 6: Player_6017a8a7 (9,960 in chips)
Seat 7: Player_5fa9e519 (10,000 in chips)
Seat 8: Player_26750e8e (31,493 in chips)
Seat 9: Player_449e6d2c (12,090 in chips)
Player_3666e4ba: posts the ante 40
Player_54dd8d1d: posts the ante 40
Hero: posts the ante 40
Player_ad555496: posts the ante 40
Player_2941ddff: posts the ante 40
Player_6017a8a7: posts the ante 40
Player_5fa9e519: posts the ante 40
Player_26750e8e: posts the ante 40
Player_449e6d2c: posts the ante 40
Player_54dd8d1d: posts small blind 200
Hero: posts big blind 400
*** HOLE CARDS ***
Dealt to Hero [2d 5d]
Player_ad555496: folds
Player_2941ddff: calls 400 
Player_6017a8a7: folds
Player_5fa9e519: raises 2800 to 2800
Player_26750e8e: folds
Player_449e6d2c: folds
Player_3666e4ba: folds
Player_54dd8d1d: folds
Hero: folds
Player_2941ddff: folds
*** SHOW DOWN ***
Player_5fa9e519: shows [Ac Kc] (high card Ace)
Uncalled bet (2400) returned to Player_5fa9e519
Player_5fa9e519 collected 1760 from pot
*** SUMMARY ***
Total pot 1760 | Rake 0
Seat 1: Player_3666e4ba (button) mucked
Seat 2: Player_54dd8d1d (small blind) mucked
Seat 3: Hero (big blind) mucked
Seat 4: Player_ad555496 mucked
Seat 5: Player_2941ddff mucked
Seat 6: Player_6017a8a7 mucked
Seat 7: Player_5fa9e519 showed [Ac Kc] and won (1760) with high card Ace
Seat 8: Player_26750e8e mucked
Seat 9: Player_449e6d2c mucked



PokerStars Hand #3661312735: Tournament #21391319, $20+$2 - Hold'em No Limit (200/400) - 2018/04/06 23:24:05
Table '#18' Seat #2 is the button
Seat 1: Player_19ff2caa (16,930 in chips)
Seat 2: Player_3ebeef1f (9,355 in chips)
Seat 3: Hero (22,140 in chips)
Seat 4: Player_a6e95a71 (11,650 in chips)
Seat 5: Player_a2eefdc6 (8,085 in chips)
Seat 6: Player_ce40c093 (9,920 in chips)
Seat 7: Player_bc8dfafc (11,320 in chips)
Seat 8: Player_0d23fed5 (31,453 in chips)
Seat 9: Player_6dce5802 (12,050 in chips)
Player_19ff2caa: posts the ante 40
Player_3ebeef1f: posts the ante 40
Hero: posts the ante 40
Player_a6e95a71: posts the ante 40
Player_a2eefdc6: posts the ante 40
Player_ce40c093: posts the ante 40
Player_bc8dfafc: posts the ante 40
Player_0d23fed5: posts the ante 40
Player_6dce5802: posts the ante 40
Hero: posts small blind 200
Player_a6e95a71: posts big blind 400
*** HOLE CARDS ***
Dealt to Hero [8c Kh]
Player_a2eefdc6: calls 400 
Player_ce40c093: calls 400 
Player_bc8dfafc: folds
Player_0d23fed5: raises 1600 to 1600
Player_6dce5802: folds
Player_19ff2caa: folds
Player_3ebeef1f: folds
Hero: folds
Player_a6e95a71: folds
Player_a2eefdc6: calls 1200 
Player_ce40c093: calls 1200 
*** FLOP *** [As 4d 3h]
Player_a2eefdc6: checks
Player_ce40c093: checks
Player_0d23fed5: bets 1961 
Player_a2eefdc6: calls 1961 
Player_ce40c093: calls 1961 
*** TURN *** [As 4d 3h] [6c]
Player_a2eefdc6: checks
Player_ce40c093: bets 400 
Player_0d23fed5: folds
Player_a2eefdc6: raises 2400 to 2400
Player_ce40c093: calls 2000 
*** RIVER *** [As 4d 3h 6c] [9h]
Player_a2eefdc6: bets 2084 and is all-in
Player_ce40c093: folds
Uncalled bet (2084) returned to Player_a2eefdc6
Player_a2eefdc6: doesn't show hand
Player_a2eefdc6 collected 16443 from pot
*** SUMMARY ***
Total pot 16443 | Rake 0
Board [As 4d 3h 6c 9h]
Seat 1: Player_19ff2caa mucked
Seat 2: Player_3ebeef1f (button) mucked
Seat 3: Hero (small blind) mucked
Seat 4: Player_a6e95a71 (big blind) mucked
Seat 5: Player_a2eefdc6 won (16443)
Seat 6: Player_ce40c093 mucked
Seat 7: Player_bc8dfafc mucked
Seat 8: Player_0d23fed5 mucked
Seat 9: Player_6dce5802 mucked



PokerStars Hand #3661314035: Tournament #21391319, $20+$2 - Hold'em No Limit (200/400) - 2018/04/06 23:26:02
Table '#18' Seat #3 is the button
Seat 1: Player_c21317fe (16,890 in chips)
Seat 2: Player_781173ec (9,315 in chips)
Seat 3: Hero (21,900 in chips)
Seat 4: Player_8512ba9f (11,210 in chips)
Seat 5: Player_975022b5 (18,527 in chips)
Seat 6: Player_f8cf55d5 (3,919 in chips)
Seat 7: Player_70a0d146 (11,280 in chips)
Seat 8: Player_bb1dc1fb (27,852 in chips)
Seat 9: Player_0908c5a8 (12,010 in chips)
Player_c21317fe: posts the ante 40
Player_781173ec: posts the ante 40
Hero: posts the ante 40
Player_8512ba9f: posts the ante 40
Player_975022b5: posts the ante 40
Player_f8cf55d5: posts the ante 40
Player_70a0d146: posts the ante 40
Player_bb1dc1fb: posts the ante 40
Player_0908c5a8: posts the ante 40
Player_8512ba9f: posts small blind 200
Player_975022b5: posts big blind 400
*** HOLE CARDS ***
Dealt to Hero [3d As]
Player_f8cf55d5: folds
Player_70a0d146: calls 400 
Player_bb1dc1fb: folds
Player_0908c5a8: folds
Player_c21317fe: folds
Player_781173ec: folds
Hero: folds
Player_8512ba9f: calls 200 
Player_975022b5: checks
*** FLOP *** [4h 4s Qc]
Player_8512ba9f: checks
Player_975022b5: checks
Player_70a0d146: bets 1560 
Player_8512ba9f: folds
Player_975022b5: folds
Uncalled bet (1560) returned to Player_70a0d146
Player_70a0d146: doesn't show hand
Player_70a0d146 collected 1560 from pot
*** SUMMARY ***
Total pot 1560 | Rake 0
Board [4h 4s Qc]
Seat 1: Player_c21317fe mucked
Seat 2: Player_781173ec mucked
Seat 3: Hero (button) mucked
Seat 4: Player_8512ba9f (small blind) mucked
Seat 5: Player_975022b5 (big blind) mucked
Seat 6: Player_f8cf55d5 mucked
Seat 7: Player_70a0d146 won (1560)
Seat 8: Player_bb1dc1fb mucked
Seat 9: Player_0908c5a8 mucked



PokerStars Hand #3661315176: Tournament #21391319, $20+$2 - Hold'em No Limit (200/400) - 2018/04/06 23:27:44
Table '#18' Seat #4 is the button
Seat 1: Player_666f6c63 (16,850 in chips)
Seat 2: Hero (21,860 in chips)
Seat 3: Player_50409bb3 (10,770 in chips)
Seat 4: Player_9efa8a7c (18,087 in chips)
Seat 5: Player_03eba6e9 (3,879 in chips)
Seat 6: Player_59265df9 (12,400 in chips)
Seat 7: Player_b243088d (27,812 in chips)
Seat 8: Player_d682e232 (11,970 in chips)
Player_666f6c63: posts the ante 40
Hero: posts the ante 40
Player_50409bb3: posts the ante 40
Player_9efa8a7c: posts the ante 40
Player_03eba6e9: posts the ante 40
Player_59265df9: posts the ante 40
Player_b243088d: posts the ante 40
Player_d682e232: posts the ante 40
Player_9efa8a7c: posts small blind 200
Player_03eba6e9: posts big blind 400
*** HOLE CARDS ***
Dealt to Hero [Ad Tc]
Player_59265df9: folds
Player_b243088d: folds
Player_d682e232: folds
Player_666f6c63: calls 400 
Hero: calls 400 
Player_50409bb3: calls 400 
Player_9efa8a7c: folds
Player_03eba6e9: bets 3439 and is all-in
Player_666f6c63: calls 3439 
Hero: folds
Player_50409bb3: folds
*** FLOP *** [6s Td Qs]
*** TURN *** [6s Td Qs] [8d]
*** RIVER *** [6s Td Qs 8d] [6d]
*** SHOW DOWN ***
Player_666f6c63: shows [9c 9d] (two pair, Nines and Sixes)
Player_03eba6e9: shows [6c Ah] (three of a kind, Sixes)
Player_03eba6e9 collected 8998 from pot
*** SUMMARY ***
Total pot 8998 | Rake 0
Board [6s Td Qs 8d 6d]
Seat 1: Player_666f6c63 showed [9c 9d] and lost with two pair, Nines and Sixes
Seat 2: Hero mucked
Seat 3: Player_50409bb3 (button) mucked
Seat 4: Player_9efa8a7c (small blind) mucked
Seat 5: Player_03eba6e9 (big blind) showed [6c Ah] and won (8998) with three of a kind, Sixes
Seat 6: Player_59265df9 mucked
Seat 7: Player_b243088d mucked
Seat 8: Player_d682e232 mucked



PokerStars Hand #3661316172: Tournament #21391319, $20+$2 - Hold'em No Limit (200/400) - 2018/04/06 23:29:17
Table '#18' Seat #5 is the button
Seat 1: Player_719af7a5 (12,971 in chips)
Seat 2: Player_fb25ac36 (10,000 in chips)
Seat 3: Hero (21,420 in chips)
Seat 4: Player_fbe6b0a2 (10,330 in chips)
Seat 5: Player_436b7232 (17,847 in chips)
Seat 6: Player_10b7fedb (8,998 in chips)
Seat 7: Player_74656210 (12,360 in chips)
Seat 8: Player_07e39e90 (27,772 in chips)
Seat 9: Player_bca74f83 (11,930 in chips)
Player_719af7a5: posts the ante 40
Player_fb25ac36: posts the ante 40
Hero: posts the ante 40
Player_fbe6b0a2: posts the ante 40
Player_436b7232: posts the ante 40
Player_10b7fedb: posts the ante 40
Player_74656210: posts the ante 40
Player_07e39e90: posts the ante 40
Player_bca74f83: posts the ante 40
Player_10b7fedb: posts small blind 200
Player_74656210: posts big blind 400
*** HOLE CARDS ***
Dealt to Hero [Ks Ah]
Player_07e39e90: folds
Player_bca74f83: folds
Player_719af7a5: folds
Player_fb25ac36: folds
Hero: raises 999 to 999
Player_fbe6b0a2: folds
Player_436b7232: calls 999 
Player_10b7fedb: calls 799 
Player_74656210: calls 599 
*** FLOP *** [Th Qd Kh]
Player_10b7fedb: checks
Player_74656210: checks
Hero: checks
Player_436b7232: checks
*** TURN *** [Th Qd Kh] [8s]
Player_10b7fedb: bets 400 
Player_74656210: raises 1600 to 1600
Hero: calls 1600 
Player_436b7232: folds
Player_10b7fedb: calls 1200 
*** RIVER *** [Th Qd Kh 8s] [Kc]
Player_10b7fedb: checks
Player_74656210: bets 9156 
Hero: calls 9156 
Player_10b7fedb: folds
*** SHOW DOWN ***
Player_74656210: shows [Jh 9c] (a straight, Nine to King)
Hero: Mucks [Ks Ah] (Three of a kind)
Player_74656210 collected 27468 from pot
*** SUMMARY ***
Total pot 27468 | Rake 0
Board [Th Qd Kh 8s Kc]
Seat 1: Player_719af7a5 mucked
Seat 2: Player_fb25ac36 mucked
Seat 3: Hero mucked [Ks Ah]
Seat 4: Player_fbe6b0a2 mucked
Seat 5: Player_436b7232 (button) mucked
Seat 6: Player_10b7fedb (small blind) mucked
Seat 7: Player_74656210 (big blind) showed [Jh 9c] and won (27468) with a straight, Nine to King
Seat 8: Player_07e39e90 mucked
Seat 9: Player_bca74f83 mucked



PokerStars Hand #3661317943: Tournament #21391319, $20+$2 - Hold'em No Limit (250/500) - 2018/04/06 23:31:56
Table '#18' Seat #6 is the button
Seat 1: Player_ead9e4ed (12,931 in chips)
Seat 2: Player_fab1b3b9 (9,960 in chips)
Seat 3: Hero (9,625 in chips)
Seat 4: Player_8f9da0e6 (10,290 in chips)
Seat 5: Player_3ad251c1 (16,808 in chips)
Seat 6: Player_4d14b276 (6,359 in chips)
Seat 7: Player_6c5726a8 (28,033 in chips)
Seat 8: Player_38704ce0 (27,732 in chips)
Seat 9: Player_1fb824c7 (11,890 in chips)
Player_ead9e4ed: posts the ante 50
Player_fab1b3b9: posts the ante 50
Hero: posts the ante 50
Player_8f9da0e6: posts the ante 50
Player_3ad251c1: posts the ante 50
Player_4d14b276: posts the ante 50
Player_6c5726a8: posts the ante 50
Player_38704ce0: posts the ante 50
Player_1fb824c7: posts the ante 50
Player_6c5726a8: posts small blind 250
Player_38704ce0: posts big blind 500
*** HOLE CARDS ***
Dealt to Hero [Ad Ac]
Player_1fb824c7: folds
Player_ead9e4ed: folds
Player_fab1b3b9: folds
Hero: raises 1222 to 1222
Player_8f9da0e6: folds
Player_3ad251c1: folds
Player_4d14b276: calls 1222 
Player_6c5726a8: calls 972 
Player_38704ce0: folds
*** FLOP *** [4d 2d 6s]
Player_6c5726a8: checks
Hero: bets 2333 
Player_4d14b276: folds
Player_6c5726a8: folds
Uncalled bet (2333) returned to Hero
Hero: doesn't show hand
Hero collected 4616 from pot
*** SUMMARY ***
Total pot 4616 | Rake 0
Board [4d 2d 6s]
Seat 1: Player_ead9e4ed mucked
Seat 2: Player_fab1b3b9 mucked
Seat 3: Hero won (4616)
Seat 4: Player_8f9da0e6 mucked
Seat 5: Player_3ad251c1 mucked
Seat 6: Player_4d14b276 (button) mucked
Seat 7: Player_6c5726a8 (small blind) mucked
Seat 8: Player_38704ce0 (big blind) mucked
Seat 9: Player_1fb824c7 mucked



PokerStars Hand #3661319421: Tournament #21391319, $20+$2 - Hold'em No Limit (250/500) - 2018/04/06 23:34:08
Table '#18' Seat #7 is the button
Seat 1: Player_2add4b3c (12,881 in chips)
Seat 2: Player_56ca1699 (9,910 in chips)
Seat 3: Hero (12,969 in chips)
Seat 4: Player_63148d05 (10,240 in chips)
Seat 5: Player_643c0186 (16,758 in chips)
Seat 6: Player_28782b2c (5,087 in chips)
Seat 7: Player_23d2980c (26,761 in chips)
Seat 8: Player_1f40d90f (27,182 in chips)
Seat 9: Player_29ccce34 (11,840 in chips)
Player_2add4b3c: posts the ante 50
Player_56ca1699: posts the ante 50
Hero: posts the ante 50
Player_63148d05: posts the ante 50
Player_643c0186: posts the ante 50
Player_28782b2c: posts the ante 50
Player_23d2980c: posts the ante 50
Player_1f40d90f: posts the ante 50
Player_29ccce34: posts the ante 50
Player_1f40d90f: posts small blind 250
Player_29ccce34: posts big blind 500
*** HOLE CARDS ***
Dealt to Hero [Ad Ts]
Player_2add4b3c: calls 500 
Player_56ca1699: folds
Hero: folds
Player_63148d05: folds
Player_643c0186: folds
Player_28782b2c: raises 1000 to 1000
Player_23d2980c: folds
Player_1f40d90f: folds
Player_29ccce34: raises 2500 to 3000
Player_2add4b3c: folds
Player_28782b2c: calls 2000 
*** FLOP *** [4d Th Kd]
Player_29ccce34: bets 7200 
Player_28782b2c: bets 2037 and is all-in
*** TURN *** [4d Th Kd] [3s]
*** RIVER *** [4d Th Kd 3s] [7d]
*** SHOW DOWN ***
Player_28782b2c: shows [Ks Qs] (a pair of Kings)
Player_29ccce34: shows [3d 3c] (three of a kind, Threes)
Uncalled bet (5163) returned to Player_29ccce34
Player_29ccce34 collected 11274 from pot
Player_28782b2c finished the tournament in 157th place
*** SUMMARY ***
Total pot 11274 | Rake 0
Board [4d Th Kd 3s 7d]
Seat 1: Player_2add4b3c mucked
Seat 2: Player_56ca1699 mucked
Seat 3: Hero mucked
Seat 4: Player_63148d05 mucked
Seat 5: Player_643c0186 mucked
Seat 6: Player_28782b2c showed [Ks Qs] and lost with a pair of Kings
Seat 7: Player_23d2980c (button) mucked
Seat 8: Player_1f40d90f (small blind) mucked
Seat 9: Player_29ccce34 (big blind) showed [3d 3c] and won (11274) with three of a kind, Threes



PokerStars Hand #3661320640: Tournament #21391319, $20+$2 - Hold'em No Limit (250/500) - 2018/04/06 23:36:02
Table '#18' Seat #8 is the button
Seat 1: Player_54274948 (12,331 in chips)
Seat 2: Player_04fe97e0 (9,860 in chips)
Seat 3: Hero (12,919 in chips)
Seat 4: Player_de4307fe (10,190 in chips)
Seat 5: Player_150c9fcb (16,708 in chips)
Seat 6: Player_5b0e25fc (26,711 in chips)
Seat 7: Player_ce251292 (26,882 in chips)
Seat 8: Player_a5559acc (18,027 in chips)
Player_54274948: posts the ante 50
Player_04fe97e0: posts the ante 50
Hero: posts the ante 50
Player_de4307fe: posts the ante 50
Player_150c9fcb: posts the ante 50
Player_5b0e25fc: posts the ante 50
Player_ce251292: posts the ante 50
Player_a5559acc: posts the ante 50
Player_a5559acc: posts small blind 250
Player_54274948: posts big blind 500
*** HOLE CARDS ***
Dealt to Hero [3d 6d]
Player_04fe97e0: folds
Hero: folds
Player_de4307fe: folds
Player_150c9fcb: calls 500 
Player_5b0e25fc: folds
Player_ce251292: folds
Player_a5559acc: folds
Player_54274948: checks
*** FLOP *** [Js 8s 8c]
Player_54274948: checks
Player_150c9fcb: checks
*** TURN *** [Js 8s 8c] [Th]
Player_54274948: checks
Player_150c9fcb: bets 1351 
Player_54274948: folds
Uncalled bet (1351) returned to Player_150c9fcb
Player_150c9fcb: doesn't show hand
Player_150c9fcb collected 1650 from pot
*** SUMMARY ***
Total pot 1650 | Rake 0
Board [Js 8s 8c Th]
Seat 1: Player_54274948 (big blind) mucked
Seat 2: Player_04fe97e0 mucked
Seat 3: Hero mucked
Seat 4: Player_de4307fe mucked
Seat 5: Player_150c9fcb won (1650)
Seat 6: Player_5b0e25fc mucked
Seat 7: Player_ce251292 (button) mucked
Seat 8: Player_a5559acc (small blind) mucked



PokerStars Hand #3661321808: Tournament #21391319, $20+$2 - Hold'em No Limit (250/500) - 2018/04/06 23:37:50
Table '#18' Seat #9 is the button
Seat 1: Player_b25b1990 (11,781 in chips)
Seat 2: Player_f9993d0a (9,810 in chips)
Seat 3: Hero (12,869 in chips)
Seat 4: Player_65cfb4be (10,140 in chips)
Seat 5: Player_bdbc72aa (17,808 in chips)
Seat 6: Player_f35d2792 (26,661 in chips)
Seat 7: Player_bc6d2448 (26,832 in chips)
Seat 8: Player_1943b3b8 (17,727 in chips)
Player_b25b1990: posts the ante 50
Player_f9993d0a: posts the ante 50
Hero: posts the ante 50
Player_65cfb4be: posts the ante 50
Player_bdbc72aa: posts the ante 50
Player_f35d2792: posts the ante 50
Player_bc6d2448: posts the ante 50
Player_1943b3b8: posts the ante 50
Player_b25b1990: posts small blind 250
Player_f9993d0a: posts big blind 500
*** HOLE CARDS ***
Dealt to Hero [4h 6s]
Hero: folds
Player_65cfb4be: folds
Player_bdbc72aa: folds
Player_f35d2792: calls 500 
Player_bc6d2448: raises 2650 to 2650
Player_1943b3b8: folds
Player_b25b1990: calls 2400 
Player_f9993d0a: folds
Player_f35d2792: folds
*** FLOP *** [7s 4c 8s]
Player_b25b1990: bets 1200 
Player_bc6d2448: raises 10780 to 10780
Player_b25b1990: calls 7881 and is all-in
*** TURN *** [7s 4c 8s] [Qd]
*** RIVER *** [7s 4c 8s Qd] [2d]
*** SHOW DOWN ***
Player_b25b1990: shows [Ks Js] (high card King)
Player_bc6d2448: shows [8h Ah] (a pair of Eights)
Uncalled bet (1699) returned to Player_bc6d2448
Player_bc6d2448 collected 24862 from pot
Player_b25b1990 finished the tournament in 155th place
*** SUMMARY ***
Total pot 24862 | Rake 0
Board [7s 4c 8s Qd 2d]
Seat 1: Player_b25b1990 (small blind) showed [Ks Js] and lost with high card King
Seat 2: Player_f9993d0a (big blind) mucked
Seat 3: Hero mucked
Seat 4: Player_65cfb4be mucked
Seat 5: Player_bdbc72aa mucked
Seat 6: Player_f35d2792 mucked
Seat 7: Player_bc6d2448 showed [8h Ah] and won (24862) with a pair of Eights
Seat 8: Player_1943b3b8 (button) mucked



PokerStars Hand #3661322864: Tournament #21391319, $20+$2 - Hold'em No Limit (250/500) - 2018/04/06 23:39:26
Table '#18' Seat #1 is the button
Seat 1: Player_1da6f704 (10,000 in chips)
Seat 2: Player_f1072bd1 (9,260 in chips)
Seat 3: Hero (12,819 in chips)
Seat 4: Player_86968998 (10,090 in chips)
Seat 5: Player_ed2c2ef2 (17,758 in chips)
Seat 6: Player_16e402b9 (26,111 in chips)
Seat 7: Player_88fa267c (39,913 in chips)
Seat 8: Player_8b9ddf95 (17,677 in chips)
Player_1da6f704: posts the ante 50
Player_f1072bd1: posts the ante 50
Hero: posts the ante 50
Player_86968998: posts the ante 50
Player_ed2c2ef2: posts the ante 50
Player_16e402b9: posts the ante 50
Player_88fa267c: posts the ante 50
Player_8b9ddf95: posts the ante 50
Player_f1072bd1: posts small blind 250
Hero: posts big blind 500
*** HOLE CARDS ***
Dealt to Hero [Qh 6c]
Player_86968998: folds
Player_ed2c2ef2: calls 500 
Player_16e402b9: folds
Player_88fa267c: folds
Player_8b9ddf95: folds
Player_1da6f704: calls 500 
Player_f1072bd1: bets 8960 and is all-in
Hero: folds
Player_ed2c2ef2: folds
Player_1da6f704: folds
Uncalled bet (8710) returned to Player_f1072bd1
Player_f1072bd1: doesn't show hand
Player_f1072bd1 collected 2400 from pot
*** SUMMARY ***
Total pot 2400 | Rake 0
Seat 1: Player_1da6f704 (button) mucked
Seat 2: Player_f1072bd1 (small blind) won (2400)
Seat 3: Hero (big blind) mucked
Seat 4: Player_86968998 mucked
Seat 5: Player_ed2c2ef2 mucked
Seat 6: Player_16e402b9 mucked
Seat 7: Player_88fa267c mucked
Seat 8: Player_8b9ddf95 mucked



PokerStars Hand #3661323928: Tournament #21391319, $20+$2 - Hold'em No Limit (250/500) - 2018/04/06 23:41:05
Table '#18' Seat #2 is the button
Seat 1: Player_1ed2bf5f (9,450 in chips)
Seat 2: Player_7f7f222e (11,110 in chips)
Seat 3: Hero (12,269 in chips)
Seat 4: Player_66abfa97 (10,040 in chips)
Seat 5: Player_2ac1e67d (17,208 in chips)
Seat 6: Player_dd3f1ba3 (26,061 in chips)
Seat 7: Player_c45dfa59 (39,863 in chips)
Seat 8: Player_5bf894c0 (17,627 in chips)
Player_1ed2bf5f: posts the ante 50
Player_7f7f222e: posts the ante 50
Hero: posts the ante 50
Player_66abfa97: posts the ante 50
Player_2ac1e67d: posts the ante 50
Player_dd3f1ba3: posts the ante 50
Player_c45dfa59: posts the ante 50
Player_5bf894c0: posts the ante 50
Hero: posts small blind 250
Player_66abfa97: posts big blind 500
*** HOLE CARDS ***
Dealt to Hero [2s Qs]
Player_2ac1e67d: folds
Player_dd3f1ba3: folds
Player_c45dfa59: folds
Player_5bf894c0: folds
Player_1ed2bf5f: folds
Player_7f7f222e: bets 11060 and is all-in
Hero: folds
Player_66abfa97: folds
Uncalled bet (10560) returned to Player_7f7f222e
Player_7f7f222e: doesn't show hand
Player_7f7f222e collected 1650 from pot
*** SUMMARY ***
Total pot 1650 | Rake 0
Seat 1: Player_1ed2bf5f mucked
Seat 2: Player_7f7f222e (button) won (1650)
Seat 3: Hero (small blind) mucked
Seat 4: Player_66abfa97 (big blind) mucked
Seat 5: Player_2ac1e67d mucked
Seat 6: Player_dd3f1ba3 mucked
Seat 7: Player_c45dfa59 mucked
Seat 8: Player_5bf894c0 mucked



PokerStars Hand #3661324554: Tournament #21391319, $20+$2 - Hold'em No Limit (300/600) - 2018/04/06 23:42:02
Table '#18' Seat #3 is the button
Seat 1: Player_d52183f6 (9,400 in chips)
Seat 2: Player_5e48fd81 (12,210 in chips)
Seat 3: Hero (11,969 in chips)
Seat 4: Player_5787175f (9,490 in chips)
Seat 5: Player_66760b96 (17,158 in chips)
Seat 6: Player_68a63019 (26,011 in chips)
Seat 7: Player_6dc02518 (39,813 in chips)
Seat 8: Player_b54a136d (17,577 in chips)
Player_d52183f6: posts the ante 60
Player_5e48fd81: posts the ante 60
Hero: posts the ante 60
Player_5787175f: posts the ante 60
Player_66760b96: posts the ante 60
Player_68a63019: posts the ante 60
Player_6dc02518: posts the ante 60
Player_b54a136d: posts the ante 60
Player_5787175f: posts small blind 300
Player_66760b96: posts big blind 600
*** HOLE CARDS ***
Dealt to Hero [Js 8h]
Player_68a63019: folds
Player_6dc02518: folds
Player_b54a136d: folds
Player_d52183f6: folds
Player_5e48fd81: folds
Hero: raises 1500 to 1500
Player_5787175f: folds
Player_66760b96: calls 900 
*** FLOP *** [7c Ac 2d]
Player_66760b96: checks
Hero: bets 1900 
Player_66760b96: raises 9480 to 9480
Hero: folds
Uncalled bet (7580) returned to Player_66760b96
Player_66760b96: doesn't show hand
Player_66760b96 collected 7580 from pot
*** SUMMARY ***
Total pot 7580 | Rake 0
Board [7c Ac 2d]
Seat 1: Player_d52183f6 mucked
Seat 2: Player_5e48fd81 mucked
Seat 3: Hero (button) mucked
Seat 4: Player_5787175f (small blind) mucked
Seat 5: Player_66760b96 (big blind) won (7580)
Seat 6: Player_68a63019 mucked
Seat 7: Player_6dc02518 mucked
Seat 8: Player_b54a136d mucked



PokerStars Hand #3661325232: Tournament #21391319, $20+$2 - Hold'em No Limit (300/600) - 2018/04/06 23:43:05
Table '#18' Seat #4 is the button
Seat 1: Player_78dfd08b (9,340 in chips)
Seat 2: Player_fb9c0786 (12,150 in chips)
Seat 3: Hero (8,509 in chips)
Seat 4: Player_872ac82c (9,130 in chips)
Seat 5: Player_770e7752 (21,278 in chips)
Seat 6: Player_0ef39fd7 (25,951 in chips)
Seat 7: Player_80ff3782 (39,753 in chips)
Seat 8: Player_558c99ec (17,517 in chips)
Player_78dfd08b: posts the ante 60
Player_fb9c0786: posts the ante 60
Hero: posts the ante 60
Player_872ac82c: posts the ante 60
Player_770e7752: posts the ante 60
Player_0ef39fd7: posts the ante 60
Player_80ff3782: posts the ante 60
Player_558c99ec: posts the ante 60
Player_770e7752: posts small blind 300
Player_0ef39fd7: posts big blind 600
*** HOLE CARDS ***
Dealt to Hero [2s Ah]
Player_80ff3782: folds
Player_558c99ec: folds
Player_78dfd08b: folds
Player_fb9c0786: folds
Hero: folds
Player_872ac82c: folds
Player_770e7752: folds
Player_0ef39fd7: doesn't show hand
Uncalled bet (600) returned to Player_0ef39fd7
Player_0ef39fd7 collected 780 from pot
*** SUMMARY ***
Total pot 780 | Rake 0
Seat 1: Player_78dfd08b mucked
Seat 2: Player_fb9c0786 mucked
Seat 3: Hero mucked
Seat 4: Player_872ac82c (button) mucked
Seat 5: Player_770e7752 (small blind) mucked
Seat 6: Player_0ef39fd7 (big blind) won (780)
Seat 7: Player_80ff3782 mucked
Seat 8: Player_558c99ec mucked



PokerStars Hand #3661325977: Tournament #21391319, $20+$2 - Hold'em No Limit (300/600) - 2018/04/06 23:44:14
Table '#18' Seat #5 is the button
Seat 1: Player_47e7590f (9,280 in chips)
Seat 2: Player_00724f88 (12,090 in chips)
Seat 3: Hero (8,449 in chips)
Seat 4: Player_43d0d7f7 (9,070 in chips)
Seat 5: Player_290e56f4 (20,918 in chips)
Seat 6: Player_32bbce49 (26,671 in chips)
Seat 7: Player_fc8b96ee (39,693 in chips)
Seat 8: Player_4071fb1e (17,457 in chips)
Player_47e7590f: posts the ante 60
Player_00724f88: posts the ante 60
Hero: posts the ante 60
Player_43d0d7f7: posts the ante 60
Player_290e56f4: posts the ante 60
Player_32bbce49: posts the ante 60
Player_fc8b96ee: posts the ante 60
Player_4071fb1e: posts the ante 60
Player_32bbce49: posts small blind 300
Player_fc8b96ee: posts big blind 600
*** HOLE CARDS ***
Dealt to Hero [6s 9c]
Player_4071fb1e: folds
Player_47e7590f: folds
Player_00724f88: folds
Hero: folds
Player_43d0d7f7: raises 2580 to 2580
Player_290e56f4: folds
Player_32bbce49: raises 10860 to 11160
Player_fc8b96ee: folds
Player_43d0d7f7: calls 6430 and is all-in
*** FLOP *** [Qc 9s Jh]
*** TURN *** [Qc 9s Jh] [8h]
*** RIVER *** [Qc 9s Jh 8h] [7h]
*** SHOW DOWN ***
Player_43d0d7f7: shows [Jc Jd] (three of a kind, Jacks)
Player_32bbce49: shows [Ts As] (a straight, Eight to Queen)
Uncalled bet (2150) returned to Player_32bbce49
Player_32bbce49 collected 19100 from pot
Player_43d0d7f7 finished the tournament in 148th place
*** SUMMARY ***
Total pot 19100 | Rake 0
Board [Qc 9s Jh 8h 7h]
Seat 1: Player_47e7590f mucked
Seat 2: Player_00724f88 mucked
Seat 3: Hero mucked
Seat 4: Player_43d0d7f7 showed [Jc Jd] and lost with three of a kind, Jacks
Seat 5: Player_290e56f4 (button) mucked
Seat 6: Player_32bbce49 (small blind) showed [Ts As] and won (19100) with a straight, Eight to Queen
Seat 7: Player_fc8b96ee (big blind) mucked
Seat 8: Player_4071fb1e mucked



PokerStars Hand #3661326713: Tournament #21391319, $20+$2 - Hold'em No Limit (300/600) - 2018/04/06 23:45:23
Table '#18' Seat #7 is the button
Seat 1: Player_b6279521 (9,220 in chips)
Seat 2: Player_b507f377 (12,030 in chips)
Seat 3: Hero (8,389 in chips)
Seat 4: Player_4a8aecef (20,858 in chips)
Seat 5: Player_1d42307d (36,701 in chips)
Seat 6: Player_90fa9a91 (39,033 in chips)
Seat 7: Player_071c9168 (17,397 in chips)
Player_b6279521: posts the ante 60
Player_b507f377: posts the ante 60
Hero: posts the ante 60
Player_4a8aecef: posts the ante 60
Player_1d42307d: posts the ante 60
Player_90fa9a91: posts the ante 60
Player_071c9168: posts the ante 60
Player_90fa9a91: posts small blind 300
Player_071c9168: posts big blind 600
*** HOLE CARDS ***
Dealt to Hero [9h 2c]
Player_b6279521: folds
Player_b507f377: folds
Hero: folds
Player_4a8aecef: calls 600 
Player_1d42307d: folds
Player_90fa9a91: calls 300 
Player_071c9168: checks
*** FLOP *** [Ac 7c 3c]
Player_90fa9a91: checks
Player_071c9168: checks
Player_4a8aecef: checks
*** TURN *** [Ac 7c 3c] [Ah]
Player_90fa9a91: checks
Player_071c9168: checks
Player_4a8aecef: checks
*** RIVER *** [Ac 7c 3c Ah] [Jd]
Player_90fa9a91: checks
Player_071c9168: checks
Player_4a8aecef: checks
*** SHOW DOWN ***
Player_90fa9a91: shows [6s Ts] (a pair of Aces)
Player_071c9168: shows [3s 8c] (two pair, Aces and Threes)
Player_4a8aecef: Mucks [5h 6h] (One pair)
Player_071c9168 collected 2220 from pot
*** SUMMARY ***
Total pot 2220 | Rake 0
Board [Ac 7c 3c Ah Jd]
Seat 1: Player_b6279521 mucked
Seat 2: Player_b507f377 mucked
Seat 3: Hero mucked
Seat 4: Player_4a8aecef mucked [5h 6h]
Seat 5: Player_1d42307d (button) mucked
Seat 6: Player_90fa9a91 (small blind) showed [6s Ts] and lost with a pair of Aces
Seat 7: Player_071c9168 (big blind) showed [3s 8c] and won (2220) with two pair, Aces and Threes



PokerStars Hand #3661327504: Tournament #21391319, $20+$2 - Hold'em No Limit (300/600) - 2018/04/06 23:46:35
Table '#18' Seat #8 is the button
Seat 1: Player_7cb82389 (9,160 in chips)
Seat 2: Player_7e4dcf79 (11,970 in chips)
Seat 3: Hero (8,329 in chips)
Seat 4: Player_fec98c6a (10,000 in chips)
Seat 5: Player_ada2611d (20,198 in chips)
Seat 6: Player_ae6ab046 (36,641 in chips)
Seat 7: Player_fd52b8d8 (38,373 in chips)
Seat 8: Player_95d9ca02 (18,957 in chips)
Player_7cb82389: posts the ante 60
Player_7e4dcf79: posts the ante 60
Hero: posts the ante 60
Player_fec98c6a: posts the ante 60
Player_ada2611d: posts the ante 60
Player_ae6ab046: posts the ante 60
Player_fd52b8d8: posts the ante 60
Player_95d9ca02: posts the ante 60
Player_95d9ca02: posts small blind 300
Player_7cb82389: posts big blind 600
*** HOLE CARDS ***
Dealt to Hero [3s 5s]
Player_7e4dcf79: folds
Hero: folds
Player_fec98c6a: folds
Player_ada2611d: folds
Player_ae6ab046: calls 600 
Player_fd52b8d8: raises 3011 to 3011
Player_95d9ca02: folds
Player_7cb82389: folds
Player_ae6ab046: folds
Uncalled bet (2411) returned to Player_fd52b8d8
Player_fd52b8d8: doesn't show hand
Player_fd52b8d8 collected 2580 from pot
*** SUMMARY ***
Total pot 2580 | Rake 0
Seat 1: Player_7cb82389 (big blind) mucked
Seat 2: Player_7e4dcf79 mucked
Seat 3: Hero mucked
Seat 4: Player_fec98c6a mucked
Seat 5: Player_ada2611d mucked
Seat 6: Player_ae6ab046 mucked
Seat 7: Player_fd52b8d8 (button) won (2580)
Seat 8: Player_95d9ca02 (small blind) mucked



PokerStars Hand #3661328383: Tournament #21391319, $20+$2 - Hold'em No Limit (300/600) - 2018/04/06 23:47:59
Table '#18' Seat #9 is the button
Seat 1: Player_443ede9b (8,500 in chips)
Seat 2: Player_eecce1f2 (11,910 in chips)
Seat 3: Hero (8,269 in chips)
Seat 4: Player_45035386 (9,940 in chips)
Seat 5: Player_51f36658 (20,138 in chips)
Seat 6: Player_172e3b83 (10,000 in chips)
Seat 7: Player_e333a48e (35,981 in chips)
Seat 8: Player_ecb74dc0 (40,293 in chips)
Seat 9: Player_405d7819 (18,597 in chips)
Player_443ede9b: posts the ante 60
Player_eecce1f2: posts the ante 60
Hero: posts the ante 60
Player_45035386: posts the ante 60
Player_51f36658: posts the ante 60
Player_172e3b83: posts the ante 60
Player_e333a48e: posts the ante 60
Player_ecb74dc0: posts the ante 60
Player_405d7819: posts the ante 60
Player_443ede9b: posts small blind 300
Player_eecce1f2: posts big blind 600
*** HOLE CARDS ***
Dealt to Hero [Qh 9h]
Hero: bets 8209 and is all-in
Player_45035386: folds
Player_51f36658: folds
Player_172e3b83: folds
Player_e333a48e: folds
Player_ecb74dc0: calls 8209 
Player_405d7819: folds
Player_443ede9b: folds
Player_eecce1f2: folds
*** FLOP *** [3s 2s Ah]
*** TURN *** [3s 2s Ah] [8s]
*** RIVER *** [3s 2s Ah 8s] [8d]
*** SHOW DOWN ***
Hero: shows [Qh 9h] (a pair of Eights)
Player_ecb74dc0: shows [Ac Ad] (a full house, Aces full of Eights)
Player_ecb74dc0 collected 17858 from pot
Hero finished the tournament in 139th place
*** SUMMARY ***
Total pot 17858 | Rake 0
Board [3s 2s Ah 8s 8d]
Seat 1: Player_443ede9b (small blind) mucked
Seat 2: Player_eecce1f2 (big blind) mucked
Seat 3: Hero showed [Qh 9h] and lost with a pair of Eights
Seat 4: Player_45035386 mucked
Seat 5: Player_51f36658 mucked
Seat 6: Player_172e3b83 mucked
Seat 7: Player_e333a48e mucked
Seat 8: Player_ecb74dc0 showed [Ac Ad] and won (17858) with a full house, Aces full of Eights
Seat 9: Player_405d7819 (button) mucked




