PokerStars Hand #3661260797: Tournament #21391319, $20+$2 - Hold'em No Limit (30/60) - 2018/04/06 22:06:14
Table '#18' Seat #5 is the button
Seat 1: Player_cf84d0a0 (10,000 in chips)
Seat 2: Player_5a9ca179 (9,980 in chips)
Seat 3: Hero (10,000 in chips)
Seat 4: Player_c59fb1b5 (10,000 in chips)
Seat 5: Player_12f1370c (10,020 in chips)
Seat 6: Player_a5fe7763 (10,029 in chips)
Seat 7: Player_5a085f1b (14,870 in chips)
Player_a5fe7763: posts small blind 30
Player_5a085f1b: posts big blind 60
*** HOLE CARDS ***
Dealt to Hero [Qd 7h]
Player_cf84d0a0: folds
Player_5a9ca179: folds
Hero: folds
Player_c59fb1b5: folds
Player_12f1370c: folds
Player_a5fe7763: raises 150 to 180
Player_5a085f1b: calls 120 
*** FLOP *** [Ac 4c Qh]
Player_a5fe7763: bets 200 
Player_5a085f1b: calls 200 
*** TURN *** [Ac 4c Qh] [Jh]
Player_a5fe7763: bets 400 
Player_5a085f1b: calls 400 
*** RIVER *** [Ac 4c Qh Jh] [2c]
Player_a5fe7763: bets 750 
Player_5a085f1b: calls 750 
*** SHOW DOWN ***
Player_a5fe7763: shows [Ad Jd] (two pair, Aces and Jacks)
Player_5a085f1b: Mucks [Td Ah] (One pair)
Player_a5fe7763 collected 3060 from pot
*** SUMMARY ***
Total pot 3060 | Rake 0
Board [Ac 4c Qh Jh 2c]
Seat 1: Player_cf84d0a0 mucked [4h 8s]
Seat 2: Player_5a9ca179 mucked [6h Qs]
Seat 3: Hero mucked [Qd 7h]
Seat 4: Player_c59fb1b5 mucked [5s Tc]
Seat 5: Player_12f1370c (button) mucked [6d Js]
Seat 6: Player_a5fe7763 (small blind) showed [Ad Jd] and won (3060) with two pair, Aces and Jacks
Seat 7: Player_5a085f1b (big blind) mucked [Td Ah]



PokerStars Hand #3661261701: Tournament #21391319, $20+$2 - Hold'em No Limit (30/60) - 2018/04/06 22:07:41
Table '#18' Seat #7 is the button
Seat 1: Player_fafdfcf5 (10,000 in chips)
Seat 2: Player_84dbd2b1 (9,980 in chips)
Seat 3: Hero (10,000 in chips)
Seat 4: Player_2d48bbee (10,020 in chips)
Seat 5: Player_635f43e2 (10,000 in chips)
Seat 6: Player_7da8fcc6 (10,000 in chips)
Seat 7: Player_2255d6fe (11,559 in chips)
Seat 8: Player_be1d3b72 (13,340 in chips)
Player_be1d3b72: posts small blind 30
Player_fafdfcf5: posts big blind 60
*** HOLE CARDS ***
Dealt to Hero [5h Th]
Player_84dbd2b1: folds
Hero: folds
Player_2d48bbee: folds
Player_635f43e2: folds
Player_7da8fcc6: raises 120 to 120
Player_2255d6fe: calls 120 
Player_be1d3b72: folds
Player_fafdfcf5: folds
*** FLOP *** [Jh 7h 8c]
Player_7da8fcc6: bets 60 
Player_2255d6fe: calls 60 
*** TURN *** [Jh 7h 8c] [6d]
Player_7da8fcc6: bets 60 
Player_2255d6fe: raises 222 to 222
Player_7da8fcc6: folds
Uncalled bet (162) returned to Player_2255d6fe
Player_2255d6fe: doesn't show hand
Player_2255d6fe collected 570 from pot
*** SUMMARY ***
Total pot 570 | Rake 0
Board [Jh 7h 8c 6d]
Seat 1: Player_fafdfcf5 (big blind) mucked [7s 6c]
Seat 2: Player_84dbd2b1 mucked [Jc 4h]
Seat 3: Hero mucked [5h Th]
Seat 4: Player_2d48bbee mucked [As 2h]
Seat 5: Player_635f43e2 mucked [Kc Ts]
Seat 6: Player_7da8fcc6 mucked [Ks 8d]
Seat 7: Player_2255d6fe (button) showed [4c 5c] and won (570)
Seat 8: Player_be1d3b72 (small blind) mucked [2d 5d]



PokerStars Hand #3661262348: Tournament #21391319, $20+$2 - Hold'em No Limit (30/60) - 2018/04/06 22:08:41
Table '#18' Seat #9 is the button
Seat 1: Player_862b9102 (9,940 in chips)
Seat 2: Player_b96a4fbd (9,980 in chips)
Seat 3: Hero (10,000 in chips)
Seat 4: Player_2ec220d9 (10,000 in chips)
Seat 5: Player_eee0eb43 (10,020 in chips)
Seat 6: Player_01d14569 (10,000 in chips)
Seat 7: Player_070f8dc3 (9,760 in chips)
Seat 8: Player_f9b80ae4 (11,889 in chips)
Seat 9: Player_bd4e226c (13,310 in chips)
Player_862b9102: posts small blind 30
Player_b96a4fbd: posts big blind 60
*** HOLE CARDS ***
Dealt to Hero [Ah Qs]
Hero: raises 180 to 180
Player_2ec220d9: folds
Player_eee0eb43: folds
Player_01d14569: folds
Player_070f8dc3: calls 180 
Player_f9b80ae4: folds
Player_bd4e226c: folds
Player_862b9102: calls 150 
Player_b96a4fbd: folds
*** FLOP *** [Qh 8d Jd]
Player_862b9102: checks
Hero: bets 400 
Player_070f8dc3: folds
Player_862b9102: folds
Uncalled bet (400) returned to Hero
Hero: doesn't show hand
Hero collected 600 from pot
*** SUMMARY ***
Total pot 600 | Rake 0
Board [Qh 8d Jd]
Seat 1: Player_862b9102 (small blind) mucked [4s Ks]
Seat 2: Player_b96a4fbd (big blind) mucked [9h 2s]
Seat 3: Hero showed [Ah Qs] and won (600)
Seat 4: Player_2ec220d9 mucked [Kh 2h]
Seat 5: Player_eee0eb43 mucked [2d 6d]
Seat 6: Player_01d14569 mucked [Jc Tc]
Seat 7: Player_070f8dc3 mucked [6h 4c]
Seat 8: Player_f9b80ae4 mucked [2c Th]
Seat 9: Player_bd4e226c (button) mucked [Ts Kd]



PokerStars Hand #3661263420: Tournament #21391319, $20+$2 - Hold'em No Limit (30/60) - 2018/04/06 22:10:26
Table '#18' Seat #1 is the button
Seat 1: Player_53040b2b (9,760 in chips)
Seat 2: Player_a18cad83 (9,920 in chips)
Seat 3: Hero (10,420 in chips)
Seat 4: Player_a651e6d0 (10,000 in chips)
Seat 5: Player_54cab85b (10,020 in chips)
Seat 6: Player_97085da6 (10,000 in chips)
Seat 7: Player_9fb89d46 (9,580 in chips)
Seat 8: Player_1bce1393 (11,889 in chips)
Seat 9: Player_8bcc55dc (13,310 in chips)
Player_a18cad83: posts small blind 30
Hero: posts big blind 60
*** HOLE CARDS ***
Dealt to Hero [8d 3h]
Player_a651e6d0: folds
Player_54cab85b: folds
Player_97085da6: folds
Player_9fb89d46: calls 60 
Player_1bce1393: raises 270 to 270
Player_8bcc55dc: calls 270 
Player_53040b2b: folds
Player_a18cad83: folds
Hero: folds
Player_9fb89d46: calls 210 
*** FLOP *** [2c 8s 9d]
Player_9fb89d46: checks
Player_1bce1393: bets 360 
Player_8bcc55dc: calls 360 
Player_9fb89d46: folds
*** TURN *** [2c 8s 9d] [7d]
Player_1bce1393: bets 890 
Player_8bcc55dc: folds
Uncalled bet (890) returned to Player_1bce1393
Player_1bce1393: doesn't show hand
Player_1bce1393 collected 1620 from pot
*** SUMMARY ***
Total pot 1620 | Rake 0
Board [2c 8s 9d 7d]
Seat 1: Player_53040b2b (button) mucked [5h 4c]
Seat 2: Player_a18cad83 (small blind) mucked [7s Qs]
Seat 3: Hero (big blind) mucked [8d 3h]
Seat 4: Player_a651e6d0 mucked [Ks 7h]
Seat 5: Player_54cab85b mucked [4s 6d]
Seat 6: Player_97085da6 mucked [Qd 3c]
Seat 7: Player_9fb89d46 mucked [Kc 4h]
Seat 8: Player_1bce1393 showed [9h 9s] and won (1620)
Seat 9: Player_8bcc55dc mucked [Qh As]



PokerStars Hand #3661264773: Tournament #21391319, $20+$2 - Hold'em No Limit (30/60) - 2018/04/06 22:12:35
Table '#18' Seat #2 is the button
Seat 1: Player_21bb2ac0 (9,760 in chips)
Seat 2: Player_c28cb55e (9,890 in chips)
Seat 3: Hero (10,360 in chips)
Seat 4: Player_c9c5ca88 (10,000 in chips)
Seat 5: Player_09750905 (10,020 in chips)
Seat 6: Player_8ad56630 (10,000 in chips)
Seat 7: Player_6fa92aac (9,310 in chips)
Seat 8: Player_cd2a7626 (12,879 in chips)
Seat 9: Player_f930cd71 (12,680 in chips)
Hero: posts small blind 30
Player_c9c5ca88: posts big blind 60
*** HOLE CARDS ***
Dealt to Hero [3d 9c]
Player_09750905: folds
Player_8ad56630: folds
Player_6fa92aac: raises 207 to 207
Player_cd2a7626: calls 207 
Player_f930cd71: folds
Player_21bb2ac0: folds
Player_c28cb55e: folds
Hero: folds
Player_c9c5ca88: folds
*** FLOP *** [5h Qd 4c]
Player_6fa92aac: bets 254 
Player_cd2a7626: calls 254 
*** TURN *** [5h Qd 4c] [7d]
Player_6fa92aac: bets 509 
Player_cd2a7626: calls 509 
*** RIVER *** [5h Qd 4c 7d] [Ks]
Player_6fa92aac: checks
Player_cd2a7626: checks
*** SHOW DOWN ***
Player_6fa92aac: shows [Td Ac] (high card Ace)
Player_cd2a7626: shows [Qh Jh] (a pair of Queens)
Player_cd2a7626 collected 2030 from pot
*** SUMMARY ***
Total pot 2030 | Rake 0
Board [5h Qd 4c 7d Ks]
Seat 1: Player_21bb2ac0 mucked [Qc 5s]
Seat 2: Player_c28cb55e (button) mucked [6d Jc]
Seat 3: Hero (small blind) mucked [3d 9c]
Seat 4: Player_c9c5ca88 (big blind) mucked [As 4d]
Seat 5: Player_09750905 mucked [Qs 9h]
Seat 6: Player_8ad56630 mucked [7h 6s]
Seat 7: Player_6fa92aac showed [Td Ac] and lost with high card Ace
Seat 8: Player_cd2a7626 showed [Qh Jh] and won (2030) with a pair of Queens
Seat 9: Player_f930cd71 mucked [6h 2h]



PokerStars Hand #3661265930: Tournament #21391319, $20+$2 - Hold'em No Limit (30/60) - 2018/04/06 22:14:23
Table '#18' Seat #3 is the button
Seat 1: Player_e6a05c9f (9,760 in chips)
Seat 2: Player_f56e8c7d (9,890 in chips)
Seat 3: Hero (10,330 in chips)
Seat 4: Player_908711fe (9,940 in chips)
Seat 5: Player_983aac29 (10,020 in chips)
Seat 6: Player_66ae7a5b (10,000 in chips)
Seat 7: Player_db90bd19 (8,340 in chips)
Seat 8: Player_06add56f (13,939 in chips)
Seat 9: Player_ad42496b (12,680 in chips)
Player_908711fe: posts small blind 30
Player_983aac29: posts big blind 60
*** HOLE CARDS ***
Dealt to Hero [6s Ks]
Player_66ae7a5b: folds
Player_db90bd19: raises 320 to 320
Player_06add56f: raises 818 to 818
Player_ad42496b: folds
Player_e6a05c9f: calls 818 
Player_f56e8c7d: folds
Hero: folds
Player_908711fe: folds
Player_983aac29: folds
Player_db90bd19: calls 498 
*** FLOP *** [4c 6h 7h]
Player_db90bd19: bets 60 
Player_06add56f: raises 1418 to 1418
Player_e6a05c9f: folds
Player_db90bd19: folds
Uncalled bet (1358) returned to Player_06add56f
Player_06add56f: doesn't show hand
Player_06add56f collected 2664 from pot
*** SUMMARY ***
Total pot 2664 | Rake 0
Board [4c 6h 7h]
Seat 1: Player_e6a05c9f mucked [8d Ac]
Seat 2: Player_f56e8c7d mucked [4d 7s]
Seat 3: Hero (button) mucked [6s Ks]
Seat 4: Player_908711fe (small blind) mucked [Td 9d]
Seat 5: Player_983aac29 (big blind) mucked [6d 2c]
Seat 6: Player_66ae7a5b mucked [Jc 2h]
Seat 7: Player_db90bd19 mucked [Jd Kd]
Seat 8: Player_06add56f showed [Qd Qh] and won (2664)
Seat 9: Player_ad42496b mucked [Ts 6c]



PokerStars Hand #3661267605: Tournament #21391319, $20+$2 - Hold'em No Limit (40/80) - 2018/04/06 22:16:56
Table '#18' Seat #4 is the button
Seat 1: Player_f9cbd9c2 (8,942 in chips)
Seat 2: Player_a333e7be (9,890 in chips)
Seat 3: Hero (10,330 in chips)
Seat 4: Player_ae9105ab (9,910 in chips)
Seat 5: Player_e877c2b2 (9,960 in chips)
Seat 6: Player_9bc77975 (10,000 in chips)
Seat 7: Player_84d91a89 (7,462 in chips)
Seat 8: Player_45d961ca (15,725 in chips)
Seat 9: Player_2dbf76ff (12,680 in chips)
Player_e877c2b2: posts small blind 40
Player_9bc77975: posts big blind 80
*** HOLE CARDS ***
Dealt to Hero [Ts 4s]
Player_84d91a89: calls 80 
Player_45d961ca: folds
Player_2dbf76ff: calls 80 
Player_f9cbd9c2: folds
Player_a333e7be: folds
Hero: folds
Player_ae9105ab: folds
Player_e877c2b2: calls 40 
Player_9bc77975: folds
*** FLOP *** [5c 5d Qh]
Player_e877c2b2: checks
Player_84d91a89: checks
Player_2dbf76ff: checks
*** TURN *** [5c 5d Qh] [Ac]
Player_e877c2b2: checks
Player_84d91a89: bets 80 
Player_2dbf76ff: folds
Player_e877c2b2: folds
Uncalled bet (80) returned to Player_84d91a89
Player_84d91a89: doesn't show hand
Player_84d91a89 collected 320 from pot
*** SUMMARY ***
Total pot 320 | Rake 0
Board [5c 5d Qh Ac]
Seat 1: Player_f9cbd9c2 mucked [7d 6c]
Seat 2: Player_a333e7be mucked [9h Jd]
Seat 3: Hero mucked [Ts 4s]
Seat 4: Player_ae9105ab (button) mucked [Qc 5s]
Seat 5: Player_e877c2b2 (small blind) mucked [Kd 8c]
Seat 6: Player_9bc77975 (big blind) mucked [8d Ks]
Seat 7: Player_84d91a89 showed [5h Js] and won (320)
Seat 8: Player_45d961ca mucked [3d 4d]
Seat 9: Player_2dbf76ff mucked [2c 2d]



PokerStars Hand #3661268213: Tournament #21391319, $20+$2 - Hold'em No Limit (40/80) - 2018/04/06 22:17:50
Table '#18' Seat #5 is the button
Seat 1: Player_012d02a8 (8,942 in chips)
Seat 2: Player_cbfcc039 (9,890 in chips)
Seat 3: Hero (10,330 in chips)
Seat 4: Player_b851a29e (9,910 in chips)
Seat 5: Player_9415fecb (9,880 in chips)
Seat 6: Player_5866d0ce (9,920 in chips)
Seat 7: Player_d474ac2b (7,702 in chips)
Seat 8: Player_d1ce096b (15,725 in chips)
Seat 9: Player_e3d07161 (12,600 in chips)
Player_5866d0ce: posts small blind 40
Player_d474ac2b: posts big blind 80
*** HOLE CARDS ***
Dealt to Hero [4h Qc]
Player_d1ce096b: folds
Player_e3d07161: folds
Player_012d02a8: calls 80 
Player_cbfcc039: folds
Hero: folds
Player_b851a29e: folds
Player_9415fecb: calls 80 
Player_5866d0ce: folds
Player_d474ac2b: checks
*** FLOP *** [Ah 6c 7c]
Player_d474ac2b: bets 359 
Player_012d02a8: calls 359 
Player_9415fecb: folds
*** TURN *** [Ah 6c 7c] [Qh]
Player_d474ac2b: bets 486 
Player_012d02a8: raises 1640 to 1640
Player_d474ac2b: folds
*** SHOW DOWN ***
Player_012d02a8: shows [As 7h] (two pair, Aces and Sevens)
Uncalled bet (1154) returned to Player_012d02a8
Player_012d02a8 collected 1970 from pot
*** SUMMARY ***
Total pot 1970 | Rake 0
Board [Ah 6c 7c Qh]
Seat 1: Player_012d02a8 showed [As 7h] and won (1970) with two pair, Aces and Sevens
Seat 2: Player_cbfcc039 mucked [6h 4d]
Seat 3: Hero mucked [4h Qc]
Seat 4: Player_b851a29e mucked [3c 8h]
Seat 5: Player_9415fecb (button) mucked [Td Kd]
Seat 6: Player_5866d0ce (small blind) mucked [3s 8s]
Seat 7: Player_d474ac2b (big blind) mucked [2d Ac]
Seat 8: Player_d1ce096b mucked [Ad 2c]
Seat 9: Player_e3d07161 mucked [7s 4c]



PokerStars Hand #3661268828: Tournament #21391319, $20+$2 - Hold'em No Limit (40/80) - 2018/04/06 22:18:47
Table '#18' Seat #6 is the button
Seat 1: Player_856d2594 (9,987 in chips)
Seat 2: Player_d447f6c1 (9,890 in chips)
Seat 3: Hero (10,330 in chips)
Seat 4: Player_c2fefe78 (9,910 in chips)
Seat 5: Player_5795f0d4 (9,800 in chips)
Seat 6: Player_a3e39084 (9,880 in chips)
Seat 7: Player_f7606709 (6,777 in chips)
Seat 8: Player_4cc5cf99 (15,725 in chips)
Seat 9: Player_fbdedd58 (12,600 in chips)
Player_f7606709: posts small blind 40
Player_4cc5cf99: posts big blind 80
*** HOLE CARDS ***
Dealt to Hero [5d 4c]
Player_fbdedd58: folds
Player_856d2594: folds
Player_d447f6c1: folds
Hero: folds
Player_c2fefe78: raises 280 to 280
Player_5795f0d4: folds
Player_a3e39084: folds
Player_f7606709: calls 240 
Player_4cc5cf99: raises 1040 to 1120
Player_c2fefe78: calls 840 
Player_f7606709: calls 840 
*** FLOP *** [As 2c Kh]
Player_f7606709: bets 80 
Player_4cc5cf99: calls 80 
Player_c2fefe78: calls 80 
*** TURN *** [As 2c Kh] [Jc]
Player_f7606709: bets 478 
Player_4cc5cf99: folds
Player_c2fefe78: calls 478 
*** RIVER *** [As 2c Kh Jc] [2d]
Player_f7606709: bets 1401 
Player_c2fefe78: folds
Uncalled bet (1401) returned to Player_f7606709
Player_f7606709: doesn't show hand
Player_f7606709 collected 4556 from pot
*** SUMMARY ***
Total pot 4556 | Rake 0
Board [As 2c Kh Jc 2d]
Seat 1: Player_856d2594 mucked [4d 9d]
Seat 2: Player_d447f6c1 mucked [8c Th]
Seat 3: Hero mucked [5d 4c]
Seat 4: Player_c2fefe78 mucked [Qc 9c]
Seat 5: Player_5795f0d4 mucked [Kc 8h]
Seat 6: Player_a3e39084 (button) mucked [5c 8s]
Seat 7: Player_f7606709 (small blind) showed [Ks 6c] and won (4556)
Seat 8: Player_4cc5cf99 (big blind) mucked [Ts Td]
Seat 9: Player_fbdedd58 mucked [2s Js]



PokerStars Hand #3661269645: Tournament #21391319, $20+$2 - Hold'em No Limit (40/80) - 2018/04/06 22:19:59
Table '#18' Seat #7 is the button
Seat 1: Player_23db6a6e (9,987 in chips)
Seat 2: Player_5e85451b (9,890 in chips)
Seat 3: Hero (10,330 in chips)
Seat 4: Player_3dd4734c (8,232 in chips)
Seat 5: Player_3d652b29 (9,800 in chips)
Seat 6: Player_e2090091 (9,880 in chips)
Seat 7: Player_02102e45 (9,655 in chips)
Seat 8: Player_dd88ff70 (14,525 in chips)
Seat 9: Player_387428d7 (12,600 in chips)
Player_dd88ff70: posts small blind 40
Player_387428d7: posts big blind 80
*** HOLE CARDS ***
Dealt to Hero [9c 8c]
Player_23db6a6e: calls 80 
Player_5e85451b: folds
Hero: raises 320 to 320
Player_3dd4734c: folds
Player_3d652b29: folds
Player_e2090091: folds
Player_02102e45: calls 320 
Player_dd88ff70: folds
Player_387428d7: folds
Player_23db6a6e: calls 240 
*** FLOP *** [Ts 6s Jd]
Player_23db6a6e: checks
Hero: checks
Player_02102e45: checks
*** TURN *** [Ts 6s Jd] [5h]
Player_23db6a6e: checks
Hero: checks
Player_02102e45: checks
*** RIVER *** [Ts 6s Jd 5h] [Ks]
Player_23db6a6e: checks
Hero: checks
Player_02102e45: checks
*** SHOW DOWN ***
Player_23db6a6e: shows [2s Ac] (high card Ace)
Hero: Mucks [9c 8c] (High Card)
Player_02102e45: shows [9h Kh] (a pair of Kings)
Player_02102e45 collected 1080 from pot
*** SUMMARY ***
Total pot 1080 | Rake 0
Board [Ts 6s Jd 5h Ks]
Seat 1: Player_23db6a6e showed [2s Ac] and lost with high card Ace
Seat 2: Player_5e85451b mucked [4s Jh]
Seat 3: Hero mucked [9c 8c]
Seat 4: Player_3dd4734c mucked [8d Tc]
Seat 5: Player_3d652b29 mucked [5d 9d]
Seat 6: Player_e2090091 mucked [7s Th]
Seat 7: Player_02102e45 (button) showed [9h Kh] and won (1080) with a pair of Kings
Seat 8: Player_dd88ff70 (small blind) mucked [5c 4d]
Seat 9: Player_387428d7 (big blind) mucked [7d Qd]



PokerStars Hand #3661271006: Tournament #21391319, $20+$2 - Hold'em No Limit (40/80) - 2018/04/06 22:22:02
Table '#18' Seat #8 is the button
Seat 1: Player_6cf4011c (9,667 in chips)
Seat 2: Player_c46778c3 (9,890 in chips)
Seat 3: Hero (10,010 in chips)
Seat 4: Player_a82c45d2 (8,232 in chips)
Seat 5: Player_8a8d47f5 (9,800 in chips)
Seat 6: Player_7c805498 (9,880 in chips)
Seat 7: Player_a1e1debf (10,415 in chips)
Seat 8: Player_e349cc5f (14,485 in chips)
Seat 9: Player_07d72e38 (12,520 in chips)
Player_07d72e38: posts small blind 40
Player_6cf4011c: posts big blind 80
*** HOLE CARDS ***
Dealt to Hero [As 2c]
Player_c46778c3: folds
Hero: folds
Player_a82c45d2: folds
Player_8a8d47f5: folds
Player_7c805498: folds
Player_a1e1debf: calls 80 
Player_e349cc5f: folds
Player_07d72e38: folds
Player_6cf4011c: checks
*** FLOP *** [Js Th 6d]
Player_6cf4011c: checks
Player_a1e1debf: checks
*** TURN *** [Js Th 6d] [Ah]
Player_6cf4011c: checks
Player_a1e1debf: checks
*** RIVER *** [Js Th 6d Ah] [4c]
Player_6cf4011c: checks
Player_a1e1debf: checks
*** SHOW DOWN ***
Player_6cf4011c: shows [3d 8h] (high card Ace)
Player_a1e1debf: Mucks [7d 2s] (High Card)
Player_6cf4011c collected 200 from pot
*** SUMMARY ***
Total pot 200 | Rake 0
Board [Js Th 6d Ah 4c]
Seat 1: Player_6cf4011c (big blind) showed [3d 8h] and won (200) with high card Ace
Seat 2: Player_c46778c3 mucked [Jh Qd]
Seat 3: Hero mucked [As 2c]
Seat 4: Player_a82c45d2 mucked [Ts 3s]
Seat 5: Player_8a8d47f5 mucked [7c 4s]
Seat 6: Player_7c805498 mucked [Ad Qs]
Seat 7: Player_a1e1debf mucked [7d 2s]
Seat 8: Player_e349cc5f (button) mucked [2d 3c]
Seat 9: Player_07d72e38 (small blind) mucked [3h 9d]



PokerStars Hand #3661271715: Tournament #21391319, $20+$2 - Hold'em No Limit (40/80) - 2018/04/06 22:23:05
Table '#18' Seat #9 is the button
Seat 1: Player_f83cb4d0 (9,787 in chips)
Seat 2: Player_d9b77c67 (9,890 in chips)
Seat 3: Hero (10,010 in chips)
Seat 4: Player_3972067b (8,232 in chips)
Seat 5: Player_d96f9cb8 (9,800 in chips)
Seat 6: Player_dd424129 (9,880 in chips)
Seat 7: Player_d204bb47 (10,335 in chips)
Seat 8: Player_6ad3cb91 (14,485 in chips)
Seat 9: Player_76d647b8 (12,480 in chips)
Player_f83cb4d0: posts small blind 40
Player_d9b77c67: posts big blind 80
*** HOLE CARDS ***
Dealt to Hero [Ts 8s]
Hero: raises 180 to 180
Player_3972067b: calls 180 
Player_d96f9cb8: calls 180 
Player_dd424129: folds
Player_d204bb47: folds
Player_6ad3cb91: calls 180 
Player_76d647b8: folds
Player_f83cb4d0: folds
Player_d9b77c67: calls 100 
*** FLOP *** [9h Qc 6s]
Player_d9b77c67: checks
Hero: bets 500 
Player_3972067b: raises 1000 to 1000
Player_d96f9cb8: folds
Player_6ad3cb91: folds
Player_d9b77c67: raises 2500 to 2500
Hero: folds
Player_3972067b: raises 7052 to 8052 and is all-in
Player_d9b77c67: calls 5552 
*** TURN *** [9h Qc 6s] [5h]
*** RIVER *** [9h Qc 6s 5h] [Kc]
*** SHOW DOWN ***
Player_d9b77c67: shows [9d 6d] (two pair, Nines and Sixes)
Player_3972067b: shows [Js Jc] (a pair of Jacks)
Player_d9b77c67 collected 17544 from pot
Player_3972067b finished the tournament in 102nd place
*** SUMMARY ***
Total pot 17544 | Rake 0
Board [9h Qc 6s 5h Kc]
Seat 1: Player_f83cb4d0 (small blind) mucked [8d 3c]
Seat 2: Player_d9b77c67 (big blind) showed [9d 6d] and won (17544) with two pair, Nines and Sixes
Seat 3: Hero mucked [Ts 8s]
Seat 4: Player_3972067b showed [Js Jc] and lost with a pair of Jacks
Seat 5: Player_d96f9cb8 mucked [Tc Ah]
Seat 6: Player_dd424129 mucked [4h Ks]
Seat 7: Player_d204bb47 mucked [3h 5c]
Seat 8: Player_6ad3cb91 mucked [9s 8c]
Seat 9: Player_76d647b8 (button) mucked [2c 5s]



PokerStars Hand #3661273462: Tournament #21391319, $20+$2 - Hold'em No Limit (50/100) - 2018/04/06 22:25:44
Table '#18' Seat #1 is the button
Seat 1: Player_5cedde33 (9,747 in chips)
Seat 2: Player_e7e49dd0 (19,202 in chips)
Seat 3: Hero (9,330 in chips)
Seat 4: Player_382eb173 (9,620 in chips)
Seat 5: Player_8cb1bb9b (9,880 in chips)
Seat 6: Player_1399331c (10,335 in chips)
Seat 7: Player_961c9c6a (14,305 in chips)
Seat 8: Player_7360d414 (12,480 in chips)
Player_e7e49dd0: posts small blind 50
Hero: posts big blind 100
*** HOLE CARDS ***
Dealt to Hero [3d 8c]
Player_382eb173: folds
Player_8cb1bb9b: folds
Player_1399331c: folds
Player_961c9c6a: folds
Player_7360d414: folds
Player_5cedde33: calls 100 
Player_e7e49dd0: calls 50 
Hero: checks
*** FLOP *** [Ks Ah Qs]
Player_e7e49dd0: bets 150 
Hero: folds
Player_5cedde33: calls 150 
*** TURN *** [Ks Ah Qs] [4c]
Player_e7e49dd0: checks
Player_5cedde33: checks
*** RIVER *** [Ks Ah Qs 4c] [9d]
Player_e7e49dd0: bets 150 
Player_5cedde33: folds
Uncalled bet (150) returned to Player_e7e49dd0
Player_e7e49dd0: doesn't show hand
Player_e7e49dd0 collected 600 from pot
*** SUMMARY ***
Total pot 600 | Rake 0
Board [Ks Ah Qs 4c 9d]
Seat 1: Player_5cedde33 (button) mucked [Js 6s]
Seat 2: Player_e7e49dd0 (small blind) showed [Jh Ad] and won (600)
Seat 3: Hero (big blind) mucked [3d 8c]
Seat 4: Player_382eb173 mucked [Jc 3c]
Seat 5: Player_8cb1bb9b mucked [Qd 6d]
Seat 6: Player_1399331c mucked [Td 6h]
Seat 7: Player_961c9c6a mucked [8s 2c]
Seat 8: Player_7360d414 mucked [9h 4h]



PokerStars Hand #3661274519: Tournament #21391319, $20+$2 - Hold'em No Limit (50/100) - 2018/04/06 22:27:17
Table '#18' Seat #2 is the button
Seat 1: Player_f68c0274 (9,497 in chips)
Seat 2: Player_dadf9e5b (19,552 in chips)
Seat 3: Hero (9,230 in chips)
Seat 4: Player_fb22a422 (9,620 in chips)
Seat 5: Player_9e477c30 (9,880 in chips)
Seat 6: Player_d83d3d54 (10,335 in chips)
Seat 7: Player_3f408e17 (14,305 in chips)
Seat 8: Player_e429e588 (12,480 in chips)
Hero: posts small blind 50
Player_fb22a422: posts big blind 100
*** HOLE CARDS ***
Dealt to Hero [Qs 7c]
Player_9e477c30: folds
Player_d83d3d54: raises 200 to 200
Player_3f408e17: folds
Player_e429e588: folds
Player_f68c0274: calls 200 
Player_dadf9e5b: folds
Hero: folds
Player_fb22a422: calls 100 
*** FLOP *** [4s 5h Ks]
Player_fb22a422: checks
Player_d83d3d54: bets 797 
Player_f68c0274: folds
Player_fb22a422: calls 797 
*** TURN *** [4s 5h Ks] [7d]
Player_fb22a422: checks
Player_d83d3d54: bets 930 
Player_fb22a422: calls 930 
*** RIVER *** [4s 5h Ks 7d] [Ah]
Player_fb22a422: checks
Player_d83d3d54: checks
*** SHOW DOWN ***
Player_fb22a422: shows [2h Kh] (a pair of Kings)
Player_d83d3d54: shows [Jh Kc] (a pair of Kings)
Player_d83d3d54 collected 4104 from pot
*** SUMMARY ***
Total pot 4104 | Rake 0
Board [4s 5h Ks 7d Ah]
Seat 1: Player_f68c0274 mucked [Qc Ts]
Seat 2: Player_dadf9e5b (button) mucked [3c 9d]
Seat 3: Hero (small blind) mucked [Qs 7c]
Seat 4: Player_fb22a422 (big blind) showed [2h Kh] and lost with a pair of Kings
Seat 5: Player_9e477c30 mucked [9c 8c]
Seat 6: Player_d83d3d54 showed [Jh Kc] and won (4104) with a pair of Kings
Seat 7: Player_3f408e17 mucked [5s 4d]
Seat 8: Player_e429e588 mucked [2c 3d]



PokerStars Hand #3661275691: Tournament #21391319, $20+$2 - Hold'em No Limit (50/100) - 2018/04/06 22:29:02
Table '#18' Seat #3 is the button
Seat 1: Player_8268d4f0 (9,297 in chips)
Seat 2: Player_dace6371 (19,552 in chips)
Seat 3: Hero (9,180 in chips)
Seat 4: Player_e425ca45 (7,693 in chips)
Seat 5: Player_602f1249 (9,880 in chips)
Seat 6: Player_7a790a7b (12,512 in chips)
Seat 7: Player_c2e13553 (14,305 in chips)
Seat 8: Player_fa5054fd (12,480 in chips)
Player_e425ca45: posts small blind 50
Player_602f1249: posts big blind 100
*** HOLE CARDS ***
Dealt to Hero [8s 5d]
Player_7a790a7b: calls 100 
Player_c2e13553: raises 400 to 400
Player_fa5054fd: folds
Player_8268d4f0: calls 400 
Player_dace6371: folds
Hero: folds
Player_e425ca45: folds
Player_602f1249: folds
Player_7a790a7b: calls 300 
*** FLOP *** [9s 2s 6s]
Player_7a790a7b: bets 538 
Player_c2e13553: folds
Player_8268d4f0: calls 538 
*** TURN *** [9s 2s 6s] [7d]
Player_7a790a7b: bets 1143 
Player_8268d4f0: calls 1143 
*** RIVER *** [9s 2s 6s 7d] [3h]
Player_7a790a7b: bets 1554 
Player_8268d4f0: calls 1554 
*** SHOW DOWN ***
Player_7a790a7b: shows [4h 9h] (a pair of Nines)
Player_8268d4f0: shows [Kc 9c] (a pair of Nines)
Player_8268d4f0 collected 7820 from pot
*** SUMMARY ***
Total pot 7820 | Rake 0
Board [9s 2s 6s 7d 3h]
Seat 1: Player_8268d4f0 showed [Kc 9c] and won (7820) with a pair of Nines
Seat 2: Player_dace6371 mucked [Qs Th]
Seat 3: Hero (button) mucked [8s 5d]
Seat 4: Player_e425ca45 (small blind) mucked [5h 2d]
Seat 5: Player_602f1249 (big blind) mucked [Qc Jc]
Seat 6: Player_7a790a7b showed [4h 9h] and lost with a pair of Nines
Seat 7: Player_c2e13553 mucked [Kd Jh]
Seat 8: Player_fa5054fd mucked [Ks 8c]



PokerStars Hand #3661276545: Tournament #21391319, $20+$2 - Hold'em No Limit (50/100) - 2018/04/06 22:30:20
Table '#18' Seat #4 is the button
Seat 1: Player_73bd839f (13,482 in chips)
Seat 2: Player_546ea2aa (19,552 in chips)
Seat 3: Hero (9,180 in chips)
Seat 4: Player_76d813c3 (7,643 in chips)
Seat 5: Player_35a75e67 (9,780 in chips)
Seat 6: Player_1897d926 (8,877 in chips)
Seat 7: Player_62b1e0f9 (13,905 in chips)
Seat 8: Player_3895a7eb (12,480 in chips)
Player_35a75e67: posts small blind 50
Player_1897d926: posts big blind 100
*** HOLE CARDS ***
Dealt to Hero [7s 4s]
Player_62b1e0f9: folds
Player_3895a7eb: folds
Player_73bd839f: folds
Player_546ea2aa: raises 300 to 300
Hero: folds
Player_76d813c3: calls 300 
Player_35a75e67: folds
Player_1897d926: folds
*** FLOP *** [Jc Td 7h]
Player_546ea2aa: bets 300 
Player_76d813c3: calls 300 
*** TURN *** [Jc Td 7h] [As]
Player_546ea2aa: checks
Player_76d813c3: checks
*** RIVER *** [Jc Td 7h As] [Jh]
Player_546ea2aa: bets 420 
Player_76d813c3: calls 420 
*** SHOW DOWN ***
Player_546ea2aa: shows [Kc Qs] (a straight, Ten to Ace)
Player_76d813c3: Mucks [Tc Kh] (Two pair)
Player_546ea2aa collected 2190 from pot
*** SUMMARY ***
Total pot 2190 | Rake 0
Board [Jc Td 7h As Jh]
Seat 1: Player_73bd839f mucked [3s 9s]
Seat 2: Player_546ea2aa showed [Kc Qs] and won (2190) with a straight, Ten to Ace
Seat 3: Hero mucked [7s 4s]
Seat 4: Player_76d813c3 (button) mucked [Tc Kh]
Seat 5: Player_35a75e67 (small blind) mucked [Qc 4d]
Seat 6: Player_1897d926 (big blind) mucked [9c 5h]
Seat 7: Player_62b1e0f9 mucked [Th Jd]
Seat 8: Player_3895a7eb mucked [5c 8d]



PokerStars Hand #3661277240: Tournament #21391319, $20+$2 - Hold'em No Limit (50/100) - 2018/04/06 22:31:23
Table '#18' Seat #5 is the button
Seat 1: Player_d2952aaf (13,482 in chips)
Seat 2: Player_4bc92835 (20,722 in chips)
Seat 3: Hero (9,180 in chips)
Seat 4: Player_b19fe3ce (6,623 in chips)
Seat 5: Player_cc576633 (9,730 in chips)
Seat 6: Player_00058833 (8,777 in chips)
Seat 7: Player_63b0bb28 (13,905 in chips)
Seat 8: Player_3288322e (12,480 in chips)
Player_00058833: posts small blind 50
Player_63b0bb28: posts big blind 100
*** HOLE CARDS ***
Dealt to Hero [8c Ks]
Player_3288322e: folds
Player_d2952aaf: folds
Player_4bc92835: folds
Hero: folds
Player_b19fe3ce: folds
Player_cc576633: folds
Player_00058833: folds
Player_63b0bb28: doesn't show hand
Uncalled bet (100) returned to Player_63b0bb28
Player_63b0bb28 collected 50 from pot
*** SUMMARY ***
Total pot 50 | Rake 0
Seat 1: Player_d2952aaf mucked [Ah Kh]
Seat 2: Player_4bc92835 mucked [4s Qd]
Seat 3: Hero mucked [8c Ks]
Seat 4: Player_b19fe3ce mucked [6s 4h]
Seat 5: Player_cc576633 (button) mucked [Qs 5c]
Seat 6: Player_00058833 (small blind) mucked [2c 7d]
Seat 7: Player_63b0bb28 (big blind) showed [Jc Qh] and won (50)
Seat 8: Player_3288322e mucked [Kc 2h]



PokerStars Hand #3661277747: Tournament #21391319, $20+$2 - Hold'em No Limit (50/100) - 2018/04/06 22:32:11
Table '#18' Seat #6 is the button
Seat 1: Player_ba46a89e (13,482 in chips)
Seat 2: Player_8e25bf10 (20,722 in chips)
Seat 3: Hero (9,180 in chips)
Seat 4: Player_cafee8c6 (6,623 in chips)
Seat 5: Player_7df3b2d7 (9,730 in chips)
Seat 6: Player_f183e914 (8,727 in chips)
Seat 7: Player_c737d214 (13,955 in chips)
Seat 8: Player_94374395 (12,480 in chips)
Player_c737d214: posts small blind 50
Player_94374395: posts big blind 100
*** HOLE CARDS ***
Dealt to Hero [As Jh]
Player_ba46a89e: folds
Player_8e25bf10: folds
Hero: raises 300 to 300
Player_cafee8c6: folds
Player_7df3b2d7: folds
Player_f183e914: folds
Player_c737d214: calls 250 
Player_94374395: folds
*** FLOP *** [5h 5d 7c]
Player_c737d214: checks
Hero: checks
*** TURN *** [5h 5d 7c] [6c]
Player_c737d214: bets 300 
Hero: calls 300 
*** RIVER *** [5h 5d 7c 6c] [4h]
Player_c737d214: bets 1000 
Hero: folds
Uncalled bet (1000) returned to Player_c737d214
Player_c737d214: doesn't show hand
Player_c737d214 collected 1300 from pot
*** SUMMARY ***
Total pot 1300 | Rake 0
Board [5h 5d 7c 6c 4h]
Seat 1: Player_ba46a89e mucked [9h Kc]
Seat 2: Player_8e25bf10 mucked [3h 7s]
Seat 3: Hero mucked [As Jh]
Seat 4: Player_cafee8c6 mucked [4c 6s]
Seat 5: Player_7df3b2d7 mucked [9d 4s]
Seat 6: Player_f183e914 (button) mucked [Qs 2d]
Seat 7: Player_c737d214 (small blind) showed [Ts Ad] and won (1300)
Seat 8: Player_94374395 (big blind) mucked [Ks Th]



PokerStars Hand #3661278554: Tournament #21391319, $20+$2 - Hold'em No Limit (50/100) - 2018/04/06 22:33:26
Table '#18' Seat #7 is the button
Seat 1: Player_4ede2ee0 (13,482 in chips)
Seat 2: Player_6193e39e (20,722 in chips)
Seat 3: Hero (8,580 in chips)
Seat 4: Player_8204dac8 (6,623 in chips)
Seat 5: Player_1484b5f8 (9,730 in chips)
Seat 6: Player_53ebbc74 (8,727 in chips)
Seat 7: Player_a763ac9d (14,655 in chips)
Seat 8: Player_f3a76b85 (12,380 in chips)
Player_f3a76b85: posts small blind 50
Player_4ede2ee0: posts big blind 100
*** HOLE CARDS ***
Dealt to Hero [9d 4s]
Player_6193e39e: folds
Hero: folds
Player_8204dac8: folds
Player_1484b5f8: folds
Player_53ebbc74: calls 100 
Player_a763ac9d: calls 100 
Player_f3a76b85: folds
Player_4ede2ee0: folds
*** FLOP *** [9h 5d 9c]
Player_53ebbc74: bets 100 
Player_a763ac9d: calls 100 
*** TURN *** [9h 5d 9c] [6h]
Player_53ebbc74: bets 100 
Player_a763ac9d: raises 500 to 500
Player_53ebbc74: folds
Uncalled bet (400) returned to Player_a763ac9d
Player_a763ac9d: doesn't show hand
Player_a763ac9d collected 750 from pot
*** SUMMARY ***
Total pot 750 | Rake 0
Board [9h 5d 9c 6h]
Seat 1: Player_4ede2ee0 (big blind) mucked [Ad Qs]
Seat 2: Player_6193e39e mucked [7c As]
Seat 3: Hero mucked [9d 4s]
Seat 4: Player_8204dac8 mucked [Ah 2d]
Seat 5: Player_1484b5f8 mucked [Js Jh]
Seat 6: Player_53ebbc74 mucked [8d Jc]
Seat 7: Player_a763ac9d (button) showed [8c 9s] and won (750)
Seat 8: Player_f3a76b85 (small blind) mucked [3d Jd]



PokerStars Hand #3661279293: Tournament #21391319, $20+$2 - Hold'em No Limit (50/100) - 2018/04/06 22:34:32
Table '#18' Seat #9 is the button
Seat 1: Player_f455128a (13,382 in chips)
Seat 2: Player_12d5cb81 (20,722 in chips)
Seat 3: Hero (8,580 in chips)
Seat 4: Player_b304d62a (10,000 in chips)
Seat 5: Player_76db6bc7 (6,623 in chips)
Seat 6: Player_ccf29ba8 (9,730 in chips)
Seat 7: Player_a6f98b8e (8,427 in chips)
Seat 8: Player_a2aff58d (15,105 in chips)
Seat 9: Player_ae168d39 (12,330 in chips)
Player_f455128a: posts small blind 50
Player_12d5cb81: posts big blind 100
*** HOLE CARDS ***
Dealt to Hero [6c Ah]
Hero: folds
Player_b304d62a: folds
Player_76db6bc7: raises 300 to 300
Player_ccf29ba8: folds
Player_a6f98b8e: calls 300 
Player_a2aff58d: folds
Player_ae168d39: folds
Player_f455128a: folds
Player_12d5cb81: folds
*** FLOP *** [As Kh Jc]
Player_76db6bc7: bets 200 
Player_a6f98b8e: folds
Uncalled bet (200) returned to Player_76db6bc7
Player_76db6bc7: doesn't show hand
Player_76db6bc7 collected 750 from pot
*** SUMMARY ***
Total pot 750 | Rake 0
Board [As Kh Jc]
Seat 1: Player_f455128a (small blind) mucked [3h 9s]
Seat 2: Player_12d5cb81 (big blind) mucked [3s Js]
Seat 3: Hero mucked [6c Ah]
Seat 4: Player_b304d62a mucked [5s Td]
Seat 5: Player_76db6bc7 showed [Ad Ks] and won (750)
Seat 6: Player_ccf29ba8 mucked [8d 6s]
Seat 7: Player_a6f98b8e mucked [5c 4s]
Seat 8: Player_a2aff58d mucked [2s Ac]
Seat 9: Player_ae168d39 (button) mucked [8s 9d]



PokerStars Hand #3661280038: Tournament #21391319, $20+$2 - Hold'em No Limit (75/150) - 2018/04/06 22:35:35
Table '#18' Seat #1 is the button
Seat 1: Player_6f62fc3b (13,332 in chips)
Seat 2: Player_f2df52f2 (20,622 in chips)
Seat 3: Hero (8,580 in chips)
Seat 4: Player_f879ed1f (10,000 in chips)
Seat 5: Player_3e025cfd (7,073 in chips)
Seat 6: Player_bab75542 (9,730 in chips)
Seat 7: Player_5cba6d72 (8,127 in chips)
Seat 8: Player_ebb96ecf (15,105 in chips)
Seat 9: Player_ebe4b6f4 (12,330 in chips)
Player_f2df52f2: posts small blind 75
Hero: posts big blind 150
*** HOLE CARDS ***
Dealt to Hero [Qs 7d]
Player_f879ed1f: folds
Player_3e025cfd: raises 450 to 450
Player_bab75542: folds
Player_5cba6d72: folds
Player_ebb96ecf: folds
Player_ebe4b6f4: folds
Player_6f62fc3b: folds
Player_f2df52f2: folds
Hero: folds
Uncalled bet (300) returned to Player_3e025cfd
Player_3e025cfd: doesn't show hand
Player_3e025cfd collected 375 from pot
*** SUMMARY ***
Total pot 375 | Rake 0
Seat 1: Player_6f62fc3b (button) mucked [5c 8h]
Seat 2: Player_f2df52f2 (small blind) mucked [4c 9s]
Seat 3: Hero (big blind) mucked [Qs 7d]
Seat 4: Player_f879ed1f mucked [Qd 2s]
Seat 5: Player_3e025cfd showed [Ac 9h] and won (375)
Seat 6: Player_bab75542 mucked [Jd 8s]
Seat 7: Player_5cba6d72 mucked [4s Kh]
Seat 8: Player_ebb96ecf mucked [Ks 3s]
Seat 9: Player_ebe4b6f4 mucked [3d 4d]



PokerStars Hand #3661280543: Tournament #21391319, $20+$2 - Hold'em No Limit (75/150) - 2018/04/06 22:36:20
Table '#18' Seat #2 is the button
Seat 1: Player_cb72e7ef (13,332 in chips)
Seat 2: Player_2e587229 (20,547 in chips)
Seat 3: Hero (8,430 in chips)
Seat 4: Player_25bd0e1c (10,000 in chips)
Seat 5: Player_acae34e4 (7,298 in chips)
Seat 6: Player_f543f7a2 (9,730 in chips)
Seat 7: Player_02f21550 (15,105 in chips)
Seat 8: Player_81c61184 (12,330 in chips)
Hero: posts small blind 75
Player_25bd0e1c: posts big blind 150
*** HOLE CARDS ***
Dealt to Hero [Td 8d]
Player_acae34e4: calls 150 
Player_f543f7a2: folds
Player_02f21550: folds
Player_81c61184: folds
Player_cb72e7ef: folds
Player_2e587229: folds
Hero: calls 75 
Player_25bd0e1c: checks
*** FLOP *** [9h 5h Js]
Hero: bets 300 
Player_25bd0e1c: calls 300 
Player_acae34e4: calls 300 
*** TURN *** [9h 5h Js] [Ac]
Hero: bets 1000 
Player_25bd0e1c: calls 1000 
Player_acae34e4: folds
*** RIVER *** [9h 5h Js Ac] [2d]
Hero: bets 3000 
Player_25bd0e1c: folds
Uncalled bet (3000) returned to Hero
Hero: doesn't show hand
Hero collected 3350 from pot
*** SUMMARY ***
Total pot 3350 | Rake 0
Board [9h 5h Js Ac 2d]
Seat 1: Player_cb72e7ef mucked [5c 2h]
Seat 2: Player_2e587229 (button) mucked [2c Qs]
Seat 3: Hero (small blind) showed [Td 8d] and won (3350)
Seat 4: Player_25bd0e1c (big blind) mucked [Ts Qd]
Seat 5: Player_acae34e4 mucked [Kc Jh]
Seat 6: Player_f543f7a2 mucked [7d 6d]
Seat 7: Player_02f21550 mucked [6s Jd]
Seat 8: Player_81c61184 mucked [4h 3d]



PokerStars Hand #3661281886: Tournament #21391319, $20+$2 - Hold'em No Limit (75/150) - 2018/04/06 22:38:20
Table '#18' Seat #3 is the button
Seat 1: Player_6c4437fc (13,332 in chips)
Seat 2: Player_2d002944 (20,547 in chips)
Seat 3: Hero (10,330 in chips)
Seat 4: Player_e4bca5f8 (8,550 in chips)
Seat 5: Player_7549ade0 (6,848 in chips)
Seat 6: Player_1179175c (9,730 in chips)
Seat 7: Player_eb7160ba (15,105 in chips)
Seat 8: Player_138ca2d0 (12,330 in chips)
Player_e4bca5f8: posts small blind 75
Player_7549ade0: posts big blind 150
*** HOLE CARDS ***
Dealt to Hero [9h 5s]
Player_1179175c: folds
Player_eb7160ba: folds
Player_138ca2d0: folds
Player_6c4437fc: folds
Player_2d002944: raises 350 to 350
Hero: folds
Player_e4bca5f8: calls 275 
Player_7549ade0: folds
*** FLOP *** [8d 2c 5h]
Player_e4bca5f8: checks
Player_2d002944: checks
*** TURN *** [8d 2c 5h] [6s]
Player_e4bca5f8: bets 425 
Player_2d002944: folds
Uncalled bet (425) returned to Player_e4bca5f8
Player_e4bca5f8: doesn't show hand
Player_e4bca5f8 collected 850 from pot
*** SUMMARY ***
Total pot 850 | Rake 0
Board [8d 2c 5h 6s]
Seat 1: Player_6c4437fc mucked [Td 8c]
Seat 2: Player_2d002944 mucked [Jc Qd]
Seat 3: Hero (button) mucked [9h 5s]
Seat 4: Player_e4bca5f8 (small blind) showed [5c Ac] and won (850)
Seat 5: Player_7549ade0 (big blind) mucked [Tc 3d]
Seat 6: Player_1179175c mucked [2h 4s]
Seat 7: Player_eb7160ba mucked [Jd 2d]
Seat 8: Player_138ca2d0 mucked [3c Jh]



PokerStars Hand #3661282910: Tournament #21391319, $20+$2 - Hold'em No Limit (75/150) - 2018/04/06 22:39:50
Table '#18' Seat #4 is the button
Seat 1: Player_08ec4d8a (13,332 in chips)
Seat 2: Player_222c9fb2 (20,197 in chips)
Seat 3: Hero (10,330 in chips)
Seat 4: Player_3e929592 (9,050 in chips)
Seat 5: Player_9e3f61e6 (6,698 in chips)
Seat 6: Player_e9098417 (9,730 in chips)
Seat 7: Player_6a83f8b3 (15,105 in chips)
Seat 8: Player_cf8a113e (12,330 in chips)
Player_9e3f61e6: posts small blind 75
Player_e9098417: posts big blind 150
*** HOLE CARDS ***
Dealt to Hero [Ah Kd]
Player_6a83f8b3: folds
Player_cf8a113e: folds
Player_08ec4d8a: folds
Player_222c9fb2: folds
Hero: raises 400 to 400
Player_3e929592: folds
Player_9e3f61e6: folds
Player_e9098417: folds
Uncalled bet (250) returned to Hero
Hero: doesn't show hand
Hero collected 375 from pot
*** SUMMARY ***
Total pot 375 | Rake 0
Seat 1: Player_08ec4d8a mucked [5s 6h]
Seat 2: Player_222c9fb2 mucked [Qs 3d]
Seat 3: Hero showed [Ah Kd] and won (375)
Seat 4: Player_3e929592 (button) mucked [Qd 6c]
Seat 5: Player_9e3f61e6 (small blind) mucked [As 7d]
Seat 6: Player_e9098417 (big blind) mucked [Jd 8c]
Seat 7: Player_6a83f8b3 mucked [Jh 9d]
Seat 8: Player_cf8a113e mucked [6d 9c]



PokerStars Hand #3661283352: Tournament #21391319, $20+$2 - Hold'em No Limit (75/150) - 2018/04/06 22:40:29
Table '#18' Seat #5 is the button
Seat 1: Player_bc50d4e2 (13,332 in chips)
Seat 2: Player_99f6eb8a (20,197 in chips)
Seat 3: Hero (10,555 in chips)
Seat 4: Player_8517da94 (9,050 in chips)
Seat 5: Player_438e474a (6,623 in chips)
Seat 6: Player_0512d078 (9,580 in chips)
Seat 7: Player_7be0773e (10,000 in chips)
Seat 8: Player_fdccf6bd (15,105 in chips)
Seat 9: Player_bc49c067 (12,330 in chips)
Player_0512d078: posts small blind 75
Player_7be0773e: posts big blind 150
*** HOLE CARDS ***
Dealt to Hero [Qc 5c]
Player_fdccf6bd: folds
Player_bc49c067: folds
Player_bc50d4e2: folds
Player_99f6eb8a: folds
Hero: folds
Player_8517da94: folds
Player_438e474a: raises 450 to 450
Player_0512d078: folds
Player_7be0773e: folds
Uncalled bet (300) returned to Player_438e474a
Player_438e474a: doesn't show hand
Player_438e474a collected 375 from pot
*** SUMMARY ***
Total pot 375 | Rake 0
Seat 1: Player_bc50d4e2 mucked [Td Kh]
Seat 2: Player_99f6eb8a mucked [Ad 5s]
Seat 3: Hero mucked [Qc 5c]
Seat 4: Player_8517da94 mucked [Tc 8d]
Seat 5: Player_438e474a (button) showed [7d 7c] and won (375)
Seat 6: Player_0512d078 (small blind) mucked [8s 3h]
Seat 7: Player_7be0773e (big blind) mucked [4h 6d]
Seat 8: Player_fdccf6bd mucked [4s Jc]
Seat 9: Player_bc49c067 mucked [2h Kc]



PokerStars Hand #3661283849: Tournament #21391319, $20+$2 - Hold'em No Limit (75/150) - 2018/04/06 22:41:14
Table '#18' Seat #6 is the button
Seat 1: Player_5bff0f38 (13,332 in chips)
Seat 2: Player_10b1ce16 (20,197 in chips)
Seat 3: Hero (10,555 in chips)
Seat 4: Player_f7e9764b (9,050 in chips)
Seat 5: Player_f3890604 (6,848 in chips)
Seat 6: Player_98cfd942 (9,505 in chips)
Seat 7: Player_485f3ade (9,850 in chips)
Seat 8: Player_000705d6 (15,105 in chips)
Seat 9: Player_22bcffd0 (12,330 in chips)
Player_485f3ade: posts small blind 75
Player_000705d6: posts big blind 150
*** HOLE CARDS ***
Dealt to Hero [3c 5h]
Player_22bcffd0: folds
Player_5bff0f38: folds
Player_10b1ce16: raises 350 to 350
Hero: folds
Player_f7e9764b: folds
Player_f3890604: folds
Player_98cfd942: folds
Player_485f3ade: folds
Player_000705d6: calls 200 
*** FLOP *** [8d 6h Qc]
Player_000705d6: checks
Player_10b1ce16: bets 325 
Player_000705d6: calls 325 
*** TURN *** [8d 6h Qc] [Qs]
Player_000705d6: checks
Player_10b1ce16: bets 600 
Player_000705d6: folds
Uncalled bet (600) returned to Player_10b1ce16
Player_10b1ce16: doesn't show hand
Player_10b1ce16 collected 1425 from pot
*** SUMMARY ***
Total pot 1425 | Rake 0
Board [8d 6h Qc Qs]
Seat 1: Player_5bff0f38 mucked [Kc 7h]
Seat 2: Player_10b1ce16 showed [Kh Qd] and won (1425)
Seat 3: Hero mucked [3c 5h]
Seat 4: Player_f7e9764b mucked [Jh 4d]
Seat 5: Player_f3890604 mucked [9c Js]
Seat 6: Player_98cfd942 (button) mucked [3d 6c]
Seat 7: Player_485f3ade (small blind) mucked [3s 4h]
Seat 8: Player_000705d6 (big blind) mucked [7c 9h]
Seat 9: Player_22bcffd0 mucked [2d 8c]



PokerStars Hand #3661284499: Tournament #21391319, $20+$2 - Hold'em No Limit (75/150) - 2018/04/06 22:42:11
Table '#18' Seat #7 is the button
Seat 1: Player_186a58b1 (13,332 in chips)
Seat 2: Player_a63f7bdb (20,947 in chips)
Seat 3: Hero (10,555 in chips)
Seat 4: Player_ff874b77 (9,050 in chips)
Seat 5: Player_bba63afb (6,848 in chips)
Seat 6: Player_e3c240db (9,505 in chips)
Seat 7: Player_b5ff1e5f (9,775 in chips)
Seat 8: Player_a439b069 (14,430 in chips)
Seat 9: Player_837b9ede (12,330 in chips)
Player_a439b069: posts small blind 75
Player_837b9ede: posts big blind 150
*** HOLE CARDS ***
Dealt to Hero [2d Ah]
Player_186a58b1: folds
Player_a63f7bdb: folds
Hero: folds
Player_ff874b77: folds
Player_bba63afb: folds
Player_e3c240db: folds
Player_b5ff1e5f: folds
Player_a439b069: raises 375 to 450
Player_837b9ede: folds
Uncalled bet (300) returned to Player_a439b069
Player_a439b069: doesn't show hand
Player_a439b069 collected 300 from pot
*** SUMMARY ***
Total pot 300 | Rake 0
Seat 1: Player_186a58b1 mucked [2c Jh]
Seat 2: Player_a63f7bdb mucked [8c Js]
Seat 3: Hero mucked [2d Ah]
Seat 4: Player_ff874b77 mucked [7d Ts]
Seat 5: Player_bba63afb mucked [4s 8h]
Seat 6: Player_e3c240db mucked [9d 5s]
Seat 7: Player_b5ff1e5f (button) mucked [3h 9s]
Seat 8: Player_a439b069 (small blind) showed [Kd 6d] and won (300)
Seat 9: Player_837b9ede (big blind) mucked [3s Ac]



PokerStars Hand #3661284950: Tournament #21391319, $20+$2 - Hold'em No Limit (75/150) - 2018/04/06 22:42:53
Table '#18' Seat #8 is the button
Seat 1: Player_cfb71463 (13,332 in chips)
Seat 2: Player_c7c40125 (20,947 in chips)
Seat 3: Hero (10,555 in chips)
Seat 4: Player_b17bd696 (9,050 in chips)
Seat 5: Player_1437df28 (6,848 in chips)
Seat 6: Player_e5d00ddf (9,505 in chips)
Seat 7: Player_5c4b22d0 (9,775 in chips)
Seat 8: Player_c7874640 (14,580 in chips)
Seat 9: Player_b2e835f2 (12,180 in chips)
Player_b2e835f2: posts small blind 75
Player_cfb71463: posts big blind 150
*** HOLE CARDS ***
Dealt to Hero [7s 5d]
Player_c7c40125: folds
Hero: folds
Player_b17bd696: folds
Player_1437df28: folds
Player_e5d00ddf: raises 300 to 300
Player_5c4b22d0: folds
Player_c7874640: folds
Player_b2e835f2: folds
Player_cfb71463: folds
Uncalled bet (150) returned to Player_e5d00ddf
Player_e5d00ddf: doesn't show hand
Player_e5d00ddf collected 375 from pot
*** SUMMARY ***
Total pot 375 | Rake 0
Seat 1: Player_cfb71463 (big blind) mucked [5h 2c]
Seat 2: Player_c7c40125 mucked [9s Ah]
Seat 3: Hero mucked [7s 5d]
Seat 4: Player_b17bd696 mucked [Td 7h]
Seat 5: Player_1437df28 mucked [4h 2h]
Seat 6: Player_e5d00ddf showed [Ad 7d] and won (375)
Seat 7: Player_5c4b22d0 mucked [9h 4c]
Seat 8: Player_c7874640 (button) mucked [2d Qc]
Seat 9: Player_b2e835f2 (small blind) mucked [9c Tc]



PokerStars Hand #3661285701: Tournament #21391319, $20+$2 - Hold'em No Limit (75/150) - 2018/04/06 22:43:59
Table '#18' Seat #8 is the button
Seat 1: Player_41d6b494 (13,182 in chips)
Seat 2: Player_60e15935 (20,947 in chips)
Seat 3: Hero (10,555 in chips)
Seat 4: Player_32fec2e2 (9,050 in chips)
Seat 5: Player_965856e8 (6,848 in chips)
Seat 6: Player_9b7e71c1 (9,730 in chips)
Seat 7: Player_deb3cc25 (14,580 in chips)
Seat 8: Player_8f8bb084 (12,105 in chips)
Player_41d6b494: posts small blind 75
Player_60e15935: posts big blind 150
*** HOLE CARDS ***
Dealt to Hero [3c 7d]
Hero: folds
Player_32fec2e2: folds
Player_965856e8: folds
Player_9b7e71c1: folds
Player_deb3cc25: raises 450 to 450
Player_8f8bb084: folds
Player_41d6b494: calls 375 
Player_60e15935: calls 300 
*** FLOP *** [2s 2d 5c]
Player_41d6b494: checks
Player_60e15935: bets 350 
Player_deb3cc25: folds
Player_41d6b494: calls 350 
*** TURN *** [2s 2d 5c] [5s]
Player_41d6b494: bets 500 
Player_60e15935: calls 500 
*** RIVER *** [2s 2d 5c 5s] [8s]
Player_41d6b494: bets 500 
Player_60e15935: raises 1750 to 1750
Player_41d6b494: folds
Uncalled bet (1250) returned to Player_60e15935
Player_60e15935: doesn't show hand
Player_60e15935 collected 4050 from pot
*** SUMMARY ***
Total pot 4050 | Rake 0
Board [2s 2d 5c 5s 8s]
Seat 1: Player_41d6b494 (small blind) mucked [Ad Qh]
Seat 2: Player_60e15935 (big blind) showed [Qs Td] and won (4050)
Seat 3: Hero mucked [3c 7d]
Seat 4: Player_32fec2e2 mucked [4c 5h]
Seat 5: Player_965856e8 mucked [7h Qd]
Seat 6: Player_9b7e71c1 mucked [7c 6c]
Seat 7: Player_deb3cc25 mucked [4s 7s]
Seat 8: Player_8f8bb084 (button) mucked [Jh As]



PokerStars Hand #3661290922: Tournament #21391319, $20+$2 - Hold'em No Limit (100/200) - 2018/04/06 22:51:32
Table '#18' Seat #1 is the button
Seat 1: Player_ab45b1b9 (11,382 in chips)
Seat 2: Player_10aa024a (23,197 in chips)
Seat 3: Hero (10,555 in chips)
Seat 4: Player_189aa42a (9,050 in chips)
Seat 5: Player_a9bbd923 (6,848 in chips)
Seat 6: Player_561fab2d (9,730 in chips)
Seat 7: Player_91a51e4c (10,000 in chips)
Seat 8: Player_4227406b (14,130 in chips)
Seat 9: Player_49d7b7c0 (12,105 in chips)
Player_10aa024a: posts small blind 100
Hero: posts big blind 200
*** HOLE CARDS ***
Dealt to Hero [3d 4h]
Player_189aa42a: raises 600 to 600
Player_a9bbd923: folds
Player_561fab2d: folds
Player_91a51e4c: calls 600 
Player_4227406b: folds
Player_49d7b7c0: folds
Player_ab45b1b9: calls 600 
Player_10aa024a: folds
Hero: folds
*** FLOP *** [8c 8h Ac]
Player_189aa42a: bets 1050 
Player_91a51e4c: calls 1050 
Player_ab45b1b9: folds
*** TURN *** [8c 8h Ac] [As]
Player_189aa42a: checks
Player_91a51e4c: checks
*** RIVER *** [8c 8h Ac As] [3h]
Player_189aa42a: bets 3400 
Player_91a51e4c: raises 8350 to 8350 and is all-in
Player_189aa42a: folds
Uncalled bet (4950) returned to Player_91a51e4c
Player_91a51e4c: doesn't show hand
Player_91a51e4c collected 11000 from pot
*** SUMMARY ***
Total pot 11000 | Rake 0
Board [8c 8h Ac As 3h]
Seat 1: Player_ab45b1b9 (button) mucked [Td Kc]
Seat 2: Player_10aa024a (small blind) mucked [5d 6h]
Seat 3: Hero (big blind) mucked [3d 4h]
Seat 4: Player_189aa42a mucked [7d 7s]
Seat 5: Player_a9bbd923 mucked [9c 8d]
Seat 6: Player_561fab2d mucked [2s 3c]
Seat 7: Player_91a51e4c showed [Ah Tc] and won (11000)
Seat 8: Player_4227406b mucked [6s Js]
Seat 9: Player_49d7b7c0 mucked [Jc Ks]



PokerStars Hand #3661291903: Tournament #21391319, $20+$2 - Hold'em No Limit (100/200) - 2018/04/06 22:52:56
Table '#18' Seat #2 is the button
Seat 1: Player_f0a217cf (10,782 in chips)
Seat 2: Player_0cde4dfc (23,097 in chips)
Seat 3: Hero (10,355 in chips)
Seat 4: Player_1f8b6dea (4,000 in chips)
Seat 5: Player_a102de62 (6,848 in chips)
Seat 6: Player_42d2bc8d (9,730 in chips)
Seat 7: Player_5cdf739b (15,950 in chips)
Seat 8: Player_738a190e (14,130 in chips)
Seat 9: Player_eccdd24e (12,105 in chips)
Hero: posts small blind 100
Player_1f8b6dea: posts big blind 200
*** HOLE CARDS ***
Dealt to Hero [7d Ad]
Player_a102de62: folds
Player_42d2bc8d: folds
Player_5cdf739b: folds
Player_738a190e: folds
Player_eccdd24e: folds
Player_f0a217cf: calls 200 
Player_0cde4dfc: folds
Hero: raises 700 to 800
Player_1f8b6dea: calls 600 
Player_f0a217cf: calls 600 
*** FLOP *** [3c 6h 7c]
Hero: bets 1500 
Player_1f8b6dea: raises 3200 to 3200 and is all-in
Player_f0a217cf: folds
Hero: calls 1700 
*** TURN *** [3c 6h 7c] [9c]
*** RIVER *** [3c 6h 7c 9c] [Js]
*** SHOW DOWN ***
Hero: shows [7d Ad] (a pair of Sevens)
Player_1f8b6dea: shows [2d 3d] (a pair of Threes)
Hero collected 8800 from pot
Player_1f8b6dea finished the tournament in 134th place
*** SUMMARY ***
Total pot 8800 | Rake 0
Board [3c 6h 7c 9c Js]
Seat 1: Player_f0a217cf mucked [8c Qc]
Seat 2: Player_0cde4dfc (button) mucked [3s Ah]
Seat 3: Hero (small blind) showed [7d Ad] and won (8800) with a pair of Sevens
Seat 4: Player_1f8b6dea (big blind) showed [2d 3d] and lost with a pair of Threes
Seat 5: Player_a102de62 mucked [7s 9s]
Seat 6: Player_42d2bc8d mucked [4c Ks]
Seat 7: Player_5cdf739b mucked [Jd 6c]
Seat 8: Player_738a190e mucked [2h As]
Seat 9: Player_eccdd24e mucked [Kc 2c]



PokerStars Hand #3661292973: Tournament #21391319, $20+$2 - Hold'em No Limit (100/200) - 2018/04/06 22:54:38
Table '#18' Seat #3 is the button
Seat 1: Player_454be7f2 (9,982 in chips)
Seat 2: Player_99b0c074 (23,097 in chips)
Seat 3: Hero (15,155 in chips)
Seat 4: Player_85686a5e (6,848 in chips)
Seat 5: Player_7ed8decf (9,730 in chips)
Seat 6: Player_c24f617e (15,950 in chips)
Seat 7: Player_cb2a9876 (14,130 in chips)
Seat 8: Player_8309ae61 (12,105 in chips)
Player_85686a5e: posts big blind 200
*** HOLE CARDS ***
Dealt to Hero [6d Ts]
Player_7ed8decf: folds
Player_c24f617e: folds
Player_cb2a9876: folds
Player_8309ae61: raises 600 to 600
Player_454be7f2: folds
Player_99b0c074: folds
Hero: folds
Player_85686a5e: calls 400 
*** FLOP *** [9h 8s Qc]
Player_85686a5e: checks
Player_8309ae61: bets 600 
Player_85686a5e: folds
Uncalled bet (600) returned to Player_8309ae61
Player_8309ae61: doesn't show hand
Player_8309ae61 collected 1200 from pot
*** SUMMARY ***
Total pot 1200 | Rake 0
Board [9h 8s Qc]
Seat 1: Player_454be7f2 mucked [9d 2s]
Seat 2: Player_99b0c074 mucked [3c Ks]
Seat 3: Hero (button) mucked [6d Ts]
Seat 4: Player_85686a5e (big blind) mucked [4d 4h]
Seat 5: Player_7ed8decf mucked [Qh 5s]
Seat 6: Player_c24f617e mucked [Tc 3d]
Seat 7: Player_cb2a9876 mucked [4s Ah]
Seat 8: Player_8309ae61 showed [8h 8d] and won (1200)



PokerStars Hand #3661293586: Tournament #21391319, $20+$2 - Hold'em No Limit (100/200) - 2018/04/06 22:55:35
Table '#18' Seat #4 is the button
Seat 1: Player_879235d0 (9,982 in chips)
Seat 2: Player_992ea277 (23,097 in chips)
Seat 3: Hero (15,155 in chips)
Seat 4: Player_5a6008b6 (10,000 in chips)
Seat 5: Player_f7c2806f (6,248 in chips)
Seat 6: Player_064b730d (9,730 in chips)
Seat 7: Player_7fd0bfa8 (15,950 in chips)
Seat 8: Player_74537095 (14,130 in chips)
Seat 9: Player_6c1e1852 (12,705 in chips)
Player_f7c2806f: posts small blind 100
Player_064b730d: posts big blind 200
*** HOLE CARDS ***
Dealt to Hero [As 7s]
Player_7fd0bfa8: calls 200 
Player_74537095: folds
Player_6c1e1852: folds
Player_879235d0: raises 600 to 600
Player_992ea277: folds
Hero: folds
Player_5a6008b6: calls 600 
Player_f7c2806f: folds
Player_064b730d: folds
Player_7fd0bfa8: calls 400 
*** FLOP *** [5d 8d 5h]
Player_7fd0bfa8: checks
Player_879235d0: bets 600 
Player_5a6008b6: folds
Player_7fd0bfa8: folds
*** SHOW DOWN ***
Player_879235d0: shows [Ad 7d] (a pair of Fives)
Uncalled bet (600) returned to Player_879235d0
Player_879235d0 collected 2100 from pot
*** SUMMARY ***
Total pot 2100 | Rake 0
Board [5d 8d 5h]
Seat 1: Player_879235d0 showed [Ad 7d] and won (2100) with a pair of Fives
Seat 2: Player_992ea277 mucked [6s Jh]
Seat 3: Hero mucked [As 7s]
Seat 4: Player_5a6008b6 (button) mucked [Th Qh]
Seat 5: Player_f7c2806f (small blind) mucked [5c Kc]
Seat 6: Player_064b730d (big blind) mucked [9c 4s]
Seat 7: Player_7fd0bfa8 mucked [Qs Ks]
Seat 8: Player_74537095 mucked [6c 3d]
Seat 9: Player_6c1e1852 mucked [Qc 7c]



PokerStars Hand #3661294337: Tournament #21391319, $20+$2 - Hold'em No Limit (100/200) - 2018/04/06 22:56:47
Table '#18' Seat #5 is the button
Seat 1: Player_091a46f2 (11,482 in chips)
Seat 2: Player_46a7873f (23,097 in chips)
Seat 3: Hero (15,155 in chips)
Seat 4: Player_3db0d65b (9,400 in chips)
Seat 5: Player_a0a35cd8 (6,148 in chips)
Seat 6: Player_9411ea81 (9,530 in chips)
Seat 7: Player_3effa832 (15,350 in chips)
Seat 8: Player_b0f82b59 (14,130 in chips)
Seat 9: Player_489a5d64 (12,705 in chips)
Player_9411ea81: posts small blind 100
Player_3effa832: posts big blind 200
*** HOLE CARDS ***
Dealt to Hero [Qd Ts]
Player_b0f82b59: folds
Player_489a5d64: folds
Player_091a46f2: folds
Player_46a7873f: folds
Hero: folds
Player_3db0d65b: folds
Player_a0a35cd8: folds
Player_9411ea81: folds
Player_3effa832: doesn't show hand
Uncalled bet (200) returned to Player_3effa832
Player_3effa832 collected 100 from pot
*** SUMMARY ***
Total pot 100 | Rake 0
Seat 1: Player_091a46f2 mucked [5h 4s]
Seat 2: Player_46a7873f mucked [Ad 6c]
Seat 3: Hero mucked [Qd Ts]
Seat 4: Player_3db0d65b mucked [7s 9s]
Seat 5: Player_a0a35cd8 (button) mucked [7c 3d]
Seat 6: Player_9411ea81 (small blind) mucked [8d Ks]
Seat 7: Player_3effa832 (big blind) showed [2s 9h] and won (100)
Seat 8: Player_b0f82b59 mucked [2c Js]
Seat 9: Player_489a5d64 mucked [2d Jh]



PokerStars Hand #3661294653: Tournament #21391319, $20+$2 - Hold'em No Limit (100/200) - 2018/04/06 22:57:17
Table '#18' Seat #6 is the button
Seat 1: Player_06efacc9 (11,482 in chips)
Seat 2: Player_15bd29ec (23,097 in chips)
Seat 3: Hero (15,155 in chips)
Seat 4: Player_3d716abf (9,400 in chips)
Seat 5: Player_411916f8 (6,148 in chips)
Seat 6: Player_88684da4 (9,430 in chips)
Seat 7: Player_8835275f (15,450 in chips)
Seat 8: Player_54f21e71 (14,130 in chips)
Seat 9: Player_7216cf13 (12,705 in chips)
Player_8835275f: posts small blind 100
Player_54f21e71: posts big blind 200
*** HOLE CARDS ***
Dealt to Hero [6c 4d]
Player_7216cf13: folds
Player_06efacc9: folds
Player_15bd29ec: folds
Hero: folds
Player_3d716abf: folds
Player_411916f8: folds
Player_88684da4: folds
Player_8835275f: folds
Player_54f21e71: doesn't show hand
Uncalled bet (200) returned to Player_54f21e71
Player_54f21e71 collected 100 from pot
*** SUMMARY ***
Total pot 100 | Rake 0
Seat 1: Player_06efacc9 mucked [Qh 9d]
Seat 2: Player_15bd29ec mucked [Qd Jc]
Seat 3: Hero mucked [6c 4d]
Seat 4: Player_3d716abf mucked [Tc 6s]
Seat 5: Player_411916f8 mucked [5c Th]
Seat 6: Player_88684da4 (button) mucked [3d 6d]
Seat 7: Player_8835275f (small blind) mucked [5h 3c]
Seat 8: Player_54f21e71 (big blind) showed [3h Kh] and won (100)
Seat 9: Player_7216cf13 mucked [4c 8h]



PokerStars Hand #3661295035: Tournament #21391319, $20+$2 - Hold'em No Limit (100/200) - 2018/04/06 22:57:53
Table '#18' Seat #7 is the button
Seat 1: Player_4404488c (11,482 in chips)
Seat 2: Player_23ef5069 (23,097 in chips)
Seat 3: Hero (15,155 in chips)
Seat 4: Player_b80ab804 (9,400 in chips)
Seat 5: Player_872c0975 (6,148 in chips)
Seat 6: Player_fded110e (9,430 in chips)
Seat 7: Player_2c591263 (15,350 in chips)
Seat 8: Player_a6fba31d (14,230 in chips)
Seat 9: Player_c376d611 (12,705 in chips)
Player_a6fba31d: posts small blind 100
Player_c376d611: posts big blind 200
*** HOLE CARDS ***
Dealt to Hero [Ks 4h]
Player_4404488c: folds
Player_23ef5069: folds
Hero: folds
Player_b80ab804: folds
Player_872c0975: folds
Player_fded110e: folds
Player_2c591263: folds
Player_a6fba31d: calls 100 
Player_c376d611: checks
*** FLOP *** [Ac 7c 6s]
Player_a6fba31d: bets 200 
Player_c376d611: folds
Uncalled bet (200) returned to Player_a6fba31d
Player_a6fba31d: doesn't show hand
Player_a6fba31d collected 400 from pot
*** SUMMARY ***
Total pot 400 | Rake 0
Board [Ac 7c 6s]
Seat 1: Player_4404488c mucked [9h 2d]
Seat 2: Player_23ef5069 mucked [Jc Qs]
Seat 3: Hero mucked [Ks 4h]
Seat 4: Player_b80ab804 mucked [8s Td]
Seat 5: Player_872c0975 mucked [5d 7s]
Seat 6: Player_fded110e mucked [Jh 5c]
Seat 7: Player_2c591263 (button) mucked [3d Qd]
Seat 8: Player_a6fba31d (small blind) showed [Th 3h] and won (400)
Seat 9: Player_c376d611 (big blind) mucked [8d Qh]



PokerStars Hand #3661295390: Tournament #21391319, $20+$2 - Hold'em No Limit (100/200) - 2018/04/06 22:58:26
Table '#18' Seat #8 is the button
Seat 1: Player_aa0b97f2 (11,482 in chips)
Seat 2: Player_5037433e (23,097 in chips)
Seat 3: Hero (15,155 in chips)
Seat 4: Player_2f812ef1 (9,400 in chips)
Seat 5: Player_404a805c (6,148 in chips)
Seat 6: Player_68232887 (9,430 in chips)
Seat 7: Player_7cfe5a4d (15,350 in chips)
Seat 8: Player_7ffceb18 (14,430 in chips)
Seat 9: Player_c1ebe8cc (12,505 in chips)
Player_c1ebe8cc: posts small blind 100
Player_aa0b97f2: posts big blind 200
*** HOLE CARDS ***
Dealt to Hero [6h 7c]
Player_5037433e: folds
Hero: folds
Player_2f812ef1: raises 700 to 700
Player_404a805c: folds
Player_68232887: folds
Player_7cfe5a4d: folds
Player_7ffceb18: folds
Player_c1ebe8cc: folds
Player_aa0b97f2: folds
Uncalled bet (500) returned to Player_2f812ef1
Player_2f812ef1: doesn't show hand
Player_2f812ef1 collected 500 from pot
*** SUMMARY ***
Total pot 500 | Rake 0
Seat 1: Player_aa0b97f2 (big blind) mucked [4h 5c]
Seat 2: Player_5037433e mucked [Qd 8c]
Seat 3: Hero mucked [6h 7c]
Seat 4: Player_2f812ef1 showed [Ah Ad] and won (500)
Seat 5: Player_404a805c mucked [Kh 2c]
Seat 6: Player_68232887 mucked [Td 6c]
Seat 7: Player_7cfe5a4d mucked [Jh Tc]
Seat 8: Player_7ffceb18 (button) mucked [3s 8d]
Seat 9: Player_c1ebe8cc (small blind) mucked [7s 2d]



PokerStars Hand #3661295703: Tournament #21391319, $20+$2 - Hold'em No Limit (100/200) - 2018/04/06 22:58:56
Table '#18' Seat #9 is the button
Seat 1: Player_038854f0 (11,282 in chips)
Seat 2: Player_ff0fd983 (23,097 in chips)
Seat 3: Hero (15,155 in chips)
Seat 4: Player_1ed08431 (9,700 in chips)
Seat 5: Player_5e683bfa (6,148 in chips)
Seat 6: Player_194f9005 (9,430 in chips)
Seat 7: Player_26303d26 (15,350 in chips)
Seat 8: Player_ca1ec31f (14,430 in chips)
Seat 9: Player_006768de (12,405 in chips)
Player_038854f0: posts small blind 100
Player_ff0fd983: posts big blind 200
*** HOLE CARDS ***
Dealt to Hero [4s Jh]
Hero: folds
Player_1ed08431: folds
Player_5e683bfa: raises 600 to 600
Player_194f9005: folds
Player_26303d26: folds
Player_ca1ec31f: folds
Player_006768de: folds
Player_038854f0: calls 500 
Player_ff0fd983: folds
*** FLOP *** [Tc Kc 3d]
Player_038854f0: checks
Player_5e683bfa: bets 400 
Player_038854f0: raises 1200 to 1200
Player_5e683bfa: raises 5148 to 5548 and is all-in
Player_038854f0: calls 4348 
*** TURN *** [Tc Kc 3d] [Qh]
*** RIVER *** [Tc Kc 3d Qh] [6d]
*** SHOW DOWN ***
Player_038854f0: shows [Kd Td] (two pair, Kings and Tens)
Player_5e683bfa: shows [Th Ad] (a pair of Tens)
Player_038854f0 collected 12496 from pot
Player_5e683bfa finished the tournament in 135th place
*** SUMMARY ***
Total pot 12496 | Rake 0
Board [Tc Kc 3d Qh 6d]
Seat 1: Player_038854f0 (small blind) showed [Kd Td] and won (12496) with two pair, Kings and Tens
Seat 2: Player_ff0fd983 (big blind) mucked [8h Jc]
Seat 3: Hero mucked [4s Jh]
Seat 4: Player_1ed08431 mucked [5h 9s]
Seat 5: Player_5e683bfa showed [Th Ad] and lost with a pair of Tens
Seat 6: Player_194f9005 mucked [Js Qd]
Seat 7: Player_26303d26 mucked [9c 2d]
Seat 8: Player_ca1ec31f mucked [Ac 4d]
Seat 9: Player_006768de (button) mucked [6s 5s]



PokerStars Hand #3661296440: Tournament #21391319, $20+$2 - Hold'em No Limit (100/200) - 2018/04/06 22:59:56
Table '#18' Seat #1 is the button
Seat 1: Player_290abdc0 (17,630 in chips)
Seat 2: Player_5f3e36fa (22,897 in chips)
Seat 3: Hero (15,155 in chips)
Seat 4: Player_c3b2db09 (9,700 in chips)
Seat 5: Player_d685ea7f (9,430 in chips)
Seat 6: Player_97db5598 (15,350 in chips)
Seat 7: Player_e76087ac (14,430 in chips)
Seat 8: Player_87e70955 (12,405 in chips)
Player_5f3e36fa: posts small blind 100
Hero: posts big blind 200
*** HOLE CARDS ***
Dealt to Hero [9h 5d]
Player_c3b2db09: folds
Player_d685ea7f: folds
Player_97db5598: folds
Player_e76087ac: folds
Player_87e70955: calls 200 
Player_290abdc0: folds
Player_5f3e36fa: folds
Hero: checks
*** FLOP *** [3d 5s Ks]
Hero: checks
Player_87e70955: checks
*** TURN *** [3d 5s Ks] [Th]
Hero: checks
Player_87e70955: checks
*** RIVER *** [3d 5s Ks Th] [Ah]
Hero: checks
Player_87e70955: bets 250 
Hero: folds
Uncalled bet (250) returned to Player_87e70955
Player_87e70955: doesn't show hand
Player_87e70955 collected 500 from pot
*** SUMMARY ***
Total pot 500 | Rake 0
Board [3d 5s Ks Th Ah]
Seat 1: Player_290abdc0 (button) mucked [4c Kd]
Seat 2: Player_5f3e36fa (small blind) mucked [7s 5h]
Seat 3: Hero (big blind) mucked [9h 5d]
Seat 4: Player_c3b2db09 mucked [Kc 9d]
Seat 5: Player_d685ea7f mucked [8s 4d]
Seat 6: Player_97db5598 mucked [Jd 6c]
Seat 7: Player_e76087ac mucked [5c Qd]
Seat 8: Player_87e70955 showed [Ad 2d] and won (500)



PokerStars Hand #3661297399: Tournament #21391319, $20+$2 - Hold'em No Limit (100/200) - 2018/04/06 23:01:20
Table '#18' Seat #2 is the button
Seat 1: Player_649f5226 (17,630 in chips)
Seat 2: Player_872b1cbe (22,797 in chips)
Seat 3: Hero (14,955 in chips)
Seat 4: Player_baf28a8a (9,700 in chips)
Seat 5: Player_af81e597 (10,000 in chips)
Seat 6: Player_8a6ffbd3 (9,430 in chips)
Seat 7: Player_d24e4340 (15,350 in chips)
Seat 8: Player_4cdea0d5 (14,430 in chips)
Seat 9: Player_26af2a6d (12,705 in chips)
Hero: posts small blind 100
Player_baf28a8a: posts big blind 200
*** HOLE CARDS ***
Dealt to Hero [4s 2s]
Player_af81e597: raises 600 to 600
Player_8a6ffbd3: folds
Player_d24e4340: folds
Player_4cdea0d5: folds
Player_26af2a6d: folds
Player_649f5226: folds
Player_872b1cbe: folds
Hero: folds
Player_baf28a8a: folds
Uncalled bet (400) returned to Player_af81e597
Player_af81e597: doesn't show hand
Player_af81e597 collected 500 from pot
*** SUMMARY ***
Total pot 500 | Rake 0
Seat 1: Player_649f5226 mucked [7d 9c]
Seat 2: Player_872b1cbe (button) mucked [Jh 7h]
Seat 3: Hero (small blind) mucked [4s 2s]
Seat 4: Player_baf28a8a (big blind) mucked [2h Th]
Seat 5: Player_af81e597 showed [Jc Tc] and won (500)
Seat 6: Player_8a6ffbd3 mucked [2c 7s]
Seat 7: Player_d24e4340 mucked [As 6d]
Seat 8: Player_4cdea0d5 mucked [Js 4c]
Seat 9: Player_26af2a6d mucked [6s Ah]



PokerStars Hand #3661298112: Tournament #21391319, $20+$2 - Hold'em No Limit (125/250) - 2018/04/06 23:02:23
Table '#18' Seat #3 is the button
Seat 1: Player_e9572c0b (17,630 in chips)
Seat 2: Player_3a4c9b07 (22,797 in chips)
Seat 3: Hero (14,855 in chips)
Seat 4: Player_79e9f718 (9,500 in chips)
Seat 5: Player_c4584b6f (10,300 in chips)
Seat 6: Player_0b34eaa3 (9,430 in chips)
Seat 7: Player_f4387d4e (15,350 in chips)
Seat 8: Player_54643c4a (14,430 in chips)
Seat 9: Player_da75a606 (12,705 in chips)
Player_e9572c0b: posts the ante 25
Player_3a4c9b07: posts the ante 25
Hero: posts the ante 25
Player_79e9f718: posts the ante 25
Player_c4584b6f: posts the ante 25
Player_0b34eaa3: posts the ante 25
Player_f4387d4e: posts the ante 25
Player_54643c4a: posts the ante 25
Player_da75a606: posts the ante 25
Player_79e9f718: posts small blind 125
Player_c4584b6f: posts big blind 250
*** HOLE CARDS ***
Dealt to Hero [3s Tc]
Player_0b34eaa3: folds
Player_f4387d4e: folds
Player_54643c4a: folds
Player_da75a606: folds
Player_e9572c0b: folds
Player_3a4c9b07: raises 575 to 575
Hero: folds
Player_79e9f718: calls 450 
Player_c4584b6f: calls 325 
*** FLOP *** [6s 8s Ac]
Player_79e9f718: checks
Player_c4584b6f: checks
Player_3a4c9b07: bets 1325 
Player_79e9f718: folds
Player_c4584b6f: calls 1325 
*** TURN *** [6s 8s Ac] [4s]
Player_c4584b6f: checks
Player_3a4c9b07: checks
*** RIVER *** [6s 8s Ac 4s] [Kc]
Player_c4584b6f: bets 2027 
Player_3a4c9b07: calls 2027 
*** SHOW DOWN ***
Player_c4584b6f: shows [5s 5d] (a pair of Fives)
Player_3a4c9b07: shows [9h Ad] (a pair of Aces)
Player_3a4c9b07 collected 8654 from pot
*** SUMMARY ***
Total pot 8654 | Rake 0
Board [6s 8s Ac 4s Kc]
Seat 1: Player_e9572c0b mucked [Ts 8d]
Seat 2: Player_3a4c9b07 showed [9h Ad] and won (8654) with a pair of Aces
Seat 3: Hero (button) mucked [3s Tc]
Seat 4: Player_79e9f718 (small blind) mucked [Qs Th]
Seat 5: Player_c4584b6f (big blind) showed [5s 5d] and lost with a pair of Fives
Seat 6: Player_0b34eaa3 mucked [Kh Jh]
Seat 7: Player_f4387d4e mucked [7c 3h]
Seat 8: Player_54643c4a mucked [Js 4c]
Seat 9: Player_da75a606 mucked [Kd 7h]



PokerStars Hand #3661299338: Tournament #21391319, $20+$2 - Hold'em No Limit (125/250) - 2018/04/06 23:04:11
Table '#18' Seat #3 is the button
Seat 1: Player_3cecb5af (17,605 in chips)
Seat 2: Hero (14,830 in chips)
Seat 3: Player_d7ab4518 (8,900 in chips)
Seat 4: Player_0110eb93 (6,348 in chips)
Seat 5: Player_e6f39430 (9,405 in chips)
Seat 6: Player_a8711d84 (15,325 in chips)
Seat 7: Player_36f394e1 (14,405 in chips)
Seat 8: Player_150b4484 (12,680 in chips)
Player_3cecb5af: posts the ante 25
Hero: posts the ante 25
Player_d7ab4518: posts the ante 25
Player_0110eb93: posts the ante 25
Player_e6f39430: posts the ante 25
Player_a8711d84: posts the ante 25
Player_36f394e1: posts the ante 25
Player_150b4484: posts the ante 25
Player_0110eb93: posts small blind 125
Player_e6f39430: posts big blind 250
*** HOLE CARDS ***
Dealt to Hero [4c 8h]
Player_a8711d84: folds
Player_36f394e1: raises 500 to 500
Player_150b4484: folds
Player_3cecb5af: folds
Hero: folds
Player_d7ab4518: folds
Player_0110eb93: folds
Player_e6f39430: folds
Uncalled bet (250) returned to Player_36f394e1
Player_36f394e1: doesn't show hand
Player_36f394e1 collected 825 from pot
*** SUMMARY ***
Total pot 825 | Rake 0
Seat 1: Player_3cecb5af mucked [8s Qh]
Seat 2: Hero mucked [4c 8h]
Seat 3: Player_d7ab4518 (button) mucked [4s Ah]
Seat 4: Player_0110eb93 (small blind) mucked [Jh 2s]
Seat 5: Player_e6f39430 (big blind) mucked [3d Td]
Seat 6: Player_a8711d84 mucked [8d 3h]
Seat 7: Player_36f394e1 showed [5h 5c] and won (825)
Seat 8: Player_150b4484 mucked [6s Qc]



PokerStars Hand #3661299816: Tournament #21391319, $20+$2 - Hold'em No Limit (125/250) - 2018/04/06 23:04:53
Table '#18' Seat #4 is the button
Seat 1: Player_189853ab (17,580 in chips)
Seat 2: Hero (14,805 in chips)
Seat 3: Player_0fca8ed7 (8,875 in chips)
Seat 4: Player_bc564e92 (6,198 in chips)
Seat 5: Player_1ef3da03 (9,130 in chips)
Seat 6: Player_043db66d (15,300 in chips)
Seat 7: Player_2b3dedb6 (14,955 in chips)
Seat 8: Player_b337a54a (12,655 in chips)
Player_189853ab: posts the ante 25
Hero: posts the ante 25
Player_0fca8ed7: posts the ante 25
Player_bc564e92: posts the ante 25
Player_1ef3da03: posts the ante 25
Player_043db66d: posts the ante 25
Player_2b3dedb6: posts the ante 25
Player_b337a54a: posts the ante 25
Player_1ef3da03: posts small blind 125
Player_043db66d: posts big blind 250
*** HOLE CARDS ***
Dealt to Hero [9d 7d]
Player_2b3dedb6: folds
Player_b337a54a: folds
Player_189853ab: folds
Hero: raises 600 to 600
Player_0fca8ed7: raises 2375 to 2375
Player_bc564e92: folds
Player_1ef3da03: folds
Player_043db66d: folds
Hero: folds
Uncalled bet (1775) returned to Player_0fca8ed7
Player_0fca8ed7: doesn't show hand
Player_0fca8ed7 collected 1775 from pot
*** SUMMARY ***
Total pot 1775 | Rake 0
Seat 1: Player_189853ab mucked [5d 2s]
Seat 2: Hero mucked [9d 7d]
Seat 3: Player_0fca8ed7 showed [Js Jh] and won (1775)
Seat 4: Player_bc564e92 (button) mucked [4h 6d]
Seat 5: Player_1ef3da03 (small blind) mucked [Td 3s]
Seat 6: Player_043db66d (big blind) mucked [Th Kd]
Seat 7: Player_2b3dedb6 mucked [3c 8s]
Seat 8: Player_b337a54a mucked [7s Qs]



PokerStars Hand #3661300682: Tournament #21391319, $20+$2 - Hold'em No Limit (125/250) - 2018/04/06 23:06:08
Table '#18' Seat #5 is the button
Seat 1: Player_7468233b (17,555 in chips)
Seat 2: Hero (14,180 in chips)
Seat 3: Player_bd32ef9d (10,025 in chips)
Seat 4: Player_0ff69849 (6,173 in chips)
Seat 5: Player_29e44c18 (8,980 in chips)
Seat 6: Player_003de5ac (15,025 in chips)
Seat 7: Player_e877d4e3 (14,930 in chips)
Seat 8: Player_d9cebfc8 (12,630 in chips)
Player_7468233b: posts the ante 25
Hero: posts the ante 25
Player_bd32ef9d: posts the ante 25
Player_0ff69849: posts the ante 25
Player_29e44c18: posts the ante 25
Player_003de5ac: posts the ante 25
Player_e877d4e3: posts the ante 25
Player_d9cebfc8: posts the ante 25
Player_003de5ac: posts small blind 125
Player_e877d4e3: posts big blind 250
*** HOLE CARDS ***
Dealt to Hero [2c Qh]
Player_d9cebfc8: folds
Player_7468233b: folds
Hero: folds
Player_bd32ef9d: folds
Player_0ff69849: raises 716 to 716
Player_29e44c18: folds
Player_003de5ac: folds
Player_e877d4e3: calls 466 
*** FLOP *** [8h 2h 6s]
Player_e877d4e3: bets 1574 
Player_0ff69849: raises 5432 to 5432 and is all-in
Player_e877d4e3: calls 3858 
*** TURN *** [8h 2h 6s] [9h]
*** RIVER *** [8h 2h 6s 9h] [4d]
*** SHOW DOWN ***
Player_0ff69849: shows [Qd Ac] (high card Ace)
Player_e877d4e3: shows [9c 7c] (a pair of Nines)
Player_e877d4e3 collected 12621 from pot
Player_0ff69849 finished the tournament in 138th place
*** SUMMARY ***
Total pot 12621 | Rake 0
Board [8h 2h 6s 9h 4d]
Seat 1: Player_7468233b mucked [6c Ts]
Seat 2: Hero mucked [2c Qh]
Seat 3: Player_bd32ef9d mucked [8s 3c]
Seat 4: Player_0ff69849 showed [Qd Ac] and lost with high card Ace
Seat 5: Player_29e44c18 (button) mucked [5d 7d]
Seat 6: Player_003de5ac (small blind) mucked [Tc Qs]
Seat 7: Player_e877d4e3 (big blind) showed [9c 7c] and won (12621) with a pair of Nines
Seat 8: Player_d9cebfc8 mucked [6d 3h]



PokerStars Hand #3661301471: Tournament #21391319, $20+$2 - Hold'em No Limit (125/250) - 2018/04/06 23:07:20
Table '#18' Seat #6 is the button
Seat 1: Player_eaf6c34a (17,530 in chips)
Seat 2: Player_0cf48656 (10,000 in chips)
Seat 3: Hero (14,155 in chips)
Seat 4: Player_bd33f682 (10,000 in chips)
Seat 5: Player_de750527 (8,955 in chips)
Seat 6: Player_0ed86bf8 (14,875 in chips)
Seat 7: Player_2c025912 (21,378 in chips)
Seat 8: Player_277ce883 (12,605 in chips)
Player_eaf6c34a: posts the ante 25
Player_0cf48656: posts the ante 25
Hero: posts the ante 25
Player_bd33f682: posts the ante 25
Player_de750527: posts the ante 25
Player_0ed86bf8: posts the ante 25
Player_2c025912: posts the ante 25
Player_277ce883: posts the ante 25
Player_2c025912: posts small blind 125
Player_277ce883: posts big blind 250
*** HOLE CARDS ***
Dealt to Hero [Js Kc]
Player_eaf6c34a: calls 250 
Player_0cf48656: folds
Hero: folds
Player_bd33f682: folds
Player_de750527: folds
Player_0ed86bf8: folds
Player_2c025912: folds
Player_277ce883: checks
*** FLOP *** [4c 7c Kh]
Player_277ce883: checks
Player_eaf6c34a: checks
*** TURN *** [4c 7c Kh] [Qd]
Player_277ce883: checks
Player_eaf6c34a: bets 450 
Player_277ce883: folds
Uncalled bet (450) returned to Player_eaf6c34a
Player_eaf6c34a: doesn't show hand
Player_eaf6c34a collected 825 from pot
*** SUMMARY ***
Total pot 825 | Rake 0
Board [4c 7c Kh Qd]
Seat 1: Player_eaf6c34a showed [Ah 8s] and won (825)
Seat 2: Player_0cf48656 mucked [8d 9d]
Seat 3: Hero mucked [Js Kc]
Seat 4: Player_bd33f682 mucked [5d 9c]
Seat 5: Player_de750527 mucked [As 5c]
Seat 6: Player_0ed86bf8 (button) mucked [Qs 9s]
Seat 7: Player_2c025912 (small blind) mucked [Jh 5s]
Seat 8: Player_277ce883 (big blind) mucked [7d Th]



PokerStars Hand #3661302332: Tournament #21391319, $20+$2 - Hold'em No Limit (125/250) - 2018/04/06 23:08:38
Table '#18' Seat #8 is the button
Seat 1: Player_1a592d88 (18,080 in chips)
Seat 2: Player_2b7f5ef7 (9,975 in chips)
Seat 3: Hero (14,130 in chips)
Seat 4: Player_6252f2ae (9,975 in chips)
Seat 5: Player_fbbd7dfc (10,000 in chips)
Seat 6: Player_d6d1e31b (8,930 in chips)
Seat 7: Player_5df7c12f (14,850 in chips)
Seat 8: Player_69dd4e67 (21,228 in chips)
Seat 9: Player_78e4d8a9 (12,330 in chips)
Player_1a592d88: posts the ante 25
Player_2b7f5ef7: posts the ante 25
Hero: posts the ante 25
Player_6252f2ae: posts the ante 25
Player_fbbd7dfc: posts the ante 25
Player_d6d1e31b: posts the ante 25
Player_5df7c12f: posts the ante 25
Player_69dd4e67: posts the ante 25
Player_78e4d8a9: posts the ante 25
Player_78e4d8a9: posts small blind 125
Player_1a592d88: posts big blind 250
*** HOLE CARDS ***
Dealt to Hero [Ac 8d]
Player_2b7f5ef7: folds
Hero: folds
Player_6252f2ae: folds
Player_fbbd7dfc: folds
Player_d6d1e31b: raises 750 to 750
Player_5df7c12f: calls 750 
Player_69dd4e67: folds
Player_78e4d8a9: folds
Player_1a592d88: calls 500 
*** FLOP *** [2d Jc 6c]
Player_1a592d88: checks
Player_d6d1e31b: checks
Player_5df7c12f: checks
*** TURN *** [2d Jc 6c] [Td]
Player_1a592d88: checks
Player_d6d1e31b: checks
Player_5df7c12f: bets 3607 
Player_1a592d88: folds
Player_d6d1e31b: folds
Uncalled bet (3607) returned to Player_5df7c12f
Player_5df7c12f: doesn't show hand
Player_5df7c12f collected 2600 from pot
*** SUMMARY ***
Total pot 2600 | Rake 0
Board [2d Jc 6c Td]
Seat 1: Player_1a592d88 (big blind) mucked [Kc Qs]
Seat 2: Player_2b7f5ef7 mucked [4d 7c]
Seat 3: Hero mucked [Ac 8d]
Seat 4: Player_6252f2ae mucked [Tc Jh]
Seat 5: Player_fbbd7dfc mucked [2s 4c]
Seat 6: Player_d6d1e31b mucked [5c 5s]
Seat 7: Player_5df7c12f showed [6s 6d] and won (2600)
Seat 8: Player_69dd4e67 (button) mucked [Jd 7d]
Seat 9: Player_78e4d8a9 (small blind) mucked [2h Ah]



PokerStars Hand #3661303270: Tournament #21391319, $20+$2 - Hold'em No Limit (125/250) - 2018/04/06 23:09:59
Table '#18' Seat #9 is the button
Seat 1: Player_c55a0ac0 (17,305 in chips)
Seat 2: Player_2be782cb (9,950 in chips)
Seat 3: Hero (14,105 in chips)
Seat 4: Player_693ed7d9 (9,950 in chips)
Seat 5: Player_c4bdd658 (9,975 in chips)
Seat 6: Player_d7c1dff2 (8,155 in chips)
Seat 7: Player_0d4427a6 (16,675 in chips)
Seat 8: Player_2f2e723f (21,203 in chips)
Seat 9: Player_007890e3 (12,180 in chips)
Player_c55a0ac0: posts the ante 25
Player_2be782cb: posts the ante 25
Hero: posts the ante 25
Player_693ed7d9: posts the ante 25
Player_c4bdd658: posts the ante 25
Player_d7c1dff2: posts the ante 25
Player_0d4427a6: posts the ante 25
Player_2f2e723f: posts the ante 25
Player_007890e3: posts the ante 25
Player_c55a0ac0: posts small blind 125
Player_2be782cb: posts big blind 250
*** HOLE CARDS ***
Dealt to Hero [Jd 9d]
Hero: raises 600 to 600
Player_693ed7d9: raises 2400 to 2400
Player_c4bdd658: folds
Player_d7c1dff2: folds
Player_0d4427a6: folds
Player_2f2e723f: folds
Player_007890e3: folds
Player_c55a0ac0: folds
Player_2be782cb: folds
Hero: folds
Uncalled bet (1800) returned to Player_693ed7d9
Player_693ed7d9: doesn't show hand
Player_693ed7d9 collected 1800 from pot
*** SUMMARY ***
Total pot 1800 | Rake 0
Seat 1: Player_c55a0ac0 (small blind) mucked [4d 7s]
Seat 2: Player_2be782cb (big blind) mucked [4c Ac]
Seat 3: Hero mucked [Jd 9d]
Seat 4: Player_693ed7d9 showed [Kd As] and won (1800)
Seat 5: Player_c4bdd658 mucked [6s 8s]
Seat 6: Player_d7c1dff2 mucked [Jc 6h]
Seat 7: Player_0d4427a6 mucked [4h 2c]
Seat 8: Player_2f2e723f mucked [Ah Td]
Seat 9: Player_007890e3 (button) mucked [5s 8c]



PokerStars Hand #3661304019: Tournament #21391319, $20+$2 - Hold'em No Limit (125/250) - 2018/04/06 23:11:08
Table '#18' Seat #1 is the button
Seat 1: Player_6b5c2fcc (17,155 in chips)
Seat 2: Player_cb53e40e (9,675 in chips)
Seat 3: Hero (13,480 in chips)
Seat 4: Player_f6a992b0 (11,125 in chips)
Seat 5: Player_c0b13194 (9,950 in chips)
Seat 6: Player_8baa22e1 (8,130 in chips)
Seat 7: Player_6abac10f (16,650 in chips)
Seat 8: Player_f6e92064 (21,178 in chips)
Seat 9: Player_564f2ef6 (12,155 in chips)
Player_6b5c2fcc: posts the ante 25
Player_cb53e40e: posts the ante 25
Hero: posts the ante 25
Player_f6a992b0: posts the ante 25
Player_c0b13194: posts the ante 25
Player_8baa22e1: posts the ante 25
Player_6abac10f: posts the ante 25
Player_f6e92064: posts the ante 25
Player_564f2ef6: posts the ante 25
Player_cb53e40e: posts small blind 125
Hero: posts big blind 250
*** HOLE CARDS ***
Dealt to Hero [2d 9c]
Player_f6a992b0: folds
Player_c0b13194: folds
Player_8baa22e1: folds
Player_6abac10f: folds
Player_f6e92064: folds
Player_564f2ef6: folds
Player_6b5c2fcc: calls 250 
Player_cb53e40e: folds
Hero: checks
*** FLOP *** [4d Ts 8c]
Hero: checks
Player_6b5c2fcc: checks
*** TURN *** [4d Ts 8c] [2s]
Hero: checks
Player_6b5c2fcc: checks
*** RIVER *** [4d Ts 8c 2s] [3h]
Hero: checks
Player_6b5c2fcc: checks
*** SHOW DOWN ***
Hero: shows [2d 9c] (a pair of Deuces)
Player_6b5c2fcc: Mucks [Kc 9d] (High Card)
Hero collected 850 from pot
*** SUMMARY ***
Total pot 850 | Rake 0
Board [4d Ts 8c 2s 3h]
Seat 1: Player_6b5c2fcc (button) mucked [Kc 9d]
Seat 2: Player_cb53e40e (small blind) mucked [5c 7h]
Seat 3: Hero (big blind) showed [2d 9c] and won (850) with a pair of Deuces
Seat 4: Player_f6a992b0 mucked [5h Jd]
Seat 5: Player_c0b13194 mucked [3c 7s]
Seat 6: Player_8baa22e1 mucked [Kd Js]
Seat 7: Player_6abac10f mucked [6h Qh]
Seat 8: Player_f6e92064 mucked [8d Jc]
Seat 9: Player_564f2ef6 mucked [6s Td]



PokerStars Hand #3661305229: Tournament #21391319, $20+$2 - Hold'em No Limit (150/300) - 2018/04/06 23:12:59
Table '#18' Seat #2 is the button
Seat 1: Player_4040ddb9 (16,880 in chips)
Seat 2: Player_0e8d3423 (9,525 in chips)
Seat 3: Hero (14,055 in chips)
Seat 4: Player_e8dbe376 (11,100 in chips)
Seat 5: Player_8f60fffd (9,925 in chips)
Seat 6: Player_a90c704f (8,105 in chips)
Seat 7: Player_edc8592c (16,625 in chips)
Seat 8: Player_69615351 (21,153 in chips)
Seat 9: Player_5501f59e (12,130 in chips)
Player_4040ddb9: posts the ante 30
Player_0e8d3423: posts the ante 30
Hero: posts the ante 30
Player_e8dbe376: posts the ante 30
Player_8f60fffd: posts the ante 30
Player_a90c704f: posts the ante 30
Player_edc8592c: posts the ante 30
Player_69615351: posts the ante 30
Player_5501f59e: posts the ante 30
Hero: posts small blind 150
Player_e8dbe376: posts big blind 300
*** HOLE CARDS ***
Dealt to Hero [4c 2s]
Player_8f60fffd: folds
Player_a90c704f: folds
Player_edc8592c: folds
Player_69615351: folds
Player_5501f59e: folds
Player_4040ddb9: folds
Player_0e8d3423: folds
Hero: folds
Player_e8dbe376: doesn't show hand
Uncalled bet (300) returned to Player_e8dbe376
Player_e8dbe376 collected 420 from pot
*** SUMMARY ***
Total pot 420 | Rake 0
Seat 1: Player_4040ddb9 mucked [9s 3s]
Seat 2: Player_0e8d3423 (button) mucked [9d Ts]
Seat 3: Hero (small blind) mucked [4c 2s]
Seat 4: Player_e8dbe376 (big blind) showed [8d 6c] and won (420)
Seat 5: Player_8f60fffd mucked [6s Kc]
Seat 6: Player_a90c704f mucked [7h 9h]
Seat 7: Player_edc8592c mucked [2h 9c]
Seat 8: Player_69615351 mucked [6d Ac]
Seat 9: Player_5501f59e mucked [8s 5s]



PokerStars Hand #3661305779: Tournament #21391319, $20+$2 - Hold'em No Limit (150/300) - 2018/04/06 23:13:50
Table '#18' Seat #3 is the button
Seat 1: Player_37d901d2 (16,850 in chips)
Seat 2: Player_9c8a8902 (9,495 in chips)
Seat 3: Hero (13,875 in chips)
Seat 4: Player_6136620c (11,490 in chips)
Seat 5: Player_d92dae40 (9,895 in chips)
Seat 6: Player_3bfdf93a (8,075 in chips)
Seat 7: Player_a34df935 (21,123 in chips)
Seat 8: Player_88ec0e62 (12,100 in chips)
Player_37d901d2: posts the ante 30
Player_9c8a8902: posts the ante 30
Hero: posts the ante 30
Player_6136620c: posts the ante 30
Player_d92dae40: posts the ante 30
Player_3bfdf93a: posts the ante 30
Player_a34df935: posts the ante 30
Player_88ec0e62: posts the ante 30
Player_6136620c: posts small blind 150
Player_d92dae40: posts big blind 300
*** HOLE CARDS ***
Dealt to Hero [6s 7d]
Player_3bfdf93a: folds
Player_a34df935: folds
Player_88ec0e62: folds
Player_37d901d2: calls 300 
Player_9c8a8902: folds
Hero: folds
Player_6136620c: calls 150 
Player_d92dae40: checks
*** FLOP *** [4h Qh Qs]
Player_6136620c: checks
Player_d92dae40: checks
Player_37d901d2: checks
*** TURN *** [4h Qh Qs] [4d]
Player_6136620c: checks
Player_d92dae40: checks
Player_37d901d2: checks
*** RIVER *** [4h Qh Qs 4d] [3c]
Player_6136620c: checks
Player_d92dae40: checks
Player_37d901d2: checks
*** SHOW DOWN ***
Player_6136620c: shows [9h Kd] (two pair, Queens and Fours)
Player_d92dae40: Mucks [2s 7h] (Two pair)
Player_37d901d2: shows [7c Ad] (two pair, Queens and Fours)
Player_37d901d2 collected 1140 from pot
*** SUMMARY ***
Total pot 1140 | Rake 0
Board [4h Qh Qs 4d 3c]
Seat 1: Player_37d901d2 showed [7c Ad] and won (1140) with two pair, Queens and Fours
Seat 2: Player_9c8a8902 mucked [Kh 2d]
Seat 3: Hero (button) mucked [6s 7d]
Seat 4: Player_6136620c (small blind) showed [9h Kd] and lost with two pair, Queens and Fours
Seat 5: Player_d92dae40 (big blind) mucked [2s 7h]
Seat 6: Player_3bfdf93a mucked [Ac 8h]
Seat 7: Player_a34df935 mucked [5d 8s]
Seat 8: Player_88ec0e62 mucked [3h 4c]



PokerStars Hand #3661307417: Tournament #21391319, $20+$2 - Hold'em No Limit (150/300) - 2018/04/06 23:16:14
Table '#18' Seat #4 is the button
Seat 1: Player_1ac742db (17,660 in chips)
Seat 2: Player_ed8163cf (9,465 in chips)
Seat 3: Hero (13,845 in chips)
Seat 4: Player_043eadae (11,160 in chips)
Seat 5: Player_bfc9503a (9,565 in chips)
Seat 6: Player_216c3653 (8,045 in chips)
Seat 7: Player_1ddb1f6d (10,000 in chips)
Seat 8: Player_40256c5c (21,093 in chips)
Seat 9: Player_555b47fa (12,070 in chips)
Player_1ac742db: posts the ante 30
Player_ed8163cf: posts the ante 30
Hero: posts the ante 30
Player_043eadae: posts the ante 30
Player_bfc9503a: posts the ante 30
Player_216c3653: posts the ante 30
Player_1ddb1f6d: posts the ante 30
Player_40256c5c: posts the ante 30
Player_555b47fa: posts the ante 30
Player_bfc9503a: posts small blind 150
Player_216c3653: posts big blind 300
*** HOLE CARDS ***
Dealt to Hero [Ah 4h]
Player_1ddb1f6d: folds
Player_40256c5c: folds
Player_555b47fa: folds
Player_1ac742db: folds
Player_ed8163cf: raises 900 to 900
Hero: folds
Player_043eadae: folds
Player_bfc9503a: folds
Player_216c3653: folds
Uncalled bet (600) returned to Player_ed8163cf
Player_ed8163cf: doesn't show hand
Player_ed8163cf collected 1020 from pot
*** SUMMARY ***
Total pot 1020 | Rake 0
Seat 1: Player_1ac742db mucked [7s 4d]
Seat 2: Player_ed8163cf showed [9s Ac] and won (1020)
Seat 3: Hero mucked [Ah 4h]
Seat 4: Player_043eadae (button) mucked [Ad 7c]
Seat 5: Player_bfc9503a (small blind) mucked [2s 5c]
Seat 6: Player_216c3653 (big blind) mucked [5h Qc]
Seat 7: Player_1ddb1f6d mucked [Qs 8d]
Seat 8: Player_40256c5c mucked [Tc 8c]
Seat 9: Player_555b47fa mucked [Td 9d]



PokerStars Hand #3661308142: Tournament #21391319, $20+$2 - Hold'em No Limit (150/300) - 2018/04/06 23:17:17
Table '#18' Seat #5 is the button
Seat 1: Player_6061cf61 (17,630 in chips)
Seat 2: Player_94a1d330 (10,155 in chips)
Seat 3: Hero (13,815 in chips)
Seat 4: Player_080ac373 (11,130 in chips)
Seat 5: Player_d48ec491 (9,385 in chips)
Seat 6: Player_b43a6fae (7,715 in chips)
Seat 7: Player_5de49015 (9,970 in chips)
Seat 8: Player_7edd2e8d (21,063 in chips)
Seat 9: Player_e16bf6a9 (12,040 in chips)
Player_6061cf61: posts the ante 30
Player_94a1d330: posts the ante 30
Hero: posts the ante 30
Player_080ac373: posts the ante 30
Player_d48ec491: posts the ante 30
Player_b43a6fae: posts the ante 30
Player_5de49015: posts the ante 30
Player_7edd2e8d: posts the ante 30
Player_e16bf6a9: posts the ante 30
Player_b43a6fae: posts small blind 150
Player_5de49015: posts big blind 300
*** HOLE CARDS ***
Dealt to Hero [Kh 8s]
Player_7edd2e8d: folds
Player_e16bf6a9: folds
Player_6061cf61: folds
Player_94a1d330: folds
Hero: folds
Player_080ac373: raises 1320 to 1320
Player_d48ec491: folds
Player_b43a6fae: folds
Player_5de49015: folds
Uncalled bet (1020) returned to Player_080ac373
Player_080ac373: doesn't show hand
Player_080ac373 collected 1020 from pot
*** SUMMARY ***
Total pot 1020 | Rake 0
Seat 1: Player_6061cf61 mucked [Qs 8c]
Seat 2: Player_94a1d330 mucked [6h 2d]
Seat 3: Hero mucked [Kh 8s]
Seat 4: Player_080ac373 showed [Td Th] and won (1020)
Seat 5: Player_d48ec491 (button) mucked [3d 4s]
Seat 6: Player_b43a6fae (small blind) mucked [5d 5c]
Seat 7: Player_5de49015 (big blind) mucked [Jh 5s]
Seat 8: Player_7edd2e8d mucked [9h 6s]
Seat 9: Player_e16bf6a9 mucked [6c Jc]



PokerStars Hand #3661308758: Tournament #21391319, $20+$2 - Hold'em No Limit (150/300) - 2018/04/06 23:18:11
Table '#18' Seat #6 is the button
Seat 1: Player_3323a704 (17,600 in chips)
Seat 2: Player_c6ba9645 (10,125 in chips)
Seat 3: Hero (13,785 in chips)
Seat 4: Player_193bae75 (11,820 in chips)
Seat 5: Player_77a9f090 (9,355 in chips)
Seat 6: Player_f7fcfe48 (7,535 in chips)
Seat 7: Player_ab34d6d8 (9,640 in chips)
Seat 8: Player_0ec7c5b0 (21,033 in chips)
Seat 9: Player_7db502ed (12,010 in chips)
Player_3323a704: posts the ante 30
Player_c6ba9645: posts the ante 30
Hero: posts the ante 30
Player_193bae75: posts the ante 30
Player_77a9f090: posts the ante 30
Player_f7fcfe48: posts the ante 30
Player_ab34d6d8: posts the ante 30
Player_0ec7c5b0: posts the ante 30
Player_7db502ed: posts the ante 30
Player_ab34d6d8: posts small blind 150
Player_0ec7c5b0: posts big blind 300
*** HOLE CARDS ***
Dealt to Hero [Js Jd]
Player_7db502ed: folds
Player_3323a704: folds
Player_c6ba9645: folds
Hero: raises 700 to 700
Player_193bae75: folds
Player_77a9f090: calls 700 
Player_f7fcfe48: calls 700 
Player_ab34d6d8: folds
Player_0ec7c5b0: folds
*** FLOP *** [Ac Qh 6d]
Hero: bets 999 
Player_77a9f090: folds
Player_f7fcfe48: calls 999 
*** TURN *** [Ac Qh 6d] [Jh]
Hero: bets 2000 
Player_f7fcfe48: raises 5806 to 5806 and is all-in
Hero: calls 3806 
*** RIVER *** [Ac Qh 6d Jh] [6h]
*** SHOW DOWN ***
Hero: shows [Js Jd] (a full house, Jacks full of Sixes)
Player_f7fcfe48: shows [Qd Ah] (two pair, Aces and Queens)
Hero collected 16430 from pot
Player_f7fcfe48 finished the tournament in 149th place
*** SUMMARY ***
Total pot 16430 | Rake 0
Board [Ac Qh 6d Jh 6h]
Seat 1: Player_3323a704 mucked [Th 7h]
Seat 2: Player_c6ba9645 mucked [Ks 2s]
Seat 3: Hero showed [Js Jd] and won (16430) with a full house, Jacks full of Sixes
Seat 4: Player_193bae75 mucked [4c 8h]
Seat 5: Player_77a9f090 mucked [3s 4s]
Seat 6: Player_f7fcfe48 (button) showed [Qd Ah] and lost with two pair, Aces and Queens
Seat 7: Player_ab34d6d8 (small blind) mucked [4h Qs]
Seat 8: Player_0ec7c5b0 (big blind) mucked [6c Kh]
Seat 9: Player_7db502ed mucked [8d 7s]



PokerStars Hand #3661309899: Tournament #21391319, $20+$2 - Hold'em No Limit (150/300) - 2018/04/06 23:19:50
Table '#18' Seat #6 is the button
Seat 1: Player_e3a2229b (17,570 in chips)
Seat 2: Player_ff902ea0 (10,095 in chips)
Seat 3: Hero (22,680 in chips)
Seat 4: Player_6d0d071b (11,790 in chips)
Seat 5: Player_58927f0d (8,625 in chips)
Seat 6: Player_cba7e94a (9,460 in chips)
Seat 7: Player_09422178 (20,703 in chips)
Seat 8: Player_ffacda27 (11,980 in chips)
Player_e3a2229b: posts the ante 30
Player_ff902ea0: posts the ante 30
Hero: posts the ante 30
Player_6d0d071b: posts the ante 30
Player_58927f0d: posts the ante 30
Player_cba7e94a: posts the ante 30
Player_09422178: posts the ante 30
Player_ffacda27: posts the ante 30
Player_09422178: posts small blind 150
Player_ffacda27: posts big blind 300
*** HOLE CARDS ***
Dealt to Hero [5c 9h]
Player_e3a2229b: folds
Player_ff902ea0: folds
Hero: folds
Player_6d0d071b: folds
Player_58927f0d: folds
Player_cba7e94a: raises 1200 to 1200
Player_09422178: raises 20523 to 20673 and is all-in
Player_ffacda27: folds
Player_cba7e94a: calls 8230 and is all-in
*** FLOP *** [Kc 2d Ks]
*** TURN *** [Kc 2d Ks] [8c]
*** RIVER *** [Kc 2d Ks 8c] [4c]
*** SHOW DOWN ***
Player_cba7e94a: shows [Qd Jc] (a pair of Kings)
Player_09422178: shows [9d Kd] (three of a kind, Kings)
Uncalled bet (11243) returned to Player_09422178
Player_09422178 collected 19400 from pot
Player_cba7e94a finished the tournament in 148th place
*** SUMMARY ***
Total pot 19400 | Rake 0
Board [Kc 2d Ks 8c 4c]
Seat 1: Player_e3a2229b mucked [9c As]
Seat 2: Player_ff902ea0 mucked [2c 8d]
Seat 3: Hero mucked [5c 9h]
Seat 4: Player_6d0d071b mucked [7s 6d]
Seat 5: Player_58927f0d mucked [Jd 5h]
Seat 6: Player_cba7e94a (button) showed [Qd Jc] and lost with a pair of Kings
Seat 7: Player_09422178 (small blind) showed [9d Kd] and won (19400) with three of a kind, Kings
Seat 8: Player_ffacda27 (big blind) mucked [Jh Td]



PokerStars Hand #3661310670: Tournament #21391319, $20+$2 - Hold'em No Limit (150/300) - 2018/04/06 23:20:56
Table '#18' Seat #6 is the button
Seat 1: Player_277fca8b (17,540 in chips)
Seat 2: Player_1a70b0f4 (10,065 in chips)
Seat 3: Hero (22,650 in chips)
Seat 4: Player_fc5b0b58 (11,760 in chips)
Seat 5: Player_fc58e08a (8,595 in chips)
Seat 6: Player_76143abe (30,643 in chips)
Seat 7: Player_2d9b919e (11,650 in chips)
Player_277fca8b: posts the ante 30
Player_1a70b0f4: posts the ante 30
Hero: posts the ante 30
Player_fc5b0b58: posts the ante 30
Player_fc58e08a: posts the ante 30
Player_76143abe: posts the ante 30
Player_2d9b919e: posts the ante 30
Player_2d9b919e: posts small blind 150
Player_277fca8b: posts big blind 300
*** HOLE CARDS ***
Dealt to Hero [3c 2h]
Player_1a70b0f4: folds
Hero: folds
Player_fc5b0b58: folds
Player_fc58e08a: folds
Player_76143abe: folds
Player_2d9b919e: raises 750 to 900
Player_277fca8b: folds
Uncalled bet (600) returned to Player_2d9b919e
Player_2d9b919e: doesn't show hand
Player_2d9b919e collected 810 from pot
*** SUMMARY ***
Total pot 810 | Rake 0
Seat 1: Player_277fca8b (big blind) mucked [4c 2c]
Seat 2: Player_1a70b0f4 mucked [4d 4h]
Seat 3: Hero mucked [3c 2h]
Seat 4: Player_fc5b0b58 mucked [6d Jh]
Seat 5: Player_fc58e08a mucked [8c Qd]
Seat 6: Player_76143abe (button) mucked [2d 9c]
Seat 7: Player_2d9b919e (small blind) showed [Tc Td] and won (810)



PokerStars Hand #3661311473: Tournament #21391319, $20+$2 - Hold'em No Limit (200/400) - 2018/04/06 23:22:08
Table '#18' Seat #8 is the button
Seat 1: Player_7210134d (17,210 in chips)
Seat 2: Player_7dc1dc4d (10,035 in chips)
Seat 3: Hero (22,620 in chips)
Seat 4: Player_4435461e (11,730 in chips)
Seat 5: Player_6dead453 (8,565 in chips)
Seat 6: Player_7d28fcba (10,000 in chips)
Seat 7: Player_a3f78bde (30,613 in chips)
Seat 8: Player_16db2f26 (12,130 in chips)
Player_7210134d: posts the ante 40
Player_7dc1dc4d: posts the ante 40
Hero: posts the ante 40
Player_4435461e: posts the ante 40
Player_6dead453: posts the ante 40
Player_7d28fcba: posts the ante 40
Player_a3f78bde: posts the ante 40
Player_16db2f26: posts the ante 40
Player_7210134d: posts small blind 200
Player_7dc1dc4d: posts big blind 400
*** HOLE CARDS ***
Dealt to Hero [2d 5c]
Hero: folds
Player_4435461e: folds
Player_6dead453: folds
Player_7d28fcba: folds
Player_a3f78bde: raises 800 to 800
Player_16db2f26: folds
Player_7210134d: folds
Player_7dc1dc4d: folds
Uncalled bet (400) returned to Player_a3f78bde
Player_a3f78bde: doesn't show hand
Player_a3f78bde collected 1320 from pot
*** SUMMARY ***
Total pot 1320 | Rake 0
Seat 1: Player_7210134d (small blind) mucked [Qc 7h]
Seat 2: Player_7dc1dc4d (big blind) mucked [6c 2c]
Seat 3: Hero mucked [2d 5c]
Seat 4: Player_4435461e mucked [8h Qd]
Seat 5: Player_6dead453 mucked [Ks 6h]
Seat 6: Player_7d28fcba mucked [3h 9c]
Seat 7: Player_a3f78bde showed [5h 5s] and won (1320)
Seat 8: Player_16db2f26 (button) mucked [Kd Td]



PokerStars Hand #3661311997: Tournament #21391319, $20+$2 - Hold'em No Limit (200/400) - 2018/04/06 23:22:59
Table '#18' Seat #1 is the button
Seat 1: Player_860ed252 (16,970 in chips)
Seat 2: Player_cf7d4489 (9,595 in chips)
Seat 3: Hero (22,580 in chips)
Seat 4: Player_97c56214 (11,690 in chips)
Seat 5: Player_f0b84422 (8,525 in chips)
Seat 6: Player_64b54079 (9,960 in chips)
Seat 7: Player_19db5c2d (10,000 in chips)
Seat 8: Player_f9623aa8 (31,493 in chips)
Seat 9: Player_f6e30345 (12,090 in chips)
Player_860ed252: posts the ante 40
Player_cf7d4489: posts the ante 40
Hero: posts the ante 40
Player_97c56214: posts the ante 40
Player_f0b84422: posts the ante 40
Player_64b54079: posts the ante 40
Player_19db5c2d: posts the ante 40
Player_f9623aa8: posts the ante 40
Player_f6e30345: posts the ante 40
Player_cf7d4489: posts small blind 200
Hero: posts big blind 400
*** HOLE CARDS ***
Dealt to Hero [2d 5d]
Player_97c56214: folds
Player_f0b84422: calls 400 
Player_64b54079: folds
Player_19db5c2d: raises 2800 to 2800
Player_f9623aa8: folds
Player_f6e30345: folds
Player_860ed252: folds
Player_cf7d4489: folds
Hero: folds
Player_f0b84422: folds
*** SHOW DOWN ***
Player_19db5c2d: shows [Ac Kc] (high card Ace)
Uncalled bet (2400) returned to Player_19db5c2d
Player_19db5c2d collected 1760 from pot
*** SUMMARY ***
Total pot 1760 | Rake 0
Seat 1: Player_860ed252 (button) mucked [7d Ah]
Seat 2: Player_cf7d4489 (small blind) mucked [5c 2s]
Seat 3: Hero (big blind) mucked [2d 5d]
Seat 4: Player_97c56214 mucked [Jd 8s]
Seat 5: Player_f0b84422 mucked [8c 6c]
Seat 6: Player_64b54079 mucked [2h 9d]
Seat 7: Player_19db5c2d showed [Ac Kc] and won (1760) with high card Ace
Seat 8: Player_f9623aa8 mucked [5h 3s]
Seat 9: Player_f6e30345 mucked [Qc 4h]



PokerStars Hand #3661312735: Tournament #21391319, $20+$2 - Hold'em No Limit (200/400) - 2018/04/06 23:24:05
Table '#18' Seat #2 is the button
Seat 1: Player_b4979209 (16,930 in chips)
Seat 2: Player_06cde387 (9,355 in chips)
Seat 3: Hero (22,140 in chips)
Seat 4: Player_faf03efc (11,650 in chips)
Seat 5: Player_2e65c9a8 (8,085 in chips)
Seat 6: Player_e2a3e59b (9,920 in chips)
Seat 7: Player_cef66e7b (11,320 in chips)
Seat 8: Player_de6526f8 (31,453 in chips)
Seat 9: Player_9d2f2769 (12,050 in chips)
Player_b4979209: posts the ante 40
Player_06cde387: posts the ante 40
Hero: posts the ante 40
Player_faf03efc: posts the ante 40
Player_2e65c9a8: posts the ante 40
Player_e2a3e59b: posts the ante 40
Player_cef66e7b: posts the ante 40
Player_de6526f8: posts the ante 40
Player_9d2f2769: posts the ante 40
Hero: posts small blind 200
Player_faf03efc: posts big blind 400
*** HOLE CARDS ***
Dealt to Hero [8c Kh]
Player_2e65c9a8: calls 400 
Player_e2a3e59b: calls 400 
Player_cef66e7b: folds
Player_de6526f8: raises 1600 to 1600
Player_9d2f2769: folds
Player_b4979209: folds
Player_06cde387: folds
Hero: folds
Player_faf03efc: folds
Player_2e65c9a8: calls 1200 
Player_e2a3e59b: calls 1200 
*** FLOP *** [As 4d 3h]
Player_2e65c9a8: checks
Player_e2a3e59b: checks
Player_de6526f8: bets 1961 
Player_2e65c9a8: calls 1961 
Player_e2a3e59b: calls 1961 
*** TURN *** [As 4d 3h] [6c]
Player_2e65c9a8: checks
Player_e2a3e59b: bets 400 
Player_de6526f8: folds
Player_2e65c9a8: raises 2400 to 2400
Player_e2a3e59b: calls 2000 
*** RIVER *** [As 4d 3h 6c] [9h]
Player_2e65c9a8: bets 2084 and is all-in
Player_e2a3e59b: folds
Uncalled bet (2084) returned to Player_2e65c9a8
Player_2e65c9a8: doesn't show hand
Player_2e65c9a8 collected 16443 from pot
*** SUMMARY ***
Total pot 16443 | Rake 0
Board [As 4d 3h 6c 9h]
Seat 1: Player_b4979209 mucked [7s Qd]
Seat 2: Player_06cde387 (button) mucked [5s 2d]
Seat 3: Hero (small blind) mucked [8c Kh]
Seat 4: Player_faf03efc (big blind) mucked [3c Kc]
Seat 5: Player_2e65c9a8 showed [6d 6s] and won (16443)
Seat 6: Player_e2a3e59b mucked [Qh 5h]
Seat 7: Player_cef66e7b mucked [6h 7c]
Seat 8: Player_de6526f8 mucked [Kd Jd]
Seat 9: Player_9d2f2769 mucked [Qc 7h]



PokerStars Hand #3661314035: Tournament #21391319, $20+$2 - Hold'em No Limit (200/400) - 2018/04/06 23:26:02
Table '#18' Seat #3 is the button
Seat 1: Player_f3acb1ba (16,890 in chips)
Seat 2: Player_029580b9 (9,315 in chips)
Seat 3: Hero (21,900 in chips)
Seat 4: Player_871285fb (11,210 in chips)
Seat 5: Player_d0acb4f4 (18,527 in chips)
Seat 6: Player_dcdf85c8 (3,919 in chips)
Seat 7: Player_8f10e943 (11,280 in chips)
Seat 8: Player_eacc4746 (27,852 in chips)
Seat 9: Player_9280d833 (12,010 in chips)
Player_f3acb1ba: posts the ante 40
Player_029580b9: posts the ante 40
Hero: posts the ante 40
Player_871285fb: posts the ante 40
Player_d0acb4f4: posts the ante 40
Player_dcdf85c8: posts the ante 40
Player_8f10e943: posts the ante 40
Player_eacc4746: posts the ante 40
Player_9280d833: posts the ante 40
Player_871285fb: posts small blind 200
Player_d0acb4f4: posts big blind 400
*** HOLE CARDS ***
Dealt to Hero [3d As]
Player_dcdf85c8: folds
Player_8f10e943: calls 400 
Player_eacc4746: folds
Player_9280d833: folds
Player_f3acb1ba: folds
Player_029580b9: folds
Hero: folds
Player_871285fb: calls 200 
Player_d0acb4f4: checks
*** FLOP *** [4h 4s Qc]
Player_871285fb: checks
Player_d0acb4f4: checks
Player_8f10e943: bets 1560 
Player_871285fb: folds
Player_d0acb4f4: folds
Uncalled bet (1560) returned to Player_8f10e943
Player_8f10e943: doesn't show hand
Player_8f10e943 collected 1560 from pot
*** SUMMARY ***
Total pot 1560 | Rake 0
Board [4h 4s Qc]
Seat 1: Player_f3acb1ba mucked [8h 3h]
Seat 2: Player_029580b9 mucked [Ah 7s]
Seat 3: Hero (button) mucked [3d As]
Seat 4: Player_871285fb (small blind) mucked [Ks 5d]
Seat 5: Player_d0acb4f4 (big blind) mucked [Th 2h]
Seat 6: Player_dcdf85c8 mucked [4c Jd]
Seat 7: Player_8f10e943 showed [Tc Qs] and won (1560)
Seat 8: Player_eacc4746 mucked [5s Ad]
Seat 9: Player_9280d833 mucked [3c Kd]



PokerStars Hand #3661315176: Tournament #21391319, $20+$2 - Hold'em No Limit (200/400) - 2018/04/06 23:27:44
Table '#18' Seat #3 is the button
Seat 1: Player_a7368bdd (16,850 in chips)
Seat 2: Hero (21,860 in chips)
Seat 3: Player_fed17218 (10,770 in chips)
Seat 4: Player_fd5c3663 (18,087 in chips)
Seat 5: Player_7b232a6a (3,879 in chips)
Seat 6: Player_948edeaf (12,400 in chips)
Seat 7: Player_20424375 (27,812 in chips)
Seat 8: Player_f502756f (11,970 in chips)
Player_a7368bdd: posts the ante 40
Hero: posts the ante 40
Player_fed17218: posts the ante 40
Player_fd5c3663: posts the ante 40
Player_7b232a6a: posts the ante 40
Player_948edeaf: posts the ante 40
Player_20424375: posts the ante 40
Player_f502756f: posts the ante 40
Player_fd5c3663: posts small blind 200
Player_7b232a6a: posts big blind 400
*** HOLE CARDS ***
Dealt to Hero [Ad Tc]
Player_948edeaf: folds
Player_20424375: folds
Player_f502756f: folds
Player_a7368bdd: calls 400 
Hero: calls 400 
Player_fed17218: calls 400 
Player_fd5c3663: folds
Player_7b232a6a: raises 3439 to 3839 and is all-in
Player_a7368bdd: calls 3439 
Hero: folds
Player_fed17218: folds
*** FLOP *** [6s Td Qs]
*** TURN *** [6s Td Qs] [8d]
*** RIVER *** [6s Td Qs 8d] [6d]
*** SHOW DOWN ***
Player_a7368bdd: shows [9c 9d] (two pair, Nines and Sixes)
Player_7b232a6a: shows [6c Ah] (three of a kind, Sixes)
Player_7b232a6a collected 8998 from pot
*** SUMMARY ***
Total pot 8998 | Rake 0
Board [6s Td Qs 8d 6d]
Seat 1: Player_a7368bdd showed [9c 9d] and lost with two pair, Nines and Sixes
Seat 2: Hero mucked [Ad Tc]
Seat 3: Player_fed17218 (button) mucked [Qh Kc]
Seat 4: Player_fd5c3663 (small blind) mucked [Th 2d]
Seat 5: Player_7b232a6a (big blind) showed [6c Ah] and won (8998) with three of a kind, Sixes
Seat 6: Player_948edeaf mucked [2h 3s]
Seat 7: Player_20424375 mucked [8s 9s]
Seat 8: Player_f502756f mucked [4s Qd]



PokerStars Hand #3661316172: Tournament #21391319, $20+$2 - Hold'em No Limit (200/400) - 2018/04/06 23:29:17
Table '#18' Seat #5 is the button
Seat 1: Player_a35098fd (12,971 in chips)
Seat 2: Player_24106136 (10,000 in chips)
Seat 3: Hero (21,420 in chips)
Seat 4: Player_040eaf2a (10,330 in chips)
Seat 5: Player_c5e174c4 (17,847 in chips)
Seat 6: Player_4bbdba72 (8,998 in chips)
Seat 7: Player_79aa03a9 (12,360 in chips)
Seat 8: Player_66e29aff (27,772 in chips)
Seat 9: Player_b4b48693 (11,930 in chips)
Player_a35098fd: posts the ante 40
Player_24106136: posts the ante 40
Hero: posts the ante 40
Player_040eaf2a: posts the ante 40
Player_c5e174c4: posts the ante 40
Player_4bbdba72: posts the ante 40
Player_79aa03a9: posts the ante 40
Player_66e29aff: posts the ante 40
Player_b4b48693: posts the ante 40
Player_4bbdba72: posts small blind 200
Player_79aa03a9: posts big blind 400
*** HOLE CARDS ***
Dealt to Hero [Ks Ah]
Player_66e29aff: folds
Player_b4b48693: folds
Player_a35098fd: folds
Player_24106136: folds
Hero: raises 999 to 999
Player_040eaf2a: folds
Player_c5e174c4: calls 999 
Player_4bbdba72: calls 799 
Player_79aa03a9: calls 599 
*** FLOP *** [Th Qd Kh]
Player_4bbdba72: checks
Player_79aa03a9: checks
Hero: checks
Player_c5e174c4: checks
*** TURN *** [Th Qd Kh] [8s]
Player_4bbdba72: bets 400 
Player_79aa03a9: raises 1600 to 1600
Hero: calls 1600 
Player_c5e174c4: folds
Player_4bbdba72: calls 1200 
*** RIVER *** [Th Qd Kh 8s] [Kc]
Player_4bbdba72: checks
Player_79aa03a9: bets 9156 
Hero: calls 9156 
Player_4bbdba72: folds
*** SHOW DOWN ***
Player_79aa03a9: shows [Jh 9c] (a straight, Nine to King)
Hero: Mucks [Ks Ah] (Three of a kind)
Player_79aa03a9 collected 27468 from pot
*** SUMMARY ***
Total pot 27468 | Rake 0
Board [Th Qd Kh 8s Kc]
Seat 1: Player_a35098fd mucked [3c As]
Seat 2: Player_24106136 mucked [7s 4h]
Seat 3: Hero mucked [Ks Ah]
Seat 4: Player_040eaf2a mucked [6h Ac]
Seat 5: Player_c5e174c4 (button) mucked [5c 4c]
Seat 6: Player_4bbdba72 (small blind) mucked [3s Ts]
Seat 7: Player_79aa03a9 (big blind) showed [Jh 9c] and won (27468) with a straight, Nine to King
Seat 8: Player_66e29aff mucked [2c 5s]
Seat 9: Player_b4b48693 mucked [Js 9h]



PokerStars Hand #3661317943: Tournament #21391319, $20+$2 - Hold'em No Limit (250/500) - 2018/04/06 23:31:56
Table '#18' Seat #6 is the button
Seat 1: Player_b4b7e375 (12,931 in chips)
Seat 2: Player_55413e95 (9,960 in chips)
Seat 3: Hero (9,625 in chips)
Seat 4: Player_578682cc (10,290 in chips)
Seat 5: Player_c469f669 (16,808 in chips)
Seat 6: Player_c5602912 (6,359 in chips)
Seat 7: Player_8d9e9d1d (28,033 in chips)
Seat 8: Player_8fe7b956 (27,732 in chips)
Seat 9: Player_0991fc4a (11,890 in chips)
Player_b4b7e375: posts the ante 50
Player_55413e95: posts the ante 50
Hero: posts the ante 50
Player_578682cc: posts the ante 50
Player_c469f669: posts the ante 50
Player_c5602912: posts the ante 50
Player_8d9e9d1d: posts the ante 50
Player_8fe7b956: posts the ante 50
Player_0991fc4a: posts the ante 50
Player_8d9e9d1d: posts small blind 250
Player_8fe7b956: posts big blind 500
*** HOLE CARDS ***
Dealt to Hero [Ad Ac]
Player_0991fc4a: folds
Player_b4b7e375: folds
Player_55413e95: folds
Hero: raises 1222 to 1222
Player_578682cc: folds
Player_c469f669: folds
Player_c5602912: calls 1222 
Player_8d9e9d1d: calls 972 
Player_8fe7b956: folds
*** FLOP *** [4d 2d 6s]
Player_8d9e9d1d: checks
Hero: bets 2333 
Player_c5602912: folds
Player_8d9e9d1d: folds
Uncalled bet (2333) returned to Hero
Hero: doesn't show hand
Hero collected 4616 from pot
*** SUMMARY ***
Total pot 4616 | Rake 0
Board [4d 2d 6s]
Seat 1: Player_b4b7e375 mucked [Qs 2c]
Seat 2: Player_55413e95 mucked [7c 5d]
Seat 3: Hero showed [Ad Ac] and won (4616)
Seat 4: Player_578682cc mucked [3h 7s]
Seat 5: Player_c469f669 mucked [3c Jh]
Seat 6: Player_c5602912 (button) mucked [8s Qd]
Seat 7: Player_8d9e9d1d (small blind) mucked [As Tc]
Seat 8: Player_8fe7b956 (big blind) mucked [3s 9d]
Seat 9: Player_0991fc4a mucked [4c Js]



PokerStars Hand #3661319421: Tournament #21391319, $20+$2 - Hold'em No Limit (250/500) - 2018/04/06 23:34:08
Table '#18' Seat #7 is the button
Seat 1: Player_aac2c5bb (12,881 in chips)
Seat 2: Player_c40a912c (9,910 in chips)
Seat 3: Hero (12,969 in chips)
Seat 4: Player_f71ac6af (10,240 in chips)
Seat 5: Player_2962d147 (16,758 in chips)
Seat 6: Player_3791e417 (5,087 in chips)
Seat 7: Player_2a13a958 (26,761 in chips)
Seat 8: Player_11046046 (27,182 in chips)
Seat 9: Player_4dc227ee (11,840 in chips)
Player_aac2c5bb: posts the ante 50
Player_c40a912c: posts the ante 50
Hero: posts the ante 50
Player_f71ac6af: posts the ante 50
Player_2962d147: posts the ante 50
Player_3791e417: posts the ante 50
Player_2a13a958: posts the ante 50
Player_11046046: posts the ante 50
Player_4dc227ee: posts the ante 50
Player_11046046: posts small blind 250
Player_4dc227ee: posts big blind 500
*** HOLE CARDS ***
Dealt to Hero [Ad Ts]
Player_aac2c5bb: calls 500 
Player_c40a912c: folds
Hero: folds
Player_f71ac6af: folds
Player_2962d147: folds
Player_3791e417: raises 1000 to 1000
Player_2a13a958: folds
Player_11046046: folds
Player_4dc227ee: raises 2500 to 3000
Player_aac2c5bb: folds
Player_3791e417: calls 2000 
*** FLOP *** [4d Th Kd]
Player_4dc227ee: bets 7200 
Player_3791e417: bets 2037 and is all-in
*** TURN *** [4d Th Kd] [3s]
*** RIVER *** [4d Th Kd 3s] [7d]
*** SHOW DOWN ***
Player_3791e417: shows [Ks Qs] (a pair of Kings)
Player_4dc227ee: shows [3d 3c] (three of a kind, Threes)
Uncalled bet (5163) returned to Player_4dc227ee
Player_4dc227ee collected 11274 from pot
Player_3791e417 finished the tournament in 157th place
*** SUMMARY ***
Total pot 11274 | Rake 0
Board [4d Th Kd 3s 7d]
Seat 1: Player_aac2c5bb mucked [Kc 2c]
Seat 2: Player_c40a912c mucked [Tc 4h]
Seat 3: Hero mucked [Ad Ts]
Seat 4: Player_f71ac6af mucked [6s 7c]
Seat 5: Player_2962d147 mucked [Js 4c]
Seat 6: Player_3791e417 showed [Ks Qs] and lost with a pair of Kings
Seat 7: Player_2a13a958 (button) mucked [Qc 9h]
Seat 8: Player_11046046 (small blind) mucked [6h 5h]
Seat 9: Player_4dc227ee (big blind) showed [3d 3c] and won (11274) with three of a kind, Threes



PokerStars Hand #3661320640: Tournament #21391319, $20+$2 - Hold'em No Limit (250/500) - 2018/04/06 23:36:02
Table '#18' Seat #7 is the button
Seat 1: Player_e475d100 (12,331 in chips)
Seat 2: Player_8f8b2e4e (9,860 in chips)
Seat 3: Hero (12,919 in chips)
Seat 4: Player_622f9a4f (10,190 in chips)
Seat 5: Player_79e3f22c (16,708 in chips)
Seat 6: Player_a9c78f08 (26,711 in chips)
Seat 7: Player_ea748621 (26,882 in chips)
Seat 8: Player_87f85be9 (18,027 in chips)
Player_e475d100: posts the ante 50
Player_8f8b2e4e: posts the ante 50
Hero: posts the ante 50
Player_622f9a4f: posts the ante 50
Player_79e3f22c: posts the ante 50
Player_a9c78f08: posts the ante 50
Player_ea748621: posts the ante 50
Player_87f85be9: posts the ante 50
Player_87f85be9: posts small blind 250
Player_e475d100: posts big blind 500
*** HOLE CARDS ***
Dealt to Hero [3d 6d]
Player_8f8b2e4e: folds
Hero: folds
Player_622f9a4f: folds
Player_79e3f22c: calls 500 
Player_a9c78f08: folds
Player_ea748621: folds
Player_87f85be9: folds
Player_e475d100: checks
*** FLOP *** [Js 8s 8c]
Player_e475d100: checks
Player_79e3f22c: checks
*** TURN *** [Js 8s 8c] [Th]
Player_e475d100: checks
Player_79e3f22c: bets 1351 
Player_e475d100: folds
Uncalled bet (1351) returned to Player_79e3f22c
Player_79e3f22c: doesn't show hand
Player_79e3f22c collected 1650 from pot
*** SUMMARY ***
Total pot 1650 | Rake 0
Board [Js 8s 8c Th]
Seat 1: Player_e475d100 (big blind) mucked [Kd 2s]
Seat 2: Player_8f8b2e4e mucked [Qs 5c]
Seat 3: Hero mucked [3d 6d]
Seat 4: Player_622f9a4f mucked [Td 2c]
Seat 5: Player_79e3f22c showed [8d Ad] and won (1650)
Seat 6: Player_a9c78f08 mucked [9c 7d]
Seat 7: Player_ea748621 (button) mucked [Tc 3c]
Seat 8: Player_87f85be9 (small blind) mucked [3h 9d]



PokerStars Hand #3661321808: Tournament #21391319, $20+$2 - Hold'em No Limit (250/500) - 2018/04/06 23:37:50
Table '#18' Seat #8 is the button
Seat 1: Player_96eed933 (11,781 in chips)
Seat 2: Player_fbedb134 (9,810 in chips)
Seat 3: Hero (12,869 in chips)
Seat 4: Player_ad50981d (10,140 in chips)
Seat 5: Player_1a23fcf7 (17,808 in chips)
Seat 6: Player_882b2efa (26,661 in chips)
Seat 7: Player_0c47e324 (26,832 in chips)
Seat 8: Player_22f2e0cf (17,727 in chips)
Player_96eed933: posts the ante 50
Player_fbedb134: posts the ante 50
Hero: posts the ante 50
Player_ad50981d: posts the ante 50
Player_1a23fcf7: posts the ante 50
Player_882b2efa: posts the ante 50
Player_0c47e324: posts the ante 50
Player_22f2e0cf: posts the ante 50
Player_96eed933: posts small blind 250
Player_fbedb134: posts big blind 500
*** HOLE CARDS ***
Dealt to Hero [4h 6s]
Hero: folds
Player_ad50981d: folds
Player_1a23fcf7: folds
Player_882b2efa: calls 500 
Player_0c47e324: raises 2650 to 2650
Player_22f2e0cf: folds
Player_96eed933: calls 2400 
Player_fbedb134: folds
Player_882b2efa: folds
*** FLOP *** [7s 4c 8s]
Player_96eed933: bets 1200 
Player_0c47e324: raises 10780 to 10780
Player_96eed933: calls 7881 and is all-in
*** TURN *** [7s 4c 8s] [Qd]
*** RIVER *** [7s 4c 8s Qd] [2d]
*** SHOW DOWN ***
Player_96eed933: shows [Ks Js] (high card King)
Player_0c47e324: shows [8h Ah] (a pair of Eights)
Uncalled bet (1699) returned to Player_0c47e324
Player_0c47e324 collected 24862 from pot
Player_96eed933 finished the tournament in 155th place
*** SUMMARY ***
Total pot 24862 | Rake 0
Board [7s 4c 8s Qd 2d]
Seat 1: Player_96eed933 (small blind) showed [Ks Js] and lost with high card King
Seat 2: Player_fbedb134 (big blind) mucked [7h Ac]
Seat 3: Hero mucked [4h 6s]
Seat 4: Player_ad50981d mucked [Th 2s]
Seat 5: Player_1a23fcf7 mucked [Kd 3c]
Seat 6: Player_882b2efa mucked [As 9d]
Seat 7: Player_0c47e324 showed [8h Ah] and won (24862) with a pair of Eights
Seat 8: Player_22f2e0cf (button) mucked [Ts 5c]



PokerStars Hand #3661322864: Tournament #21391319, $20+$2 - Hold'em No Limit (250/500) - 2018/04/06 23:39:26
Table '#18' Seat #1 is the button
Seat 1: Player_e31e54e1 (10,000 in chips)
Seat 2: Player_73ccbfe5 (9,260 in chips)
Seat 3: Hero (12,819 in chips)
Seat 4: Player_d01b2f51 (10,090 in chips)
Seat 5: Player_472c3f21 (17,758 in chips)
Seat 6: Player_c9d5d954 (26,111 in chips)
Seat 7: Player_88758b0e (39,913 in chips)
Seat 8: Player_8579e9b7 (17,677 in chips)
Player_e31e54e1: posts the ante 50
Player_73ccbfe5: posts the ante 50
Hero: posts the ante 50
Player_d01b2f51: posts the ante 50
Player_472c3f21: posts the ante 50
Player_c9d5d954: posts the ante 50
Player_88758b0e: posts the ante 50
Player_8579e9b7: posts the ante 50
Player_73ccbfe5: posts small blind 250
Hero: posts big blind 500
*** HOLE CARDS ***
Dealt to Hero [Qh 6c]
Player_d01b2f51: folds
Player_472c3f21: calls 500 
Player_c9d5d954: folds
Player_88758b0e: folds
Player_8579e9b7: folds
Player_e31e54e1: calls 500 
Player_73ccbfe5: raises 8960 to 9210 and is all-in
Hero: folds
Player_472c3f21: folds
Player_e31e54e1: folds
Uncalled bet (8710) returned to Player_73ccbfe5
Player_73ccbfe5: doesn't show hand
Player_73ccbfe5 collected 2400 from pot
*** SUMMARY ***
Total pot 2400 | Rake 0
Seat 1: Player_e31e54e1 (button) mucked [3d 3c]
Seat 2: Player_73ccbfe5 (small blind) showed [5h Kh] and won (2400)
Seat 3: Hero (big blind) mucked [Qh 6c]
Seat 4: Player_d01b2f51 mucked [2d 6h]
Seat 5: Player_472c3f21 mucked [Qc Js]
Seat 6: Player_c9d5d954 mucked [2s 5c]
Seat 7: Player_88758b0e mucked [3h 9d]
Seat 8: Player_8579e9b7 mucked [3s 6d]



PokerStars Hand #3661323928: Tournament #21391319, $20+$2 - Hold'em No Limit (250/500) - 2018/04/06 23:41:05
Table '#18' Seat #2 is the button
Seat 1: Player_e2ee1b18 (9,450 in chips)
Seat 2: Player_ff516a96 (11,110 in chips)
Seat 3: Hero (12,269 in chips)
Seat 4: Player_b5360083 (10,040 in chips)
Seat 5: Player_a44e55dc (17,208 in chips)
Seat 6: Player_532f7828 (26,061 in chips)
Seat 7: Player_b3672609 (39,863 in chips)
Seat 8: Player_e9c8b001 (17,627 in chips)
Player_e2ee1b18: posts the ante 50
Player_ff516a96: posts the ante 50
Hero: posts the ante 50
Player_b5360083: posts the ante 50
Player_a44e55dc: posts the ante 50
Player_532f7828: posts the ante 50
Player_b3672609: posts the ante 50
Player_e9c8b001: posts the ante 50
Hero: posts small blind 250
Player_b5360083: posts big blind 500
*** HOLE CARDS ***
Dealt to Hero [2s Qs]
Player_a44e55dc: folds
Player_532f7828: folds
Player_b3672609: folds
Player_e9c8b001: folds
Player_e2ee1b18: folds
Player_ff516a96: bets 11060 and is all-in
Hero: folds
Player_b5360083: folds
Uncalled bet (10560) returned to Player_ff516a96
Player_ff516a96: doesn't show hand
Player_ff516a96 collected 1650 from pot
*** SUMMARY ***
Total pot 1650 | Rake 0
Seat 1: Player_e2ee1b18 mucked [9h Kd]
Seat 2: Player_ff516a96 (button) showed [6d Ah] and won (1650)
Seat 3: Hero (small blind) mucked [2s Qs]
Seat 4: Player_b5360083 (big blind) mucked [7s 3h]
Seat 5: Player_a44e55dc mucked [7c 8s]
Seat 6: Player_532f7828 mucked [6c 9c]
Seat 7: Player_b3672609 mucked [Jh 8h]
Seat 8: Player_e9c8b001 mucked [5d 8d]



PokerStars Hand #3661324554: Tournament #21391319, $20+$2 - Hold'em No Limit (300/600) - 2018/04/06 23:42:02
Table '#18' Seat #3 is the button
Seat 1: Player_62a2ac19 (9,400 in chips)
Seat 2: Player_e56ecbe4 (12,210 in chips)
Seat 3: Hero (11,969 in chips)
Seat 4: Player_dc722df8 (9,490 in chips)
Seat 5: Player_0db88440 (17,158 in chips)
Seat 6: Player_b075e491 (26,011 in chips)
Seat 7: Player_14bb03c9 (39,813 in chips)
Seat 8: Player_9acbf864 (17,577 in chips)
Player_62a2ac19: posts the ante 60
Player_e56ecbe4: posts the ante 60
Hero: posts the ante 60
Player_dc722df8: posts the ante 60
Player_0db88440: posts the ante 60
Player_b075e491: posts the ante 60
Player_14bb03c9: posts the ante 60
Player_9acbf864: posts the ante 60
Player_dc722df8: posts small blind 300
Player_0db88440: posts big blind 600
*** HOLE CARDS ***
Dealt to Hero [Js 8h]
Player_b075e491: folds
Player_14bb03c9: folds
Player_9acbf864: folds
Player_62a2ac19: folds
Player_e56ecbe4: folds
Hero: raises 1500 to 1500
Player_dc722df8: folds
Player_0db88440: calls 900 
*** FLOP *** [7c Ac 2d]
Player_0db88440: checks
Hero: bets 1900 
Player_0db88440: raises 9480 to 9480
Hero: folds
Uncalled bet (7580) returned to Player_0db88440
Player_0db88440: doesn't show hand
Player_0db88440 collected 7580 from pot
*** SUMMARY ***
Total pot 7580 | Rake 0
Board [7c Ac 2d]
Seat 1: Player_62a2ac19 mucked [Qs Th]
Seat 2: Player_e56ecbe4 mucked [8d 5h]
Seat 3: Hero (button) mucked [Js 8h]
Seat 4: Player_dc722df8 (small blind) mucked [8c 3d]
Seat 5: Player_0db88440 (big blind) showed [6c Qc] and won (7580)
Seat 6: Player_b075e491 mucked [4h 6s]
Seat 7: Player_14bb03c9 mucked [Qd 2c]
Seat 8: Player_9acbf864 mucked [6h Jh]



PokerStars Hand #3661325232: Tournament #21391319, $20+$2 - Hold'em No Limit (300/600) - 2018/04/06 23:43:05
Table '#18' Seat #4 is the button
Seat 1: Player_a1d23dac (9,340 in chips)
Seat 2: Player_0bb53a49 (12,150 in chips)
Seat 3: Hero (8,509 in chips)
Seat 4: Player_cb82b377 (9,130 in chips)
Seat 5: Player_beb167a7 (21,278 in chips)
Seat 6: Player_22c5fe3b (25,951 in chips)
Seat 7: Player_cdd19325 (39,753 in chips)
Seat 8: Player_22ebbe38 (17,517 in chips)
Player_a1d23dac: posts the ante 60
Player_0bb53a49: posts the ante 60
Hero: posts the ante 60
Player_cb82b377: posts the ante 60
Player_beb167a7: posts the ante 60
Player_22c5fe3b: posts the ante 60
Player_cdd19325: posts the ante 60
Player_22ebbe38: posts the ante 60
Player_beb167a7: posts small blind 300
Player_22c5fe3b: posts big blind 600
*** HOLE CARDS ***
Dealt to Hero [2s Ah]
Player_cdd19325: folds
Player_22ebbe38: folds
Player_a1d23dac: folds
Player_0bb53a49: folds
Hero: folds
Player_cb82b377: folds
Player_beb167a7: folds
Player_22c5fe3b: doesn't show hand
Uncalled bet (600) returned to Player_22c5fe3b
Player_22c5fe3b collected 780 from pot
*** SUMMARY ***
Total pot 780 | Rake 0
Seat 1: Player_a1d23dac mucked [6c 2h]
Seat 2: Player_0bb53a49 mucked [Qh 5h]
Seat 3: Hero mucked [2s Ah]
Seat 4: Player_cb82b377 (button) mucked [5d 8h]
Seat 5: Player_beb167a7 (small blind) mucked [5c 3d]
Seat 6: Player_22c5fe3b (big blind) showed [4h 8d] and won (780)
Seat 7: Player_cdd19325 mucked [Tc 7c]
Seat 8: Player_22ebbe38 mucked [Jh 7s]



PokerStars Hand #3661325977: Tournament #21391319, $20+$2 - Hold'em No Limit (300/600) - 2018/04/06 23:44:14
Table '#18' Seat #5 is the button
Seat 1: Player_c195be1a (9,280 in chips)
Seat 2: Player_b448d927 (12,090 in chips)
Seat 3: Hero (8,449 in chips)
Seat 4: Player_17701e58 (9,070 in chips)
Seat 5: Player_29fda889 (20,918 in chips)
Seat 6: Player_e4c6ad41 (26,671 in chips)
Seat 7: Player_e2ca9320 (39,693 in chips)
Seat 8: Player_64f359c1 (17,457 in chips)
Player_c195be1a: posts the ante 60
Player_b448d927: posts the ante 60
Hero: posts the ante 60
Player_17701e58: posts the ante 60
Player_29fda889: posts the ante 60
Player_e4c6ad41: posts the ante 60
Player_e2ca9320: posts the ante 60
Player_64f359c1: posts the ante 60
Player_e4c6ad41: posts small blind 300
Player_e2ca9320: posts big blind 600
*** HOLE CARDS ***
Dealt to Hero [6s 9c]
Player_64f359c1: folds
Player_c195be1a: folds
Player_b448d927: folds
Hero: folds
Player_17701e58: raises 2580 to 2580
Player_29fda889: folds
Player_e4c6ad41: raises 10860 to 11160
Player_e2ca9320: folds
Player_17701e58: calls 6430 and is all-in
*** FLOP *** [Qc 9s Jh]
*** TURN *** [Qc 9s Jh] [8h]
*** RIVER *** [Qc 9s Jh 8h] [7h]
*** SHOW DOWN ***
Player_17701e58: shows [Jc Jd] (three of a kind, Jacks)
Player_e4c6ad41: shows [Ts As] (a straight, Eight to Queen)
Uncalled bet (2150) returned to Player_e4c6ad41
Player_e4c6ad41 collected 19100 from pot
Player_17701e58 finished the tournament in 148th place
*** SUMMARY ***
Total pot 19100 | Rake 0
Board [Qc 9s Jh 8h 7h]
Seat 1: Player_c195be1a mucked [7d Tc]
Seat 2: Player_b448d927 mucked [Kh 4h]
Seat 3: Hero mucked [6s 9c]
Seat 4: Player_17701e58 showed [Jc Jd] and lost with three of a kind, Jacks
Seat 5: Player_29fda889 (button) mucked [3h Kc]
Seat 6: Player_e4c6ad41 (small blind) showed [Ts As] and won (19100) with a straight, Eight to Queen
Seat 7: Player_e2ca9320 (big blind) mucked [Ac 9h]
Seat 8: Player_64f359c1 mucked [5c 8s]



PokerStars Hand #3661326713: Tournament #21391319, $20+$2 - Hold'em No Limit (300/600) - 2018/04/06 23:45:23
Table '#18' Seat #5 is the button
Seat 1: Player_8f6d14da (9,220 in chips)
Seat 2: Player_426eca9e (12,030 in chips)
Seat 3: Hero (8,389 in chips)
Seat 4: Player_35f2832a (20,858 in chips)
Seat 5: Player_130f6e06 (36,701 in chips)
Seat 6: Player_99910ae6 (39,033 in chips)
Seat 7: Player_ff967aed (17,397 in chips)
Player_8f6d14da: posts the ante 60
Player_426eca9e: posts the ante 60
Hero: posts the ante 60
Player_35f2832a: posts the ante 60
Player_130f6e06: posts the ante 60
Player_99910ae6: posts the ante 60
Player_ff967aed: posts the ante 60
Player_99910ae6: posts small blind 300
Player_ff967aed: posts big blind 600
*** HOLE CARDS ***
Dealt to Hero [9h 2c]
Player_8f6d14da: folds
Player_426eca9e: folds
Hero: folds
Player_35f2832a: calls 600 
Player_130f6e06: folds
Player_99910ae6: calls 300 
Player_ff967aed: checks
*** FLOP *** [Ac 7c 3c]
Player_99910ae6: checks
Player_ff967aed: checks
Player_35f2832a: checks
*** TURN *** [Ac 7c 3c] [Ah]
Player_99910ae6: checks
Player_ff967aed: checks
Player_35f2832a: checks
*** RIVER *** [Ac 7c 3c Ah] [Jd]
Player_99910ae6: checks
Player_ff967aed: checks
Player_35f2832a: checks
*** SHOW DOWN ***
Player_99910ae6: shows [6s Ts] (a pair of Aces)
Player_ff967aed: shows [3s 8c] (two pair, Aces and Threes)
Player_35f2832a: Mucks [5h 6h] (One pair)
Player_ff967aed collected 2220 from pot
*** SUMMARY ***
Total pot 2220 | Rake 0
Board [Ac 7c 3c Ah Jd]
Seat 1: Player_8f6d14da mucked [Kc 2s]
Seat 2: Player_426eca9e mucked [6d Qh]
Seat 3: Hero mucked [9h 2c]
Seat 4: Player_35f2832a mucked [5h 6h]
Seat 5: Player_130f6e06 (button) mucked [5d Qs]
Seat 6: Player_99910ae6 (small blind) showed [6s Ts] and lost with a pair of Aces
Seat 7: Player_ff967aed (big blind) showed [3s 8c] and won (2220) with two pair, Aces and Threes



PokerStars Hand #3661327504: Tournament #21391319, $20+$2 - Hold'em No Limit (300/600) - 2018/04/06 23:46:35
Table '#18' Seat #7 is the button
Seat 1: Player_50a1d35d (9,160 in chips)
Seat 2: Player_02ca69ff (11,970 in chips)
Seat 3: Hero (8,329 in chips)
Seat 4: Player_81de03ab (10,000 in chips)
Seat 5: Player_fed31709 (20,198 in chips)
Seat 6: Player_63973061 (36,641 in chips)
Seat 7: Player_eb05bf99 (38,373 in chips)
Seat 8: Player_b928f371 (18,957 in chips)
Player_50a1d35d: posts the ante 60
Player_02ca69ff: posts the ante 60
Hero: posts the ante 60
Player_81de03ab: posts the ante 60
Player_fed31709: posts the ante 60
Player_63973061: posts the ante 60
Player_eb05bf99: posts the ante 60
Player_b928f371: posts the ante 60
Player_b928f371: posts small blind 300
Player_50a1d35d: posts big blind 600
*** HOLE CARDS ***
Dealt to Hero [3s 5s]
Player_02ca69ff: folds
Hero: folds
Player_81de03ab: folds
Player_fed31709: folds
Player_63973061: calls 600 
Player_eb05bf99: raises 3011 to 3011
Player_b928f371: folds
Player_50a1d35d: folds
Player_63973061: folds
Uncalled bet (2411) returned to Player_eb05bf99
Player_eb05bf99: doesn't show hand
Player_eb05bf99 collected 2580 from pot
*** SUMMARY ***
Total pot 2580 | Rake 0
Seat 1: Player_50a1d35d (big blind) mucked [Td 9s]
Seat 2: Player_02ca69ff mucked [Js Qd]
Seat 3: Hero mucked [3s 5s]
Seat 4: Player_81de03ab mucked [2s Tc]
Seat 5: Player_fed31709 mucked [4d Ah]
Seat 6: Player_63973061 mucked [7s Qs]
Seat 7: Player_eb05bf99 (button) showed [Qh Jh] and won (2580)
Seat 8: Player_b928f371 (small blind) mucked [2c 5c]



PokerStars Hand #3661328383: Tournament #21391319, $20+$2 - Hold'em No Limit (300/600) - 2018/04/06 23:47:59
Table '#18' Seat #9 is the button
Seat 1: Player_166771f6 (8,500 in chips)
Seat 2: Player_991bdd18 (11,910 in chips)
Seat 3: Hero (8,269 in chips)
Seat 4: Player_f0657998 (9,940 in chips)
Seat 5: Player_285a2641 (20,138 in chips)
Seat 6: Player_0a67b9e4 (10,000 in chips)
Seat 7: Player_4bdc1d82 (35,981 in chips)
Seat 8: Player_c87d515f (40,293 in chips)
Seat 9: Player_6f33235c (18,597 in chips)
Player_166771f6: posts the ante 60
Player_991bdd18: posts the ante 60
Hero: posts the ante 60
Player_f0657998: posts the ante 60
Player_285a2641: posts the ante 60
Player_0a67b9e4: posts the ante 60
Player_4bdc1d82: posts the ante 60
Player_c87d515f: posts the ante 60
Player_6f33235c: posts the ante 60
Player_166771f6: posts small blind 300
Player_991bdd18: posts big blind 600
*** HOLE CARDS ***
Dealt to Hero [Qh 9h]
Hero: bets 8209 and is all-in
Player_f0657998: folds
Player_285a2641: folds
Player_0a67b9e4: folds
Player_4bdc1d82: folds
Player_c87d515f: calls 8209 
Player_6f33235c: folds
Player_166771f6: folds
Player_991bdd18: folds
*** FLOP *** [3s 2s Ah]
*** TURN *** [3s 2s Ah] [8s]
*** RIVER *** [3s 2s Ah 8s] [8d]
*** SHOW DOWN ***
Hero: shows [Qh 9h] (a pair of Eights)
Player_c87d515f: shows [Ac Ad] (a full house, Aces full of Eights)
Player_c87d515f collected 17858 from pot
Hero finished the tournament in 139th place
*** SUMMARY ***
Total pot 17858 | Rake 0
Board [3s 2s Ah 8s 8d]
Seat 1: Player_166771f6 (small blind) mucked [Th 5h]
Seat 2: Player_991bdd18 (big blind) mucked [Kc 5s]
Seat 3: Hero showed [Qh 9h] and lost with a pair of Eights
Seat 4: Player_f0657998 mucked [Tc Kh]
Seat 5: Player_285a2641 mucked [2d 7d]
Seat 6: Player_0a67b9e4 mucked [6s 3c]
Seat 7: Player_4bdc1d82 mucked [Ks 9s]
Seat 8: Player_c87d515f showed [Ac Ad] and won (17858) with a full house, Aces full of Eights
Seat 9: Player_6f33235c (button) mucked [4h Qc]




