PokerStars Hand #3661260797: Tournament #21391319, $20+$2 - Hold'em No Limit (30/60) - 2018/04/06 22:06:14
Table '#18' Seat #5 is the button
Seat 1: Sharda_Rutabaga (10,000 in chips)
Seat 2: George_Habanero (9,980 in chips)
Seat 3: Hero (10,000 in chips)
Seat 4: Delena_Melon (10,000 in chips)
Seat 5: Haydee_Plumcot (10,020 in chips)
Seat 6: Harlan_Yuzu (10,029 in chips)
Seat 7: Ivory_Plum (14,870 in chips)
Harlan_Yuzu: posts small blind 30
Ivory_Plum: posts big blind 60
*** HOLE CARDS ***
Dealt to Hero [Qd 7h]
Sharda_Rutabaga: folds
George_Habanero: folds
Hero: folds
Delena_Melon: folds
Haydee_Plumcot: folds
Harlan_Yuzu: raises 150 to 180
Ivory_Plum: calls 120 
*** FLOP *** [Ac 4c Qh]
Harlan_Yuzu: bets 200 
Ivory_Plum: calls 200 
*** TURN *** [Ac 4c Qh] [Jh]
Harlan_Yuzu: bets 400 
Ivory_Plum: calls 400 
*** RIVER *** [Ac 4c Qh Jh] [2c]
Harlan_Yuzu: bets 750 
Ivory_Plum: calls 750 
*** SHOW DOWN ***
Harlan_Yuzu: shows [Ad Jd] (two pair, Aces and Jacks)
Ivory_Plum: Mucks [Td Ah] (One pair)
Harlan_Yuzu collected 3060 from pot
*** SUMMARY ***
Total pot 3060 | Rake 0
Board [Ac 4c Qh Jh 2c]
Seat 1: Sharda_Rutabaga mucked [4h 8s]
Seat 2: George_Habanero mucked [6h Qs]
Seat 3: Hero mucked [Qd 7h]
Seat 4: Delena_Melon mucked [5s Tc]
Seat 5: Haydee_Plumcot (button) mucked [6d Js]
Seat 6: Harlan_Yuzu (small blind) showed [Ad Jd] and won (3060) with two pair, Aces and Jacks
Seat 7: Ivory_Plum (big blind) mucked [Td Ah]



PokerStars Hand #3661261701: Tournament #21391319, $20+$2 - Hold'em No Limit (30/60) - 2018/04/06 22:07:41
Table '#18' Seat #7 is the button
Seat 1: Sarai_Kiwi (10,000 in chips)
Seat 2: Karyn_Olive (9,980 in chips)
Seat 3: Hero (10,000 in chips)
Seat 4: Kent_Tomatoes (10,020 in chips)
Seat 5: Lavona_Kale (10,000 in chips)
Seat 6: Adrian_Wasabi (10,000 in chips)
Seat 7: Hayley_Cayenne (11,559 in chips)
Seat 8: Coral_Tomatoes (13,340 in chips)
Coral_Tomatoes: posts small blind 30
Sarai_Kiwi: posts big blind 60
*** HOLE CARDS ***
Dealt to Hero [5h Th]
Karyn_Olive: folds
Hero: folds
Kent_Tomatoes: folds
Lavona_Kale: folds
Adrian_Wasabi: raises 120 to 120
Hayley_Cayenne: calls 120 
Coral_Tomatoes: folds
Sarai_Kiwi: folds
*** FLOP *** [Jh 7h 8c]
Adrian_Wasabi: bets 60 
Hayley_Cayenne: calls 60 
*** TURN *** [Jh 7h 8c] [6d]
Adrian_Wasabi: bets 60 
Hayley_Cayenne: raises 222 to 222
Adrian_Wasabi: folds
Uncalled bet (162) returned to Hayley_Cayenne
Hayley_Cayenne: doesn't show hand
Hayley_Cayenne collected 570 from pot
*** SUMMARY ***
Total pot 570 | Rake 0
Board [Jh 7h 8c 6d]
Seat 1: Sarai_Kiwi (big blind) mucked [7s 6c]
Seat 2: Karyn_Olive mucked [Jc 4h]
Seat 3: Hero mucked [5h Th]
Seat 4: Kent_Tomatoes mucked [As 2h]
Seat 5: Lavona_Kale mucked [Kc Ts]
Seat 6: Adrian_Wasabi mucked [Ks 8d]
Seat 7: Hayley_Cayenne (button) showed [4c 5c] and won (570)
Seat 8: Coral_Tomatoes (small blind) mucked [2d 5d]



PokerStars Hand #3661262348: Tournament #21391319, $20+$2 - Hold'em No Limit (30/60) - 2018/04/06 22:08:41
Table '#18' Seat #9 is the button
Seat 1: Paris_Pomelo (9,940 in chips)
Seat 2: Dana_Leek (9,980 in chips)
Seat 3: Hero (10,000 in chips)
Seat 4: Ora_Kohlrabi (10,000 in chips)
Seat 5: Morris_Leek (10,020 in chips)
Seat 6: Karina_Cayenne (10,000 in chips)
Seat 7: Elana_Beets (9,760 in chips)
Seat 8: Shakia_Yuzu (11,889 in chips)
Seat 9: India_Pears (13,310 in chips)
Paris_Pomelo: posts small blind 30
Dana_Leek: posts big blind 60
*** HOLE CARDS ***
Dealt to Hero [Ah Qs]
Hero: raises 180 to 180
Ora_Kohlrabi: folds
Morris_Leek: folds
Karina_Cayenne: folds
Elana_Beets: calls 180 
Shakia_Yuzu: folds
India_Pears: folds
Paris_Pomelo: calls 150 
Dana_Leek: folds
*** FLOP *** [Qh 8d Jd]
Paris_Pomelo: checks
Hero: bets 400 
Elana_Beets: folds
Paris_Pomelo: folds
Uncalled bet (400) returned to Hero
Hero: doesn't show hand
Hero collected 600 from pot
*** SUMMARY ***
Total pot 600 | Rake 0
Board [Qh 8d Jd]
Seat 1: Paris_Pomelo (small blind) mucked [4s Ks]
Seat 2: Dana_Leek (big blind) mucked [9h 2s]
Seat 3: Hero showed [Ah Qs] and won (600)
Seat 4: Ora_Kohlrabi mucked [Kh 2h]
Seat 5: Morris_Leek mucked [2d 6d]
Seat 6: Karina_Cayenne mucked [Jc Tc]
Seat 7: Elana_Beets mucked [6h 4c]
Seat 8: Shakia_Yuzu mucked [2c Th]
Seat 9: India_Pears (button) mucked [Ts Kd]



PokerStars Hand #3661263420: Tournament #21391319, $20+$2 - Hold'em No Limit (30/60) - 2018/04/06 22:10:26
Table '#18' Seat #1 is the button
Seat 1: Ivan_Rutabaga (9,760 in chips)
Seat 2: Silvia_Habanero (9,920 in chips)
Seat 3: Hero (10,420 in chips)
Seat 4: Lizeth_Coconuts (10,000 in chips)
Seat 5: Lou_Lettuce (10,020 in chips)
Seat 6: Birdie_Kohlrabi (10,000 in chips)
Seat 7: Sidney_Avocados (9,580 in chips)
Seat 8: Shonda_Soy (11,889 in chips)
Seat 9: Linnie_Parsley (13,310 in chips)
Silvia_Habanero: posts small blind 30
Hero: posts big blind 60
*** HOLE CARDS ***
Dealt to Hero [8d 3h]
Lizeth_Coconuts: folds
Lou_Lettuce: folds
Birdie_Kohlrabi: folds
Sidney_Avocados: calls 60 
Shonda_Soy: raises 270 to 270
Linnie_Parsley: calls 270 
Ivan_Rutabaga: folds
Silvia_Habanero: folds
Hero: folds
Sidney_Avocados: calls 210 
*** FLOP *** [2c 8s 9d]
Sidney_Avocados: checks
Shonda_Soy: bets 360 
Linnie_Parsley: calls 360 
Sidney_Avocados: folds
*** TURN *** [2c 8s 9d] [7d]
Shonda_Soy: bets 890 
Linnie_Parsley: folds
Uncalled bet (890) returned to Shonda_Soy
Shonda_Soy: doesn't show hand
Shonda_Soy collected 1620 from pot
*** SUMMARY ***
Total pot 1620 | Rake 0
Board [2c 8s 9d 7d]
Seat 1: Ivan_Rutabaga (button) mucked [5h 4c]
Seat 2: Silvia_Habanero (small blind) mucked [7s Qs]
Seat 3: Hero (big blind) mucked [8d 3h]
Seat 4: Lizeth_Coconuts mucked [Ks 7h]
Seat 5: Lou_Lettuce mucked [4s 6d]
Seat 6: Birdie_Kohlrabi mucked [Qd 3c]
Seat 7: Sidney_Avocados mucked [Kc 4h]
Seat 8: Shonda_Soy showed [9h 9s] and won (1620)
Seat 9: Linnie_Parsley mucked [Qh As]



PokerStars Hand #3661264773: Tournament #21391319, $20+$2 - Hold'em No Limit (30/60) - 2018/04/06 22:12:35
Table '#18' Seat #2 is the button
Seat 1: Belen_Tomatoes (9,760 in chips)
Seat 2: Mertie_Radish (9,890 in chips)
Seat 3: Hero (10,360 in chips)
Seat 4: Lonna_Sage (10,000 in chips)
Seat 5: Buena_Tamarind (10,020 in chips)
Seat 6: Jason_Melon (10,000 in chips)
Seat 7: Dorian_Apricots (9,310 in chips)
Seat 8: Ali_Soy (12,879 in chips)
Seat 9: Cecily_Quince (12,680 in chips)
Hero: posts small blind 30
Lonna_Sage: posts big blind 60
*** HOLE CARDS ***
Dealt to Hero [3d 9c]
Buena_Tamarind: folds
Jason_Melon: folds
Dorian_Apricots: raises 207 to 207
Ali_Soy: calls 207 
Cecily_Quince: folds
Belen_Tomatoes: folds
Mertie_Radish: folds
Hero: folds
Lonna_Sage: folds
*** FLOP *** [5h Qd 4c]
Dorian_Apricots: bets 254 
Ali_Soy: calls 254 
*** TURN *** [5h Qd 4c] [7d]
Dorian_Apricots: bets 509 
Ali_Soy: calls 509 
*** RIVER *** [5h Qd 4c 7d] [Ks]
Dorian_Apricots: checks
Ali_Soy: checks
*** SHOW DOWN ***
Dorian_Apricots: shows [Td Ac] (high card Ace)
Ali_Soy: shows [Qh Jh] (a pair of Queens)
Ali_Soy collected 2030 from pot
*** SUMMARY ***
Total pot 2030 | Rake 0
Board [5h Qd 4c 7d Ks]
Seat 1: Belen_Tomatoes mucked [Qc 5s]
Seat 2: Mertie_Radish (button) mucked [6d Jc]
Seat 3: Hero (small blind) mucked [3d 9c]
Seat 4: Lonna_Sage (big blind) mucked [As 4d]
Seat 5: Buena_Tamarind mucked [Qs 9h]
Seat 6: Jason_Melon mucked [7h 6s]
Seat 7: Dorian_Apricots showed [Td Ac] and lost with high card Ace
Seat 8: Ali_Soy showed [Qh Jh] and won (2030) with a pair of Queens
Seat 9: Cecily_Quince mucked [6h 2h]



PokerStars Hand #3661265930: Tournament #21391319, $20+$2 - Hold'em No Limit (30/60) - 2018/04/06 22:14:23
Table '#18' Seat #3 is the button
Seat 1: Samual_Satsuma (9,760 in chips)
Seat 2: Lesli_Yams (9,890 in chips)
Seat 3: Hero (10,330 in chips)
Seat 4: Shari_Tabasco (9,940 in chips)
Seat 5: Vi_Rambutan (10,020 in chips)
Seat 6: Antwan_Celery (10,000 in chips)
Seat 7: Arlyne_Oregano (8,340 in chips)
Seat 8: Elwood_Chives (13,939 in chips)
Seat 9: Meg_Parsley (12,680 in chips)
Shari_Tabasco: posts small blind 30
Vi_Rambutan: posts big blind 60
*** HOLE CARDS ***
Dealt to Hero [6s Ks]
Antwan_Celery: folds
Arlyne_Oregano: raises 320 to 320
Elwood_Chives: raises 818 to 818
Meg_Parsley: folds
Samual_Satsuma: calls 818 
Lesli_Yams: folds
Hero: folds
Shari_Tabasco: folds
Vi_Rambutan: folds
Arlyne_Oregano: calls 498 
*** FLOP *** [4c 6h 7h]
Arlyne_Oregano: bets 60 
Elwood_Chives: raises 1418 to 1418
Samual_Satsuma: folds
Arlyne_Oregano: folds
Uncalled bet (1358) returned to Elwood_Chives
Elwood_Chives: doesn't show hand
Elwood_Chives collected 2664 from pot
*** SUMMARY ***
Total pot 2664 | Rake 0
Board [4c 6h 7h]
Seat 1: Samual_Satsuma mucked [8d Ac]
Seat 2: Lesli_Yams mucked [4d 7s]
Seat 3: Hero (button) mucked [6s Ks]
Seat 4: Shari_Tabasco (small blind) mucked [Td 9d]
Seat 5: Vi_Rambutan (big blind) mucked [6d 2c]
Seat 6: Antwan_Celery mucked [Jc 2h]
Seat 7: Arlyne_Oregano mucked [Jd Kd]
Seat 8: Elwood_Chives showed [Qd Qh] and won (2664)
Seat 9: Meg_Parsley mucked [Ts 6c]



PokerStars Hand #3661267605: Tournament #21391319, $20+$2 - Hold'em No Limit (40/80) - 2018/04/06 22:16:56
Table '#18' Seat #4 is the button
Seat 1: Ofelia_Okra (8,942 in chips)
Seat 2: Evon_Apricots (9,890 in chips)
Seat 3: Hero (10,330 in chips)
Seat 4: Michel_Beets (9,910 in chips)
Seat 5: Carey_Alfalfa (9,960 in chips)
Seat 6: Cristi_Nettles (10,000 in chips)
Seat 7: Chang_Turnips (7,462 in chips)
Seat 8: Jimmie_Tabasco (15,725 in chips)
Seat 9: Iraida_Spinach (12,680 in chips)
Carey_Alfalfa: posts small blind 40
Cristi_Nettles: posts big blind 80
*** HOLE CARDS ***
Dealt to Hero [Ts 4s]
Chang_Turnips: calls 80 
Jimmie_Tabasco: folds
Iraida_Spinach: calls 80 
Ofelia_Okra: folds
Evon_Apricots: folds
Hero: folds
Michel_Beets: folds
Carey_Alfalfa: calls 40 
Cristi_Nettles: folds
*** FLOP *** [5c 5d Qh]
Carey_Alfalfa: checks
Chang_Turnips: checks
Iraida_Spinach: checks
*** TURN *** [5c 5d Qh] [Ac]
Carey_Alfalfa: checks
Chang_Turnips: bets 80 
Iraida_Spinach: folds
Carey_Alfalfa: folds
Uncalled bet (80) returned to Chang_Turnips
Chang_Turnips: doesn't show hand
Chang_Turnips collected 320 from pot
*** SUMMARY ***
Total pot 320 | Rake 0
Board [5c 5d Qh Ac]
Seat 1: Ofelia_Okra mucked [7d 6c]
Seat 2: Evon_Apricots mucked [9h Jd]
Seat 3: Hero mucked [Ts 4s]
Seat 4: Michel_Beets (button) mucked [Qc 5s]
Seat 5: Carey_Alfalfa (small blind) mucked [Kd 8c]
Seat 6: Cristi_Nettles (big blind) mucked [8d Ks]
Seat 7: Chang_Turnips showed [5h Js] and won (320)
Seat 8: Jimmie_Tabasco mucked [3d 4d]
Seat 9: Iraida_Spinach mucked [2c 2d]



PokerStars Hand #3661268213: Tournament #21391319, $20+$2 - Hold'em No Limit (40/80) - 2018/04/06 22:17:50
Table '#18' Seat #5 is the button
Seat 1: Ines_Tubers (8,942 in chips)
Seat 2: Kaylee_Radish (9,890 in chips)
Seat 3: Hero (10,330 in chips)
Seat 4: Levi_Mulberry (9,910 in chips)
Seat 5: Walker_Zuchinis (9,880 in chips)
Seat 6: Lonny_Lime (9,920 in chips)
Seat 7: Audra_Habanero (7,702 in chips)
Seat 8: Ruben_Nettles (15,725 in chips)
Seat 9: Mora_Pomelo (12,600 in chips)
Lonny_Lime: posts small blind 40
Audra_Habanero: posts big blind 80
*** HOLE CARDS ***
Dealt to Hero [4h Qc]
Ruben_Nettles: folds
Mora_Pomelo: folds
Ines_Tubers: calls 80 
Kaylee_Radish: folds
Hero: folds
Levi_Mulberry: folds
Walker_Zuchinis: calls 80 
Lonny_Lime: folds
Audra_Habanero: checks
*** FLOP *** [Ah 6c 7c]
Audra_Habanero: bets 359 
Ines_Tubers: calls 359 
Walker_Zuchinis: folds
*** TURN *** [Ah 6c 7c] [Qh]
Audra_Habanero: bets 486 
Ines_Tubers: raises 1640 to 1640
Audra_Habanero: folds
*** SHOW DOWN ***
Ines_Tubers: shows [As 7h] (two pair, Aces and Sevens)
Uncalled bet (1154) returned to Ines_Tubers
Ines_Tubers collected 1970 from pot
*** SUMMARY ***
Total pot 1970 | Rake 0
Board [Ah 6c 7c Qh]
Seat 1: Ines_Tubers showed [As 7h] and won (1970) with two pair, Aces and Sevens
Seat 2: Kaylee_Radish mucked [6h 4d]
Seat 3: Hero mucked [4h Qc]
Seat 4: Levi_Mulberry mucked [3c 8h]
Seat 5: Walker_Zuchinis (button) mucked [Td Kd]
Seat 6: Lonny_Lime (small blind) mucked [3s 8s]
Seat 7: Audra_Habanero (big blind) mucked [2d Ac]
Seat 8: Ruben_Nettles mucked [Ad 2c]
Seat 9: Mora_Pomelo mucked [7s 4c]



PokerStars Hand #3661268828: Tournament #21391319, $20+$2 - Hold'em No Limit (40/80) - 2018/04/06 22:18:47
Table '#18' Seat #6 is the button
Seat 1: Shani_Jicama (9,987 in chips)
Seat 2: Jann_Plumcot (9,890 in chips)
Seat 3: Hero (10,330 in chips)
Seat 4: Ruben_Melon (9,910 in chips)
Seat 5: Lesli_Apricots (9,800 in chips)
Seat 6: Maren_Apples (9,880 in chips)
Seat 7: Dena_Parsley (6,777 in chips)
Seat 8: Rebeca_Salak (15,725 in chips)
Seat 9: Helena_Kohlrabi (12,600 in chips)
Dena_Parsley: posts small blind 40
Rebeca_Salak: posts big blind 80
*** HOLE CARDS ***
Dealt to Hero [5d 4c]
Helena_Kohlrabi: folds
Shani_Jicama: folds
Jann_Plumcot: folds
Hero: folds
Ruben_Melon: raises 280 to 280
Lesli_Apricots: folds
Maren_Apples: folds
Dena_Parsley: calls 240 
Rebeca_Salak: raises 1040 to 1120
Ruben_Melon: calls 840 
Dena_Parsley: calls 840 
*** FLOP *** [As 2c Kh]
Dena_Parsley: bets 80 
Rebeca_Salak: calls 80 
Ruben_Melon: calls 80 
*** TURN *** [As 2c Kh] [Jc]
Dena_Parsley: bets 478 
Rebeca_Salak: folds
Ruben_Melon: calls 478 
*** RIVER *** [As 2c Kh Jc] [2d]
Dena_Parsley: bets 1401 
Ruben_Melon: folds
Uncalled bet (1401) returned to Dena_Parsley
Dena_Parsley: doesn't show hand
Dena_Parsley collected 4556 from pot
*** SUMMARY ***
Total pot 4556 | Rake 0
Board [As 2c Kh Jc 2d]
Seat 1: Shani_Jicama mucked [4d 9d]
Seat 2: Jann_Plumcot mucked [8c Th]
Seat 3: Hero mucked [5d 4c]
Seat 4: Ruben_Melon mucked [Qc 9c]
Seat 5: Lesli_Apricots mucked [Kc 8h]
Seat 6: Maren_Apples (button) mucked [5c 8s]
Seat 7: Dena_Parsley (small blind) showed [Ks 6c] and won (4556)
Seat 8: Rebeca_Salak (big blind) mucked [Ts Td]
Seat 9: Helena_Kohlrabi mucked [2s Js]



PokerStars Hand #3661269645: Tournament #21391319, $20+$2 - Hold'em No Limit (40/80) - 2018/04/06 22:19:59
Table '#18' Seat #7 is the button
Seat 1: Dorie_Lime (9,987 in chips)
Seat 2: Idell_Chives (9,890 in chips)
Seat 3: Hero (10,330 in chips)
Seat 4: Verlie_Apricots (8,232 in chips)
Seat 5: Brenna_Olive (9,800 in chips)
Seat 6: Frieda_Pinto (9,880 in chips)
Seat 7: Loris_Tat Soi (9,655 in chips)
Seat 8: Malisa_Plumcot (14,525 in chips)
Seat 9: Joey_Daikon (12,600 in chips)
Malisa_Plumcot: posts small blind 40
Joey_Daikon: posts big blind 80
*** HOLE CARDS ***
Dealt to Hero [9c 8c]
Dorie_Lime: calls 80 
Idell_Chives: folds
Hero: raises 320 to 320
Verlie_Apricots: folds
Brenna_Olive: folds
Frieda_Pinto: folds
Loris_Tat Soi: calls 320 
Malisa_Plumcot: folds
Joey_Daikon: folds
Dorie_Lime: calls 240 
*** FLOP *** [Ts 6s Jd]
Dorie_Lime: checks
Hero: checks
Loris_Tat Soi: checks
*** TURN *** [Ts 6s Jd] [5h]
Dorie_Lime: checks
Hero: checks
Loris_Tat Soi: checks
*** RIVER *** [Ts 6s Jd 5h] [Ks]
Dorie_Lime: checks
Hero: checks
Loris_Tat Soi: checks
*** SHOW DOWN ***
Dorie_Lime: shows [2s Ac] (high card Ace)
Hero: Mucks [9c 8c] (High Card)
Loris_Tat Soi: shows [9h Kh] (a pair of Kings)
Loris_Tat Soi collected 1080 from pot
*** SUMMARY ***
Total pot 1080 | Rake 0
Board [Ts 6s Jd 5h Ks]
Seat 1: Dorie_Lime showed [2s Ac] and lost with high card Ace
Seat 2: Idell_Chives mucked [4s Jh]
Seat 3: Hero mucked [9c 8c]
Seat 4: Verlie_Apricots mucked [8d Tc]
Seat 5: Brenna_Olive mucked [5d 9d]
Seat 6: Frieda_Pinto mucked [7s Th]
Seat 7: Loris_Tat Soi (button) showed [9h Kh] and won (1080) with a pair of Kings
Seat 8: Malisa_Plumcot (small blind) mucked [5c 4d]
Seat 9: Joey_Daikon (big blind) mucked [7d Qd]



PokerStars Hand #3661271006: Tournament #21391319, $20+$2 - Hold'em No Limit (40/80) - 2018/04/06 22:22:02
Table '#18' Seat #8 is the button
Seat 1: Serita_Leek (9,667 in chips)
Seat 2: Fae_Dill (9,890 in chips)
Seat 3: Hero (10,010 in chips)
Seat 4: Karmen_Cabbage (8,232 in chips)
Seat 5: Darwin_Orange (9,800 in chips)
Seat 6: Eric_Sprouts (9,880 in chips)
Seat 7: Twanna_Oregano (10,415 in chips)
Seat 8: Almeta_Anise (14,485 in chips)
Seat 9: Susie_Parnsip (12,520 in chips)
Susie_Parnsip: posts small blind 40
Serita_Leek: posts big blind 80
*** HOLE CARDS ***
Dealt to Hero [As 2c]
Fae_Dill: folds
Hero: folds
Karmen_Cabbage: folds
Darwin_Orange: folds
Eric_Sprouts: folds
Twanna_Oregano: calls 80 
Almeta_Anise: folds
Susie_Parnsip: folds
Serita_Leek: checks
*** FLOP *** [Js Th 6d]
Serita_Leek: checks
Twanna_Oregano: checks
*** TURN *** [Js Th 6d] [Ah]
Serita_Leek: checks
Twanna_Oregano: checks
*** RIVER *** [Js Th 6d Ah] [4c]
Serita_Leek: checks
Twanna_Oregano: checks
*** SHOW DOWN ***
Serita_Leek: shows [3d 8h] (high card Ace)
Twanna_Oregano: Mucks [7d 2s] (High Card)
Serita_Leek collected 200 from pot
*** SUMMARY ***
Total pot 200 | Rake 0
Board [Js Th 6d Ah 4c]
Seat 1: Serita_Leek (big blind) showed [3d 8h] and won (200) with high card Ace
Seat 2: Fae_Dill mucked [Jh Qd]
Seat 3: Hero mucked [As 2c]
Seat 4: Karmen_Cabbage mucked [Ts 3s]
Seat 5: Darwin_Orange mucked [7c 4s]
Seat 6: Eric_Sprouts mucked [Ad Qs]
Seat 7: Twanna_Oregano mucked [7d 2s]
Seat 8: Almeta_Anise (button) mucked [2d 3c]
Seat 9: Susie_Parnsip (small blind) mucked [3h 9d]



PokerStars Hand #3661271715: Tournament #21391319, $20+$2 - Hold'em No Limit (40/80) - 2018/04/06 22:23:05
Table '#18' Seat #9 is the button
Seat 1: Luana_Dates (9,787 in chips)
Seat 2: Vonda_Peas (9,890 in chips)
Seat 3: Hero (10,010 in chips)
Seat 4: Alla_Dill (8,232 in chips)
Seat 5: Johnny_Olive (9,800 in chips)
Seat 6: Glenn_Yuzu (9,880 in chips)
Seat 7: Tess_Beets (10,335 in chips)
Seat 8: Kena_Olive (14,485 in chips)
Seat 9: David_Pears (12,480 in chips)
Luana_Dates: posts small blind 40
Vonda_Peas: posts big blind 80
*** HOLE CARDS ***
Dealt to Hero [Ts 8s]
Hero: raises 180 to 180
Alla_Dill: calls 180 
Johnny_Olive: calls 180 
Glenn_Yuzu: folds
Tess_Beets: folds
Kena_Olive: calls 180 
David_Pears: folds
Luana_Dates: folds
Vonda_Peas: calls 100 
*** FLOP *** [9h Qc 6s]
Vonda_Peas: checks
Hero: bets 500 
Alla_Dill: raises 1000 to 1000
Johnny_Olive: folds
Kena_Olive: folds
Vonda_Peas: raises 2500 to 2500
Hero: folds
Alla_Dill: raises 7052 to 8052 and is all-in
Vonda_Peas: calls 5552 
*** TURN *** [9h Qc 6s] [5h]
*** RIVER *** [9h Qc 6s 5h] [Kc]
*** SHOW DOWN ***
Vonda_Peas: shows [9d 6d] (two pair, Nines and Sixes)
Alla_Dill: shows [Js Jc] (a pair of Jacks)
Vonda_Peas collected 17544 from pot
Alla_Dill finished the tournament in 102nd place
*** SUMMARY ***
Total pot 17544 | Rake 0
Board [9h Qc 6s 5h Kc]
Seat 1: Luana_Dates (small blind) mucked [8d 3c]
Seat 2: Vonda_Peas (big blind) showed [9d 6d] and won (17544) with two pair, Nines and Sixes
Seat 3: Hero mucked [Ts 8s]
Seat 4: Alla_Dill showed [Js Jc] and lost with a pair of Jacks
Seat 5: Johnny_Olive mucked [Tc Ah]
Seat 6: Glenn_Yuzu mucked [4h Ks]
Seat 7: Tess_Beets mucked [3h 5c]
Seat 8: Kena_Olive mucked [9s 8c]
Seat 9: David_Pears (button) mucked [2c 5s]



PokerStars Hand #3661273462: Tournament #21391319, $20+$2 - Hold'em No Limit (50/100) - 2018/04/06 22:25:44
Table '#18' Seat #1 is the button
Seat 1: Agnes_Spinach (9,747 in chips)
Seat 2: Versie_Skirret (19,202 in chips)
Seat 3: Hero (9,330 in chips)
Seat 4: Sudie_Mango (9,620 in chips)
Seat 5: Darrel_Tubers (9,880 in chips)
Seat 6: Rory_Fennel (10,335 in chips)
Seat 7: Lu_Rosemary (14,305 in chips)
Seat 8: Drew_Beans (12,480 in chips)
Versie_Skirret: posts small blind 50
Hero: posts big blind 100
*** HOLE CARDS ***
Dealt to Hero [3d 8c]
Sudie_Mango: folds
Darrel_Tubers: folds
Rory_Fennel: folds
Lu_Rosemary: folds
Drew_Beans: folds
Agnes_Spinach: calls 100 
Versie_Skirret: calls 50 
Hero: checks
*** FLOP *** [Ks Ah Qs]
Versie_Skirret: bets 150 
Hero: folds
Agnes_Spinach: calls 150 
*** TURN *** [Ks Ah Qs] [4c]
Versie_Skirret: checks
Agnes_Spinach: checks
*** RIVER *** [Ks Ah Qs 4c] [9d]
Versie_Skirret: bets 150 
Agnes_Spinach: folds
Uncalled bet (150) returned to Versie_Skirret
Versie_Skirret: doesn't show hand
Versie_Skirret collected 600 from pot
*** SUMMARY ***
Total pot 600 | Rake 0
Board [Ks Ah Qs 4c 9d]
Seat 1: Agnes_Spinach (button) mucked [Js 6s]
Seat 2: Versie_Skirret (small blind) showed [Jh Ad] and won (600)
Seat 3: Hero (big blind) mucked [3d 8c]
Seat 4: Sudie_Mango mucked [Jc 3c]
Seat 5: Darrel_Tubers mucked [Qd 6d]
Seat 6: Rory_Fennel mucked [Td 6h]
Seat 7: Lu_Rosemary mucked [8s 2c]
Seat 8: Drew_Beans mucked [9h 4h]



PokerStars Hand #3661274519: Tournament #21391319, $20+$2 - Hold'em No Limit (50/100) - 2018/04/06 22:27:17
Table '#18' Seat #2 is the button
Seat 1: Flora_Melon (9,497 in chips)
Seat 2: Hugh_Apricots (19,552 in chips)
Seat 3: Hero (9,230 in chips)
Seat 4: Melany_Lemon (9,620 in chips)
Seat 5: Dacia_Celery (9,880 in chips)
Seat 6: Cinda_Leek (10,335 in chips)
Seat 7: Jenine_Bananas (14,305 in chips)
Seat 8: Angie_Chard (12,480 in chips)
Hero: posts small blind 50
Melany_Lemon: posts big blind 100
*** HOLE CARDS ***
Dealt to Hero [Qs 7c]
Dacia_Celery: folds
Cinda_Leek: raises 200 to 200
Jenine_Bananas: folds
Angie_Chard: folds
Flora_Melon: calls 200 
Hugh_Apricots: folds
Hero: folds
Melany_Lemon: calls 100 
*** FLOP *** [4s 5h Ks]
Melany_Lemon: checks
Cinda_Leek: bets 797 
Flora_Melon: folds
Melany_Lemon: calls 797 
*** TURN *** [4s 5h Ks] [7d]
Melany_Lemon: checks
Cinda_Leek: bets 930 
Melany_Lemon: calls 930 
*** RIVER *** [4s 5h Ks 7d] [Ah]
Melany_Lemon: checks
Cinda_Leek: checks
*** SHOW DOWN ***
Melany_Lemon: shows [2h Kh] (a pair of Kings)
Cinda_Leek: shows [Jh Kc] (a pair of Kings)
Cinda_Leek collected 4104 from pot
*** SUMMARY ***
Total pot 4104 | Rake 0
Board [4s 5h Ks 7d Ah]
Seat 1: Flora_Melon mucked [Qc Ts]
Seat 2: Hugh_Apricots (button) mucked [3c 9d]
Seat 3: Hero (small blind) mucked [Qs 7c]
Seat 4: Melany_Lemon (big blind) showed [2h Kh] and lost with a pair of Kings
Seat 5: Dacia_Celery mucked [9c 8c]
Seat 6: Cinda_Leek showed [Jh Kc] and won (4104) with a pair of Kings
Seat 7: Jenine_Bananas mucked [5s 4d]
Seat 8: Angie_Chard mucked [2c 3d]



PokerStars Hand #3661275691: Tournament #21391319, $20+$2 - Hold'em No Limit (50/100) - 2018/04/06 22:29:02
Table '#18' Seat #3 is the button
Seat 1: Minh_Tabasco (9,297 in chips)
Seat 2: Quincy_Rutabaga (19,552 in chips)
Seat 3: Hero (9,180 in chips)
Seat 4: Layla_Lettuce (7,693 in chips)
Seat 5: Silva_Parnsip (9,880 in chips)
Seat 6: Phylis_Raisins (12,512 in chips)
Seat 7: Loren_Honeydew (14,305 in chips)
Seat 8: Brenda_Sage (12,480 in chips)
Layla_Lettuce: posts small blind 50
Silva_Parnsip: posts big blind 100
*** HOLE CARDS ***
Dealt to Hero [8s 5d]
Phylis_Raisins: calls 100 
Loren_Honeydew: raises 400 to 400
Brenda_Sage: folds
Minh_Tabasco: calls 400 
Quincy_Rutabaga: folds
Hero: folds
Layla_Lettuce: folds
Silva_Parnsip: folds
Phylis_Raisins: calls 300 
*** FLOP *** [9s 2s 6s]
Phylis_Raisins: bets 538 
Loren_Honeydew: folds
Minh_Tabasco: calls 538 
*** TURN *** [9s 2s 6s] [7d]
Phylis_Raisins: bets 1143 
Minh_Tabasco: calls 1143 
*** RIVER *** [9s 2s 6s 7d] [3h]
Phylis_Raisins: bets 1554 
Minh_Tabasco: calls 1554 
*** SHOW DOWN ***
Phylis_Raisins: shows [4h 9h] (a pair of Nines)
Minh_Tabasco: shows [Kc 9c] (a pair of Nines)
Minh_Tabasco collected 7820 from pot
*** SUMMARY ***
Total pot 7820 | Rake 0
Board [9s 2s 6s 7d 3h]
Seat 1: Minh_Tabasco showed [Kc 9c] and won (7820) with a pair of Nines
Seat 2: Quincy_Rutabaga mucked [Qs Th]
Seat 3: Hero (button) mucked [8s 5d]
Seat 4: Layla_Lettuce (small blind) mucked [5h 2d]
Seat 5: Silva_Parnsip (big blind) mucked [Qc Jc]
Seat 6: Phylis_Raisins showed [4h 9h] and lost with a pair of Nines
Seat 7: Loren_Honeydew mucked [Kd Jh]
Seat 8: Brenda_Sage mucked [Ks 8c]



PokerStars Hand #3661276545: Tournament #21391319, $20+$2 - Hold'em No Limit (50/100) - 2018/04/06 22:30:20
Table '#18' Seat #4 is the button
Seat 1: Almeta_Tubers (13,482 in chips)
Seat 2: Jamey_Jalapeño (19,552 in chips)
Seat 3: Hero (9,180 in chips)
Seat 4: Sydney_Nettles (7,643 in chips)
Seat 5: Billie_Cayenne (9,780 in chips)
Seat 6: Ferne_Peppers (8,877 in chips)
Seat 7: Gavin_Cayenne (13,905 in chips)
Seat 8: Aisha_Nettles (12,480 in chips)
Billie_Cayenne: posts small blind 50
Ferne_Peppers: posts big blind 100
*** HOLE CARDS ***
Dealt to Hero [7s 4s]
Gavin_Cayenne: folds
Aisha_Nettles: folds
Almeta_Tubers: folds
Jamey_Jalapeño: raises 300 to 300
Hero: folds
Sydney_Nettles: calls 300 
Billie_Cayenne: folds
Ferne_Peppers: folds
*** FLOP *** [Jc Td 7h]
Jamey_Jalapeño: bets 300 
Sydney_Nettles: calls 300 
*** TURN *** [Jc Td 7h] [As]
Jamey_Jalapeño: checks
Sydney_Nettles: checks
*** RIVER *** [Jc Td 7h As] [Jh]
Jamey_Jalapeño: bets 420 
Sydney_Nettles: calls 420 
*** SHOW DOWN ***
Jamey_Jalapeño: shows [Kc Qs] (a straight, Ten to Ace)
Sydney_Nettles: Mucks [Tc Kh] (Two pair)
Jamey_Jalapeño collected 2190 from pot
*** SUMMARY ***
Total pot 2190 | Rake 0
Board [Jc Td 7h As Jh]
Seat 1: Almeta_Tubers mucked [3s 9s]
Seat 2: Jamey_Jalapeño showed [Kc Qs] and won (2190) with a straight, Ten to Ace
Seat 3: Hero mucked [7s 4s]
Seat 4: Sydney_Nettles (button) mucked [Tc Kh]
Seat 5: Billie_Cayenne (small blind) mucked [Qc 4d]
Seat 6: Ferne_Peppers (big blind) mucked [9c 5h]
Seat 7: Gavin_Cayenne mucked [Th Jd]
Seat 8: Aisha_Nettles mucked [5c 8d]



PokerStars Hand #3661277240: Tournament #21391319, $20+$2 - Hold'em No Limit (50/100) - 2018/04/06 22:31:23
Table '#18' Seat #5 is the button
Seat 1: Denita_Thyme (13,482 in chips)
Seat 2: Roxana_Tat Soi (20,722 in chips)
Seat 3: Hero (9,180 in chips)
Seat 4: Idalia_Ginger (6,623 in chips)
Seat 5: Cassie_Cabbage (9,730 in chips)
Seat 6: Mirian_Jujube (8,777 in chips)
Seat 7: Sheri_Salak (13,905 in chips)
Seat 8: Sima_Cherry (12,480 in chips)
Mirian_Jujube: posts small blind 50
Sheri_Salak: posts big blind 100
*** HOLE CARDS ***
Dealt to Hero [8c Ks]
Sima_Cherry: folds
Denita_Thyme: folds
Roxana_Tat Soi: folds
Hero: folds
Idalia_Ginger: folds
Cassie_Cabbage: folds
Mirian_Jujube: folds
Sheri_Salak: doesn't show hand
Uncalled bet (100) returned to Sheri_Salak
Sheri_Salak collected 50 from pot
*** SUMMARY ***
Total pot 50 | Rake 0
Seat 1: Denita_Thyme mucked [Ah Kh]
Seat 2: Roxana_Tat Soi mucked [4s Qd]
Seat 3: Hero mucked [8c Ks]
Seat 4: Idalia_Ginger mucked [6s 4h]
Seat 5: Cassie_Cabbage (button) mucked [Qs 5c]
Seat 6: Mirian_Jujube (small blind) mucked [2c 7d]
Seat 7: Sheri_Salak (big blind) showed [Jc Qh] and won (50)
Seat 8: Sima_Cherry mucked [Kc 2h]



PokerStars Hand #3661277747: Tournament #21391319, $20+$2 - Hold'em No Limit (50/100) - 2018/04/06 22:32:11
Table '#18' Seat #6 is the button
Seat 1: Tillie_Soy (13,482 in chips)
Seat 2: Leana_Onions (20,722 in chips)
Seat 3: Hero (9,180 in chips)
Seat 4: Elke_Skirret (6,623 in chips)
Seat 5: Raul_Peppers (9,730 in chips)
Seat 6: Ling_Nettles (8,727 in chips)
Seat 7: Zula_Beans (13,955 in chips)
Seat 8: Roni_Sprouts (12,480 in chips)
Zula_Beans: posts small blind 50
Roni_Sprouts: posts big blind 100
*** HOLE CARDS ***
Dealt to Hero [As Jh]
Tillie_Soy: folds
Leana_Onions: folds
Hero: raises 300 to 300
Elke_Skirret: folds
Raul_Peppers: folds
Ling_Nettles: folds
Zula_Beans: calls 250 
Roni_Sprouts: folds
*** FLOP *** [5h 5d 7c]
Zula_Beans: checks
Hero: checks
*** TURN *** [5h 5d 7c] [6c]
Zula_Beans: bets 300 
Hero: calls 300 
*** RIVER *** [5h 5d 7c 6c] [4h]
Zula_Beans: bets 1000 
Hero: folds
Uncalled bet (1000) returned to Zula_Beans
Zula_Beans: doesn't show hand
Zula_Beans collected 1300 from pot
*** SUMMARY ***
Total pot 1300 | Rake 0
Board [5h 5d 7c 6c 4h]
Seat 1: Tillie_Soy mucked [9h Kc]
Seat 2: Leana_Onions mucked [3h 7s]
Seat 3: Hero mucked [As Jh]
Seat 4: Elke_Skirret mucked [4c 6s]
Seat 5: Raul_Peppers mucked [9d 4s]
Seat 6: Ling_Nettles (button) mucked [Qs 2d]
Seat 7: Zula_Beans (small blind) showed [Ts Ad] and won (1300)
Seat 8: Roni_Sprouts (big blind) mucked [Ks Th]



PokerStars Hand #3661278554: Tournament #21391319, $20+$2 - Hold'em No Limit (50/100) - 2018/04/06 22:33:26
Table '#18' Seat #7 is the button
Seat 1: Kala_Caraway (13,482 in chips)
Seat 2: Sherly_Yams (20,722 in chips)
Seat 3: Hero (8,580 in chips)
Seat 4: Will_Lavender (6,623 in chips)
Seat 5: Jamee_Beets (9,730 in chips)
Seat 6: Loris_Cucumber (8,727 in chips)
Seat 7: Melida_Peppers (14,655 in chips)
Seat 8: Jana_Turnips (12,380 in chips)
Jana_Turnips: posts small blind 50
Kala_Caraway: posts big blind 100
*** HOLE CARDS ***
Dealt to Hero [9d 4s]
Sherly_Yams: folds
Hero: folds
Will_Lavender: folds
Jamee_Beets: folds
Loris_Cucumber: calls 100 
Melida_Peppers: calls 100 
Jana_Turnips: folds
Kala_Caraway: folds
*** FLOP *** [9h 5d 9c]
Loris_Cucumber: bets 100 
Melida_Peppers: calls 100 
*** TURN *** [9h 5d 9c] [6h]
Loris_Cucumber: bets 100 
Melida_Peppers: raises 500 to 500
Loris_Cucumber: folds
Uncalled bet (400) returned to Melida_Peppers
Melida_Peppers: doesn't show hand
Melida_Peppers collected 750 from pot
*** SUMMARY ***
Total pot 750 | Rake 0
Board [9h 5d 9c 6h]
Seat 1: Kala_Caraway (big blind) mucked [Ad Qs]
Seat 2: Sherly_Yams mucked [7c As]
Seat 3: Hero mucked [9d 4s]
Seat 4: Will_Lavender mucked [Ah 2d]
Seat 5: Jamee_Beets mucked [Js Jh]
Seat 6: Loris_Cucumber mucked [8d Jc]
Seat 7: Melida_Peppers (button) showed [8c 9s] and won (750)
Seat 8: Jana_Turnips (small blind) mucked [3d Jd]



PokerStars Hand #3661279293: Tournament #21391319, $20+$2 - Hold'em No Limit (50/100) - 2018/04/06 22:34:32
Table '#18' Seat #9 is the button
Seat 1: Ricki_Fennel (13,382 in chips)
Seat 2: Daron_Garlic (20,722 in chips)
Seat 3: Hero (8,580 in chips)
Seat 4: Sara_Mango (10,000 in chips)
Seat 5: Oretha_Yuzu (6,623 in chips)
Seat 6: Mana_Guava (9,730 in chips)
Seat 7: Erin_Chili (8,427 in chips)
Seat 8: Kina_Jicama (15,105 in chips)
Seat 9: Kieth_Turnips (12,330 in chips)
Ricki_Fennel: posts small blind 50
Daron_Garlic: posts big blind 100
*** HOLE CARDS ***
Dealt to Hero [6c Ah]
Hero: folds
Sara_Mango: folds
Oretha_Yuzu: raises 300 to 300
Mana_Guava: folds
Erin_Chili: calls 300 
Kina_Jicama: folds
Kieth_Turnips: folds
Ricki_Fennel: folds
Daron_Garlic: folds
*** FLOP *** [As Kh Jc]
Oretha_Yuzu: bets 200 
Erin_Chili: folds
Uncalled bet (200) returned to Oretha_Yuzu
Oretha_Yuzu: doesn't show hand
Oretha_Yuzu collected 750 from pot
*** SUMMARY ***
Total pot 750 | Rake 0
Board [As Kh Jc]
Seat 1: Ricki_Fennel (small blind) mucked [3h 9s]
Seat 2: Daron_Garlic (big blind) mucked [3s Js]
Seat 3: Hero mucked [6c Ah]
Seat 4: Sara_Mango mucked [5s Td]
Seat 5: Oretha_Yuzu showed [Ad Ks] and won (750)
Seat 6: Mana_Guava mucked [8d 6s]
Seat 7: Erin_Chili mucked [5c 4s]
Seat 8: Kina_Jicama mucked [2s Ac]
Seat 9: Kieth_Turnips (button) mucked [8s 9d]



PokerStars Hand #3661280038: Tournament #21391319, $20+$2 - Hold'em No Limit (75/150) - 2018/04/06 22:35:35
Table '#18' Seat #1 is the button
Seat 1: Misha_Dates (13,332 in chips)
Seat 2: Monnie_Tat Soi (20,622 in chips)
Seat 3: Hero (8,580 in chips)
Seat 4: Juan_Marjoram (10,000 in chips)
Seat 5: Kimbra_Marjoram (7,073 in chips)
Seat 6: Herman_Papaya (9,730 in chips)
Seat 7: Thao_Lentils (8,127 in chips)
Seat 8: Bryce_Rhubarb (15,105 in chips)
Seat 9: Lorrie_Collard (12,330 in chips)
Monnie_Tat Soi: posts small blind 75
Hero: posts big blind 150
*** HOLE CARDS ***
Dealt to Hero [Qs 7d]
Juan_Marjoram: folds
Kimbra_Marjoram: raises 450 to 450
Herman_Papaya: folds
Thao_Lentils: folds
Bryce_Rhubarb: folds
Lorrie_Collard: folds
Misha_Dates: folds
Monnie_Tat Soi: folds
Hero: folds
Uncalled bet (300) returned to Kimbra_Marjoram
Kimbra_Marjoram: doesn't show hand
Kimbra_Marjoram collected 375 from pot
*** SUMMARY ***
Total pot 375 | Rake 0
Seat 1: Misha_Dates (button) mucked [5c 8h]
Seat 2: Monnie_Tat Soi (small blind) mucked [4c 9s]
Seat 3: Hero (big blind) mucked [Qs 7d]
Seat 4: Juan_Marjoram mucked [Qd 2s]
Seat 5: Kimbra_Marjoram showed [Ac 9h] and won (375)
Seat 6: Herman_Papaya mucked [Jd 8s]
Seat 7: Thao_Lentils mucked [4s Kh]
Seat 8: Bryce_Rhubarb mucked [Ks 3s]
Seat 9: Lorrie_Collard mucked [3d 4d]



PokerStars Hand #3661280543: Tournament #21391319, $20+$2 - Hold'em No Limit (75/150) - 2018/04/06 22:36:20
Table '#18' Seat #2 is the button
Seat 1: Azzie_Jujube (13,332 in chips)
Seat 2: Hoyt_Pumpkins (20,547 in chips)
Seat 3: Hero (8,430 in chips)
Seat 4: Kerrie_Orange (10,000 in chips)
Seat 5: Jene_Sage (7,298 in chips)
Seat 6: Joelle_Papaya (9,730 in chips)
Seat 7: Linda_Kiwi (15,105 in chips)
Seat 8: Gena_Okra (12,330 in chips)
Hero: posts small blind 75
Kerrie_Orange: posts big blind 150
*** HOLE CARDS ***
Dealt to Hero [Td 8d]
Jene_Sage: calls 150 
Joelle_Papaya: folds
Linda_Kiwi: folds
Gena_Okra: folds
Azzie_Jujube: folds
Hoyt_Pumpkins: folds
Hero: calls 75 
Kerrie_Orange: checks
*** FLOP *** [9h 5h Js]
Hero: bets 300 
Kerrie_Orange: calls 300 
Jene_Sage: calls 300 
*** TURN *** [9h 5h Js] [Ac]
Hero: bets 1000 
Kerrie_Orange: calls 1000 
Jene_Sage: folds
*** RIVER *** [9h 5h Js Ac] [2d]
Hero: bets 3000 
Kerrie_Orange: folds
Uncalled bet (3000) returned to Hero
Hero: doesn't show hand
Hero collected 3350 from pot
*** SUMMARY ***
Total pot 3350 | Rake 0
Board [9h 5h Js Ac 2d]
Seat 1: Azzie_Jujube mucked [5c 2h]
Seat 2: Hoyt_Pumpkins (button) mucked [2c Qs]
Seat 3: Hero (small blind) showed [Td 8d] and won (3350)
Seat 4: Kerrie_Orange (big blind) mucked [Ts Qd]
Seat 5: Jene_Sage mucked [Kc Jh]
Seat 6: Joelle_Papaya mucked [7d 6d]
Seat 7: Linda_Kiwi mucked [6s Jd]
Seat 8: Gena_Okra mucked [4h 3d]



PokerStars Hand #3661281886: Tournament #21391319, $20+$2 - Hold'em No Limit (75/150) - 2018/04/06 22:38:20
Table '#18' Seat #3 is the button
Seat 1: Odilia_Onions (13,332 in chips)
Seat 2: Rashad_Peppers (20,547 in chips)
Seat 3: Hero (10,330 in chips)
Seat 4: Jenice_Oregano (8,550 in chips)
Seat 5: John_Soursop (6,848 in chips)
Seat 6: Sarina_Turnips (9,730 in chips)
Seat 7: Karyl_Avocados (15,105 in chips)
Seat 8: Aaron_Shallot (12,330 in chips)
Jenice_Oregano: posts small blind 75
John_Soursop: posts big blind 150
*** HOLE CARDS ***
Dealt to Hero [9h 5s]
Sarina_Turnips: folds
Karyl_Avocados: folds
Aaron_Shallot: folds
Odilia_Onions: folds
Rashad_Peppers: raises 350 to 350
Hero: folds
Jenice_Oregano: calls 275 
John_Soursop: folds
*** FLOP *** [8d 2c 5h]
Jenice_Oregano: checks
Rashad_Peppers: checks
*** TURN *** [8d 2c 5h] [6s]
Jenice_Oregano: bets 425 
Rashad_Peppers: folds
Uncalled bet (425) returned to Jenice_Oregano
Jenice_Oregano: doesn't show hand
Jenice_Oregano collected 850 from pot
*** SUMMARY ***
Total pot 850 | Rake 0
Board [8d 2c 5h 6s]
Seat 1: Odilia_Onions mucked [Td 8c]
Seat 2: Rashad_Peppers mucked [Jc Qd]
Seat 3: Hero (button) mucked [9h 5s]
Seat 4: Jenice_Oregano (small blind) showed [5c Ac] and won (850)
Seat 5: John_Soursop (big blind) mucked [Tc 3d]
Seat 6: Sarina_Turnips mucked [2h 4s]
Seat 7: Karyl_Avocados mucked [Jd 2d]
Seat 8: Aaron_Shallot mucked [3c Jh]



PokerStars Hand #3661282910: Tournament #21391319, $20+$2 - Hold'em No Limit (75/150) - 2018/04/06 22:39:50
Table '#18' Seat #4 is the button
Seat 1: Gordon_Orange (13,332 in chips)
Seat 2: Odelia_Parnsip (20,197 in chips)
Seat 3: Hero (10,330 in chips)
Seat 4: Kelvin_Plantain (9,050 in chips)
Seat 5: Verlie_Plum (6,698 in chips)
Seat 6: Inez_Ugli (9,730 in chips)
Seat 7: Ta_Coconuts (15,105 in chips)
Seat 8: Erline_Leek (12,330 in chips)
Verlie_Plum: posts small blind 75
Inez_Ugli: posts big blind 150
*** HOLE CARDS ***
Dealt to Hero [Ah Kd]
Ta_Coconuts: folds
Erline_Leek: folds
Gordon_Orange: folds
Odelia_Parnsip: folds
Hero: raises 400 to 400
Kelvin_Plantain: folds
Verlie_Plum: folds
Inez_Ugli: folds
Uncalled bet (250) returned to Hero
Hero: doesn't show hand
Hero collected 375 from pot
*** SUMMARY ***
Total pot 375 | Rake 0
Seat 1: Gordon_Orange mucked [5s 6h]
Seat 2: Odelia_Parnsip mucked [Qs 3d]
Seat 3: Hero showed [Ah Kd] and won (375)
Seat 4: Kelvin_Plantain (button) mucked [Qd 6c]
Seat 5: Verlie_Plum (small blind) mucked [As 7d]
Seat 6: Inez_Ugli (big blind) mucked [Jd 8c]
Seat 7: Ta_Coconuts mucked [Jh 9d]
Seat 8: Erline_Leek mucked [6d 9c]



PokerStars Hand #3661283352: Tournament #21391319, $20+$2 - Hold'em No Limit (75/150) - 2018/04/06 22:40:29
Table '#18' Seat #5 is the button
Seat 1: Robbie_Skirret (13,332 in chips)
Seat 2: Orpha_Apples (20,197 in chips)
Seat 3: Hero (10,555 in chips)
Seat 4: Kacy_Dates (9,050 in chips)
Seat 5: Barton_Broccoli (6,623 in chips)
Seat 6: Verona_Yuzu (9,580 in chips)
Seat 7: Wynona_Olive (10,000 in chips)
Seat 8: Ilse_Thyme (15,105 in chips)
Seat 9: Marie_Tamarind (12,330 in chips)
Verona_Yuzu: posts small blind 75
Wynona_Olive: posts big blind 150
*** HOLE CARDS ***
Dealt to Hero [Qc 5c]
Ilse_Thyme: folds
Marie_Tamarind: folds
Robbie_Skirret: folds
Orpha_Apples: folds
Hero: folds
Kacy_Dates: folds
Barton_Broccoli: raises 450 to 450
Verona_Yuzu: folds
Wynona_Olive: folds
Uncalled bet (300) returned to Barton_Broccoli
Barton_Broccoli: doesn't show hand
Barton_Broccoli collected 375 from pot
*** SUMMARY ***
Total pot 375 | Rake 0
Seat 1: Robbie_Skirret mucked [Td Kh]
Seat 2: Orpha_Apples mucked [Ad 5s]
Seat 3: Hero mucked [Qc 5c]
Seat 4: Kacy_Dates mucked [Tc 8d]
Seat 5: Barton_Broccoli (button) showed [7d 7c] and won (375)
Seat 6: Verona_Yuzu (small blind) mucked [8s 3h]
Seat 7: Wynona_Olive (big blind) mucked [4h 6d]
Seat 8: Ilse_Thyme mucked [4s Jc]
Seat 9: Marie_Tamarind mucked [2h Kc]



PokerStars Hand #3661283849: Tournament #21391319, $20+$2 - Hold'em No Limit (75/150) - 2018/04/06 22:41:14
Table '#18' Seat #6 is the button
Seat 1: Ines_Jicama (13,332 in chips)
Seat 2: Honey_Onions (20,197 in chips)
Seat 3: Hero (10,555 in chips)
Seat 4: Daniel_Soursop (9,050 in chips)
Seat 5: Berta_Sage (6,848 in chips)
Seat 6: Theo_Celery (9,505 in chips)
Seat 7: Hsiu_Plantain (9,850 in chips)
Seat 8: Brett_Cherry (15,105 in chips)
Seat 9: Kyle_Pumpkins (12,330 in chips)
Hsiu_Plantain: posts small blind 75
Brett_Cherry: posts big blind 150
*** HOLE CARDS ***
Dealt to Hero [3c 5h]
Kyle_Pumpkins: folds
Ines_Jicama: folds
Honey_Onions: raises 350 to 350
Hero: folds
Daniel_Soursop: folds
Berta_Sage: folds
Theo_Celery: folds
Hsiu_Plantain: folds
Brett_Cherry: calls 200 
*** FLOP *** [8d 6h Qc]
Brett_Cherry: checks
Honey_Onions: bets 325 
Brett_Cherry: calls 325 
*** TURN *** [8d 6h Qc] [Qs]
Brett_Cherry: checks
Honey_Onions: bets 600 
Brett_Cherry: folds
Uncalled bet (600) returned to Honey_Onions
Honey_Onions: doesn't show hand
Honey_Onions collected 1425 from pot
*** SUMMARY ***
Total pot 1425 | Rake 0
Board [8d 6h Qc Qs]
Seat 1: Ines_Jicama mucked [Kc 7h]
Seat 2: Honey_Onions showed [Kh Qd] and won (1425)
Seat 3: Hero mucked [3c 5h]
Seat 4: Daniel_Soursop mucked [Jh 4d]
Seat 5: Berta_Sage mucked [9c Js]
Seat 6: Theo_Celery (button) mucked [3d 6c]
Seat 7: Hsiu_Plantain (small blind) mucked [3s 4h]
Seat 8: Brett_Cherry (big blind) mucked [7c 9h]
Seat 9: Kyle_Pumpkins mucked [2d 8c]



PokerStars Hand #3661284499: Tournament #21391319, $20+$2 - Hold'em No Limit (75/150) - 2018/04/06 22:42:11
Table '#18' Seat #7 is the button
Seat 1: Jospeh_Tabasco (13,332 in chips)
Seat 2: Tandra_Onions (20,947 in chips)
Seat 3: Hero (10,555 in chips)
Seat 4: Ma_Quinoa (9,050 in chips)
Seat 5: Lisha_Plum (6,848 in chips)
Seat 6: Lue_Onions (9,505 in chips)
Seat 7: Hayden_Onions (9,775 in chips)
Seat 8: Reina_Mango (14,430 in chips)
Seat 9: Dalton_Goji (12,330 in chips)
Reina_Mango: posts small blind 75
Dalton_Goji: posts big blind 150
*** HOLE CARDS ***
Dealt to Hero [2d Ah]
Jospeh_Tabasco: folds
Tandra_Onions: folds
Hero: folds
Ma_Quinoa: folds
Lisha_Plum: folds
Lue_Onions: folds
Hayden_Onions: folds
Reina_Mango: raises 375 to 450
Dalton_Goji: folds
Uncalled bet (300) returned to Reina_Mango
Reina_Mango: doesn't show hand
Reina_Mango collected 300 from pot
*** SUMMARY ***
Total pot 300 | Rake 0
Seat 1: Jospeh_Tabasco mucked [2c Jh]
Seat 2: Tandra_Onions mucked [8c Js]
Seat 3: Hero mucked [2d Ah]
Seat 4: Ma_Quinoa mucked [7d Ts]
Seat 5: Lisha_Plum mucked [4s 8h]
Seat 6: Lue_Onions mucked [9d 5s]
Seat 7: Hayden_Onions (button) mucked [3h 9s]
Seat 8: Reina_Mango (small blind) showed [Kd 6d] and won (300)
Seat 9: Dalton_Goji (big blind) mucked [3s Ac]



PokerStars Hand #3661284950: Tournament #21391319, $20+$2 - Hold'em No Limit (75/150) - 2018/04/06 22:42:53
Table '#18' Seat #8 is the button
Seat 1: Winter_Broccoli (13,332 in chips)
Seat 2: Sharee_Lime (20,947 in chips)
Seat 3: Hero (10,555 in chips)
Seat 4: Steven_Tubers (9,050 in chips)
Seat 5: Rubye_Tomatoes (6,848 in chips)
Seat 6: Zita_Okra (9,505 in chips)
Seat 7: Lacy_Arugula (9,775 in chips)
Seat 8: Lahoma_Caraway (14,580 in chips)
Seat 9: Cami_Bok Choy (12,180 in chips)
Cami_Bok Choy: posts small blind 75
Winter_Broccoli: posts big blind 150
*** HOLE CARDS ***
Dealt to Hero [7s 5d]
Sharee_Lime: folds
Hero: folds
Steven_Tubers: folds
Rubye_Tomatoes: folds
Zita_Okra: raises 300 to 300
Lacy_Arugula: folds
Lahoma_Caraway: folds
Cami_Bok Choy: folds
Winter_Broccoli: folds
Uncalled bet (150) returned to Zita_Okra
Zita_Okra: doesn't show hand
Zita_Okra collected 375 from pot
*** SUMMARY ***
Total pot 375 | Rake 0
Seat 1: Winter_Broccoli (big blind) mucked [5h 2c]
Seat 2: Sharee_Lime mucked [9s Ah]
Seat 3: Hero mucked [7s 5d]
Seat 4: Steven_Tubers mucked [Td 7h]
Seat 5: Rubye_Tomatoes mucked [4h 2h]
Seat 6: Zita_Okra showed [Ad 7d] and won (375)
Seat 7: Lacy_Arugula mucked [9h 4c]
Seat 8: Lahoma_Caraway (button) mucked [2d Qc]
Seat 9: Cami_Bok Choy (small blind) mucked [9c Tc]



PokerStars Hand #3661285701: Tournament #21391319, $20+$2 - Hold'em No Limit (75/150) - 2018/04/06 22:43:59
Table '#18' Seat #8 is the button
Seat 1: Aurore_Quinoa (13,182 in chips)
Seat 2: Adell_Kohlrabi (20,947 in chips)
Seat 3: Hero (10,555 in chips)
Seat 4: Lala_Avocados (9,050 in chips)
Seat 5: Alexis_Quince (6,848 in chips)
Seat 6: Ellie_Spinach (9,730 in chips)
Seat 7: Essie_Squash (14,580 in chips)
Seat 8: Joslyn_Jicama (12,105 in chips)
Aurore_Quinoa: posts small blind 75
Adell_Kohlrabi: posts big blind 150
*** HOLE CARDS ***
Dealt to Hero [3c 7d]
Hero: folds
Lala_Avocados: folds
Alexis_Quince: folds
Ellie_Spinach: folds
Essie_Squash: raises 450 to 450
Joslyn_Jicama: folds
Aurore_Quinoa: calls 375 
Adell_Kohlrabi: calls 300 
*** FLOP *** [2s 2d 5c]
Aurore_Quinoa: checks
Adell_Kohlrabi: bets 350 
Essie_Squash: folds
Aurore_Quinoa: calls 350 
*** TURN *** [2s 2d 5c] [5s]
Aurore_Quinoa: bets 500 
Adell_Kohlrabi: calls 500 
*** RIVER *** [2s 2d 5c 5s] [8s]
Aurore_Quinoa: bets 500 
Adell_Kohlrabi: raises 1750 to 1750
Aurore_Quinoa: folds
Uncalled bet (1250) returned to Adell_Kohlrabi
Adell_Kohlrabi: doesn't show hand
Adell_Kohlrabi collected 4050 from pot
*** SUMMARY ***
Total pot 4050 | Rake 0
Board [2s 2d 5c 5s 8s]
Seat 1: Aurore_Quinoa (small blind) mucked [Ad Qh]
Seat 2: Adell_Kohlrabi (big blind) showed [Qs Td] and won (4050)
Seat 3: Hero mucked [3c 7d]
Seat 4: Lala_Avocados mucked [4c 5h]
Seat 5: Alexis_Quince mucked [7h Qd]
Seat 6: Ellie_Spinach mucked [7c 6c]
Seat 7: Essie_Squash mucked [4s 7s]
Seat 8: Joslyn_Jicama (button) mucked [Jh As]



PokerStars Hand #3661290922: Tournament #21391319, $20+$2 - Hold'em No Limit (100/200) - 2018/04/06 22:51:32
Table '#18' Seat #1 is the button
Seat 1: Bart_Grapes (11,382 in chips)
Seat 2: Jovita_Olive (23,197 in chips)
Seat 3: Hero (10,555 in chips)
Seat 4: Loris_Sprouts (9,050 in chips)
Seat 5: Veta_Melon (6,848 in chips)
Seat 6: Jude_Grapes (9,730 in chips)
Seat 7: Manuel_Lemon (10,000 in chips)
Seat 8: Jae_Celeriac (14,130 in chips)
Seat 9: Stella_Celeriac (12,105 in chips)
Jovita_Olive: posts small blind 100
Hero: posts big blind 200
*** HOLE CARDS ***
Dealt to Hero [3d 4h]
Loris_Sprouts: raises 600 to 600
Veta_Melon: folds
Jude_Grapes: folds
Manuel_Lemon: calls 600 
Jae_Celeriac: folds
Stella_Celeriac: folds
Bart_Grapes: calls 600 
Jovita_Olive: folds
Hero: folds
*** FLOP *** [8c 8h Ac]
Loris_Sprouts: bets 1050 
Manuel_Lemon: calls 1050 
Bart_Grapes: folds
*** TURN *** [8c 8h Ac] [As]
Loris_Sprouts: checks
Manuel_Lemon: checks
*** RIVER *** [8c 8h Ac As] [3h]
Loris_Sprouts: bets 3400 
Manuel_Lemon: raises 8350 to 8350 and is all-in
Loris_Sprouts: folds
Uncalled bet (4950) returned to Manuel_Lemon
Manuel_Lemon: doesn't show hand
Manuel_Lemon collected 11000 from pot
*** SUMMARY ***
Total pot 11000 | Rake 0
Board [8c 8h Ac As 3h]
Seat 1: Bart_Grapes (button) mucked [Td Kc]
Seat 2: Jovita_Olive (small blind) mucked [5d 6h]
Seat 3: Hero (big blind) mucked [3d 4h]
Seat 4: Loris_Sprouts mucked [7d 7s]
Seat 5: Veta_Melon mucked [9c 8d]
Seat 6: Jude_Grapes mucked [2s 3c]
Seat 7: Manuel_Lemon showed [Ah Tc] and won (11000)
Seat 8: Jae_Celeriac mucked [6s Js]
Seat 9: Stella_Celeriac mucked [Jc Ks]



PokerStars Hand #3661291903: Tournament #21391319, $20+$2 - Hold'em No Limit (100/200) - 2018/04/06 22:52:56
Table '#18' Seat #2 is the button
Seat 1: Eden_Sage (10,782 in chips)
Seat 2: Etha_Yuzu (23,097 in chips)
Seat 3: Hero (10,355 in chips)
Seat 4: Nobuko_Lavender (4,000 in chips)
Seat 5: Akilah_Jujube (6,848 in chips)
Seat 6: Alysa_Rambutan (9,730 in chips)
Seat 7: Danny_Oregano (15,950 in chips)
Seat 8: Arron_Tamarind (14,130 in chips)
Seat 9: Greg_Collard (12,105 in chips)
Hero: posts small blind 100
Nobuko_Lavender: posts big blind 200
*** HOLE CARDS ***
Dealt to Hero [7d Ad]
Akilah_Jujube: folds
Alysa_Rambutan: folds
Danny_Oregano: folds
Arron_Tamarind: folds
Greg_Collard: folds
Eden_Sage: calls 200 
Etha_Yuzu: folds
Hero: raises 700 to 800
Nobuko_Lavender: calls 600 
Eden_Sage: calls 600 
*** FLOP *** [3c 6h 7c]
Hero: bets 1500 
Nobuko_Lavender: raises 3200 to 3200 and is all-in
Eden_Sage: folds
Hero: calls 1700 
*** TURN *** [3c 6h 7c] [9c]
*** RIVER *** [3c 6h 7c 9c] [Js]
*** SHOW DOWN ***
Hero: shows [7d Ad] (a pair of Sevens)
Nobuko_Lavender: shows [2d 3d] (a pair of Threes)
Hero collected 8800 from pot
Nobuko_Lavender finished the tournament in 134th place
*** SUMMARY ***
Total pot 8800 | Rake 0
Board [3c 6h 7c 9c Js]
Seat 1: Eden_Sage mucked [8c Qc]
Seat 2: Etha_Yuzu (button) mucked [3s Ah]
Seat 3: Hero (small blind) showed [7d Ad] and won (8800) with a pair of Sevens
Seat 4: Nobuko_Lavender (big blind) showed [2d 3d] and lost with a pair of Threes
Seat 5: Akilah_Jujube mucked [7s 9s]
Seat 6: Alysa_Rambutan mucked [4c Ks]
Seat 7: Danny_Oregano mucked [Jd 6c]
Seat 8: Arron_Tamarind mucked [2h As]
Seat 9: Greg_Collard mucked [Kc 2c]



PokerStars Hand #3661292973: Tournament #21391319, $20+$2 - Hold'em No Limit (100/200) - 2018/04/06 22:54:38
Table '#18' Seat #3 is the button
Seat 1: Nadia_Orange (9,982 in chips)
Seat 2: Sabra_Soy (23,097 in chips)
Seat 3: Hero (15,155 in chips)
Seat 4: Andrew_Bilberry (6,848 in chips)
Seat 5: Ressie_Celery (9,730 in chips)
Seat 6: Alexis_Quinoa (15,950 in chips)
Seat 7: Tawana_Celeriac (14,130 in chips)
Seat 8: Marlys_Lychee (12,105 in chips)
Andrew_Bilberry: posts big blind 200
*** HOLE CARDS ***
Dealt to Hero [6d Ts]
Ressie_Celery: folds
Alexis_Quinoa: folds
Tawana_Celeriac: folds
Marlys_Lychee: raises 600 to 600
Nadia_Orange: folds
Sabra_Soy: folds
Hero: folds
Andrew_Bilberry: calls 400 
*** FLOP *** [9h 8s Qc]
Andrew_Bilberry: checks
Marlys_Lychee: bets 600 
Andrew_Bilberry: folds
Uncalled bet (600) returned to Marlys_Lychee
Marlys_Lychee: doesn't show hand
Marlys_Lychee collected 1200 from pot
*** SUMMARY ***
Total pot 1200 | Rake 0
Board [9h 8s Qc]
Seat 1: Nadia_Orange mucked [9d 2s]
Seat 2: Sabra_Soy mucked [3c Ks]
Seat 3: Hero (button) mucked [6d Ts]
Seat 4: Andrew_Bilberry (big blind) mucked [4d 4h]
Seat 5: Ressie_Celery mucked [Qh 5s]
Seat 6: Alexis_Quinoa mucked [Tc 3d]
Seat 7: Tawana_Celeriac mucked [4s Ah]
Seat 8: Marlys_Lychee showed [8h 8d] and won (1200)



PokerStars Hand #3661293586: Tournament #21391319, $20+$2 - Hold'em No Limit (100/200) - 2018/04/06 22:55:35
Table '#18' Seat #4 is the button
Seat 1: Leigh_Paprika (9,982 in chips)
Seat 2: Neva_Pinto (23,097 in chips)
Seat 3: Hero (15,155 in chips)
Seat 4: Timmy_Rhubarb (10,000 in chips)
Seat 5: Terrie_Apricots (6,248 in chips)
Seat 6: Carole_Pomelo (9,730 in chips)
Seat 7: Isaura_Tat Soi (15,950 in chips)
Seat 8: Timmy_Figs (14,130 in chips)
Seat 9: Ivey_Mulberry (12,705 in chips)
Terrie_Apricots: posts small blind 100
Carole_Pomelo: posts big blind 200
*** HOLE CARDS ***
Dealt to Hero [As 7s]
Isaura_Tat Soi: calls 200 
Timmy_Figs: folds
Ivey_Mulberry: folds
Leigh_Paprika: raises 600 to 600
Neva_Pinto: folds
Hero: folds
Timmy_Rhubarb: calls 600 
Terrie_Apricots: folds
Carole_Pomelo: folds
Isaura_Tat Soi: calls 400 
*** FLOP *** [5d 8d 5h]
Isaura_Tat Soi: checks
Leigh_Paprika: bets 600 
Timmy_Rhubarb: folds
Isaura_Tat Soi: folds
*** SHOW DOWN ***
Leigh_Paprika: shows [Ad 7d] (a pair of Fives)
Uncalled bet (600) returned to Leigh_Paprika
Leigh_Paprika collected 2100 from pot
*** SUMMARY ***
Total pot 2100 | Rake 0
Board [5d 8d 5h]
Seat 1: Leigh_Paprika showed [Ad 7d] and won (2100) with a pair of Fives
Seat 2: Neva_Pinto mucked [6s Jh]
Seat 3: Hero mucked [As 7s]
Seat 4: Timmy_Rhubarb (button) mucked [Th Qh]
Seat 5: Terrie_Apricots (small blind) mucked [5c Kc]
Seat 6: Carole_Pomelo (big blind) mucked [9c 4s]
Seat 7: Isaura_Tat Soi mucked [Qs Ks]
Seat 8: Timmy_Figs mucked [6c 3d]
Seat 9: Ivey_Mulberry mucked [Qc 7c]



PokerStars Hand #3661294337: Tournament #21391319, $20+$2 - Hold'em No Limit (100/200) - 2018/04/06 22:56:47
Table '#18' Seat #5 is the button
Seat 1: Dudley_Dill (11,482 in chips)
Seat 2: Sharan_Jalapeño (23,097 in chips)
Seat 3: Hero (15,155 in chips)
Seat 4: Caroll_Rhubarb (9,400 in chips)
Seat 5: Iesha_Spinach (6,148 in chips)
Seat 6: Eliseo_Cabbage (9,530 in chips)
Seat 7: Doris_Honeydew (15,350 in chips)
Seat 8: Kari_Parsley (14,130 in chips)
Seat 9: Anton_Juniper (12,705 in chips)
Eliseo_Cabbage: posts small blind 100
Doris_Honeydew: posts big blind 200
*** HOLE CARDS ***
Dealt to Hero [Qd Ts]
Kari_Parsley: folds
Anton_Juniper: folds
Dudley_Dill: folds
Sharan_Jalapeño: folds
Hero: folds
Caroll_Rhubarb: folds
Iesha_Spinach: folds
Eliseo_Cabbage: folds
Doris_Honeydew: doesn't show hand
Uncalled bet (200) returned to Doris_Honeydew
Doris_Honeydew collected 100 from pot
*** SUMMARY ***
Total pot 100 | Rake 0
Seat 1: Dudley_Dill mucked [5h 4s]
Seat 2: Sharan_Jalapeño mucked [Ad 6c]
Seat 3: Hero mucked [Qd Ts]
Seat 4: Caroll_Rhubarb mucked [7s 9s]
Seat 5: Iesha_Spinach (button) mucked [7c 3d]
Seat 6: Eliseo_Cabbage (small blind) mucked [8d Ks]
Seat 7: Doris_Honeydew (big blind) showed [2s 9h] and won (100)
Seat 8: Kari_Parsley mucked [2c Js]
Seat 9: Anton_Juniper mucked [2d Jh]



PokerStars Hand #3661294653: Tournament #21391319, $20+$2 - Hold'em No Limit (100/200) - 2018/04/06 22:57:17
Table '#18' Seat #6 is the button
Seat 1: Pia_Figs (11,482 in chips)
Seat 2: Suzann_Sprouts (23,097 in chips)
Seat 3: Hero (15,155 in chips)
Seat 4: Reda_Paprika (9,400 in chips)
Seat 5: Lory_Thyme (6,148 in chips)
Seat 6: Santos_Nettles (9,430 in chips)
Seat 7: Simon_Orange (15,450 in chips)
Seat 8: Hang_Caraway (14,130 in chips)
Seat 9: Bailey_Pears (12,705 in chips)
Simon_Orange: posts small blind 100
Hang_Caraway: posts big blind 200
*** HOLE CARDS ***
Dealt to Hero [6c 4d]
Bailey_Pears: folds
Pia_Figs: folds
Suzann_Sprouts: folds
Hero: folds
Reda_Paprika: folds
Lory_Thyme: folds
Santos_Nettles: folds
Simon_Orange: folds
Hang_Caraway: doesn't show hand
Uncalled bet (200) returned to Hang_Caraway
Hang_Caraway collected 100 from pot
*** SUMMARY ***
Total pot 100 | Rake 0
Seat 1: Pia_Figs mucked [Qh 9d]
Seat 2: Suzann_Sprouts mucked [Qd Jc]
Seat 3: Hero mucked [6c 4d]
Seat 4: Reda_Paprika mucked [Tc 6s]
Seat 5: Lory_Thyme mucked [5c Th]
Seat 6: Santos_Nettles (button) mucked [3d 6d]
Seat 7: Simon_Orange (small blind) mucked [5h 3c]
Seat 8: Hang_Caraway (big blind) showed [3h Kh] and won (100)
Seat 9: Bailey_Pears mucked [4c 8h]



PokerStars Hand #3661295035: Tournament #21391319, $20+$2 - Hold'em No Limit (100/200) - 2018/04/06 22:57:53
Table '#18' Seat #7 is the button
Seat 1: Eloy_Parsley (11,482 in chips)
Seat 2: Carson_Salak (23,097 in chips)
Seat 3: Hero (15,155 in chips)
Seat 4: Wendy_Kiwi (9,400 in chips)
Seat 5: Lida_Olive (6,148 in chips)
Seat 6: Retta_Salak (9,430 in chips)
Seat 7: Rod_Cabbage (15,350 in chips)
Seat 8: Lin_Tamarind (14,230 in chips)
Seat 9: Ashley_Fennel (12,705 in chips)
Lin_Tamarind: posts small blind 100
Ashley_Fennel: posts big blind 200
*** HOLE CARDS ***
Dealt to Hero [Ks 4h]
Eloy_Parsley: folds
Carson_Salak: folds
Hero: folds
Wendy_Kiwi: folds
Lida_Olive: folds
Retta_Salak: folds
Rod_Cabbage: folds
Lin_Tamarind: calls 100 
Ashley_Fennel: checks
*** FLOP *** [Ac 7c 6s]
Lin_Tamarind: bets 200 
Ashley_Fennel: folds
Uncalled bet (200) returned to Lin_Tamarind
Lin_Tamarind: doesn't show hand
Lin_Tamarind collected 400 from pot
*** SUMMARY ***
Total pot 400 | Rake 0
Board [Ac 7c 6s]
Seat 1: Eloy_Parsley mucked [9h 2d]
Seat 2: Carson_Salak mucked [Jc Qs]
Seat 3: Hero mucked [Ks 4h]
Seat 4: Wendy_Kiwi mucked [8s Td]
Seat 5: Lida_Olive mucked [5d 7s]
Seat 6: Retta_Salak mucked [Jh 5c]
Seat 7: Rod_Cabbage (button) mucked [3d Qd]
Seat 8: Lin_Tamarind (small blind) showed [Th 3h] and won (400)
Seat 9: Ashley_Fennel (big blind) mucked [8d Qh]



PokerStars Hand #3661295390: Tournament #21391319, $20+$2 - Hold'em No Limit (100/200) - 2018/04/06 22:58:26
Table '#18' Seat #8 is the button
Seat 1: Sybil_Bananas (11,482 in chips)
Seat 2: Bea_Alfalfa (23,097 in chips)
Seat 3: Hero (15,155 in chips)
Seat 4: Jaimee_Parsley (9,400 in chips)
Seat 5: Rowena_Arugula (6,148 in chips)
Seat 6: Mignon_Coconuts (9,430 in chips)
Seat 7: Emiko_Squash (15,350 in chips)
Seat 8: Divina_Chives (14,430 in chips)
Seat 9: Jewel_Basil (12,505 in chips)
Jewel_Basil: posts small blind 100
Sybil_Bananas: posts big blind 200
*** HOLE CARDS ***
Dealt to Hero [6h 7c]
Bea_Alfalfa: folds
Hero: folds
Jaimee_Parsley: raises 700 to 700
Rowena_Arugula: folds
Mignon_Coconuts: folds
Emiko_Squash: folds
Divina_Chives: folds
Jewel_Basil: folds
Sybil_Bananas: folds
Uncalled bet (500) returned to Jaimee_Parsley
Jaimee_Parsley: doesn't show hand
Jaimee_Parsley collected 500 from pot
*** SUMMARY ***
Total pot 500 | Rake 0
Seat 1: Sybil_Bananas (big blind) mucked [4h 5c]
Seat 2: Bea_Alfalfa mucked [Qd 8c]
Seat 3: Hero mucked [6h 7c]
Seat 4: Jaimee_Parsley showed [Ah Ad] and won (500)
Seat 5: Rowena_Arugula mucked [Kh 2c]
Seat 6: Mignon_Coconuts mucked [Td 6c]
Seat 7: Emiko_Squash mucked [Jh Tc]
Seat 8: Divina_Chives (button) mucked [3s 8d]
Seat 9: Jewel_Basil (small blind) mucked [7s 2d]



PokerStars Hand #3661295703: Tournament #21391319, $20+$2 - Hold'em No Limit (100/200) - 2018/04/06 22:58:56
Table '#18' Seat #9 is the button
Seat 1: Spring_Rutabaga (11,282 in chips)
Seat 2: Damien_Spinach (23,097 in chips)
Seat 3: Hero (15,155 in chips)
Seat 4: Yvone_Mango (9,700 in chips)
Seat 5: Davina_Honeydew (6,148 in chips)
Seat 6: Long_Peach (9,430 in chips)
Seat 7: Keith_Beans (15,350 in chips)
Seat 8: Angla_Kale (14,430 in chips)
Seat 9: Janae_Caraway (12,405 in chips)
Spring_Rutabaga: posts small blind 100
Damien_Spinach: posts big blind 200
*** HOLE CARDS ***
Dealt to Hero [4s Jh]
Hero: folds
Yvone_Mango: folds
Davina_Honeydew: raises 600 to 600
Long_Peach: folds
Keith_Beans: folds
Angla_Kale: folds
Janae_Caraway: folds
Spring_Rutabaga: calls 500 
Damien_Spinach: folds
*** FLOP *** [Tc Kc 3d]
Spring_Rutabaga: checks
Davina_Honeydew: bets 400 
Spring_Rutabaga: raises 1200 to 1200
Davina_Honeydew: raises 5148 to 5548 and is all-in
Spring_Rutabaga: calls 4348 
*** TURN *** [Tc Kc 3d] [Qh]
*** RIVER *** [Tc Kc 3d Qh] [6d]
*** SHOW DOWN ***
Spring_Rutabaga: shows [Kd Td] (two pair, Kings and Tens)
Davina_Honeydew: shows [Th Ad] (a pair of Tens)
Spring_Rutabaga collected 12496 from pot
Davina_Honeydew finished the tournament in 135th place
*** SUMMARY ***
Total pot 12496 | Rake 0
Board [Tc Kc 3d Qh 6d]
Seat 1: Spring_Rutabaga (small blind) showed [Kd Td] and won (12496) with two pair, Kings and Tens
Seat 2: Damien_Spinach (big blind) mucked [8h Jc]
Seat 3: Hero mucked [4s Jh]
Seat 4: Yvone_Mango mucked [5h 9s]
Seat 5: Davina_Honeydew showed [Th Ad] and lost with a pair of Tens
Seat 6: Long_Peach mucked [Js Qd]
Seat 7: Keith_Beans mucked [9c 2d]
Seat 8: Angla_Kale mucked [Ac 4d]
Seat 9: Janae_Caraway (button) mucked [6s 5s]



PokerStars Hand #3661296440: Tournament #21391319, $20+$2 - Hold'em No Limit (100/200) - 2018/04/06 22:59:56
Table '#18' Seat #1 is the button
Seat 1: Larae_Squash (17,630 in chips)
Seat 2: Curt_Kohlrabi (22,897 in chips)
Seat 3: Hero (15,155 in chips)
Seat 4: Avis_Rambutan (9,700 in chips)
Seat 5: Chong_Alfalfa (9,430 in chips)
Seat 6: Lonna_Yams (15,350 in chips)
Seat 7: Marty_Shallot (14,430 in chips)
Seat 8: Dann_Plum (12,405 in chips)
Curt_Kohlrabi: posts small blind 100
Hero: posts big blind 200
*** HOLE CARDS ***
Dealt to Hero [9h 5d]
Avis_Rambutan: folds
Chong_Alfalfa: folds
Lonna_Yams: folds
Marty_Shallot: folds
Dann_Plum: calls 200 
Larae_Squash: folds
Curt_Kohlrabi: folds
Hero: checks
*** FLOP *** [3d 5s Ks]
Hero: checks
Dann_Plum: checks
*** TURN *** [3d 5s Ks] [Th]
Hero: checks
Dann_Plum: checks
*** RIVER *** [3d 5s Ks Th] [Ah]
Hero: checks
Dann_Plum: bets 250 
Hero: folds
Uncalled bet (250) returned to Dann_Plum
Dann_Plum: doesn't show hand
Dann_Plum collected 500 from pot
*** SUMMARY ***
Total pot 500 | Rake 0
Board [3d 5s Ks Th Ah]
Seat 1: Larae_Squash (button) mucked [4c Kd]
Seat 2: Curt_Kohlrabi (small blind) mucked [7s 5h]
Seat 3: Hero (big blind) mucked [9h 5d]
Seat 4: Avis_Rambutan mucked [Kc 9d]
Seat 5: Chong_Alfalfa mucked [8s 4d]
Seat 6: Lonna_Yams mucked [Jd 6c]
Seat 7: Marty_Shallot mucked [5c Qd]
Seat 8: Dann_Plum showed [Ad 2d] and won (500)



PokerStars Hand #3661297399: Tournament #21391319, $20+$2 - Hold'em No Limit (100/200) - 2018/04/06 23:01:20
Table '#18' Seat #2 is the button
Seat 1: Leisa_Celery (17,630 in chips)
Seat 2: Mark_Beets (22,797 in chips)
Seat 3: Hero (14,955 in chips)
Seat 4: Ira_Lentils (9,700 in chips)
Seat 5: Ruben_Zuchinis (10,000 in chips)
Seat 6: Rico_Potatos (9,430 in chips)
Seat 7: Freddy_Peach (15,350 in chips)
Seat 8: Mario_Plumcot (14,430 in chips)
Seat 9: Ngan_Collard (12,705 in chips)
Hero: posts small blind 100
Ira_Lentils: posts big blind 200
*** HOLE CARDS ***
Dealt to Hero [4s 2s]
Ruben_Zuchinis: raises 600 to 600
Rico_Potatos: folds
Freddy_Peach: folds
Mario_Plumcot: folds
Ngan_Collard: folds
Leisa_Celery: folds
Mark_Beets: folds
Hero: folds
Ira_Lentils: folds
Uncalled bet (400) returned to Ruben_Zuchinis
Ruben_Zuchinis: doesn't show hand
Ruben_Zuchinis collected 500 from pot
*** SUMMARY ***
Total pot 500 | Rake 0
Seat 1: Leisa_Celery mucked [7d 9c]
Seat 2: Mark_Beets (button) mucked [Jh 7h]
Seat 3: Hero (small blind) mucked [4s 2s]
Seat 4: Ira_Lentils (big blind) mucked [2h Th]
Seat 5: Ruben_Zuchinis showed [Jc Tc] and won (500)
Seat 6: Rico_Potatos mucked [2c 7s]
Seat 7: Freddy_Peach mucked [As 6d]
Seat 8: Mario_Plumcot mucked [Js 4c]
Seat 9: Ngan_Collard mucked [6s Ah]



PokerStars Hand #3661298112: Tournament #21391319, $20+$2 - Hold'em No Limit (125/250) - 2018/04/06 23:02:23
Table '#18' Seat #3 is the button
Seat 1: Corey_Goji (17,630 in chips)
Seat 2: David_Juniper (22,797 in chips)
Seat 3: Hero (14,855 in chips)
Seat 4: Pierre_Lentils (9,500 in chips)
Seat 5: Grady_Tubers (10,300 in chips)
Seat 6: Spring_Lime (9,430 in chips)
Seat 7: Cathy_Plum (15,350 in chips)
Seat 8: Annice_Plumcot (14,430 in chips)
Seat 9: Vickie_Cucumber (12,705 in chips)
Corey_Goji: posts the ante 25
David_Juniper: posts the ante 25
Hero: posts the ante 25
Pierre_Lentils: posts the ante 25
Grady_Tubers: posts the ante 25
Spring_Lime: posts the ante 25
Cathy_Plum: posts the ante 25
Annice_Plumcot: posts the ante 25
Vickie_Cucumber: posts the ante 25
Pierre_Lentils: posts small blind 125
Grady_Tubers: posts big blind 250
*** HOLE CARDS ***
Dealt to Hero [3s Tc]
Spring_Lime: folds
Cathy_Plum: folds
Annice_Plumcot: folds
Vickie_Cucumber: folds
Corey_Goji: folds
David_Juniper: raises 575 to 575
Hero: folds
Pierre_Lentils: calls 450 
Grady_Tubers: calls 325 
*** FLOP *** [6s 8s Ac]
Pierre_Lentils: checks
Grady_Tubers: checks
David_Juniper: bets 1325 
Pierre_Lentils: folds
Grady_Tubers: calls 1325 
*** TURN *** [6s 8s Ac] [4s]
Grady_Tubers: checks
David_Juniper: checks
*** RIVER *** [6s 8s Ac 4s] [Kc]
Grady_Tubers: bets 2027 
David_Juniper: calls 2027 
*** SHOW DOWN ***
Grady_Tubers: shows [5s 5d] (a pair of Fives)
David_Juniper: shows [9h Ad] (a pair of Aces)
David_Juniper collected 8654 from pot
*** SUMMARY ***
Total pot 8654 | Rake 0
Board [6s 8s Ac 4s Kc]
Seat 1: Corey_Goji mucked [Ts 8d]
Seat 2: David_Juniper showed [9h Ad] and won (8654) with a pair of Aces
Seat 3: Hero (button) mucked [3s Tc]
Seat 4: Pierre_Lentils (small blind) mucked [Qs Th]
Seat 5: Grady_Tubers (big blind) showed [5s 5d] and lost with a pair of Fives
Seat 6: Spring_Lime mucked [Kh Jh]
Seat 7: Cathy_Plum mucked [7c 3h]
Seat 8: Annice_Plumcot mucked [Js 4c]
Seat 9: Vickie_Cucumber mucked [Kd 7h]



PokerStars Hand #3661299338: Tournament #21391319, $20+$2 - Hold'em No Limit (125/250) - 2018/04/06 23:04:11
Table '#18' Seat #3 is the button
Seat 1: Agueda_Cherry (17,605 in chips)
Seat 2: Hero (14,830 in chips)
Seat 3: Pia_Tat Soi (8,900 in chips)
Seat 4: Heidy_Habanero (6,348 in chips)
Seat 5: Ayako_Marjoram (9,405 in chips)
Seat 6: Vertie_Cayenne (15,325 in chips)
Seat 7: Hyon_Plantain (14,405 in chips)
Seat 8: Kittie_Lentils (12,680 in chips)
Agueda_Cherry: posts the ante 25
Hero: posts the ante 25
Pia_Tat Soi: posts the ante 25
Heidy_Habanero: posts the ante 25
Ayako_Marjoram: posts the ante 25
Vertie_Cayenne: posts the ante 25
Hyon_Plantain: posts the ante 25
Kittie_Lentils: posts the ante 25
Heidy_Habanero: posts small blind 125
Ayako_Marjoram: posts big blind 250
*** HOLE CARDS ***
Dealt to Hero [4c 8h]
Vertie_Cayenne: folds
Hyon_Plantain: raises 500 to 500
Kittie_Lentils: folds
Agueda_Cherry: folds
Hero: folds
Pia_Tat Soi: folds
Heidy_Habanero: folds
Ayako_Marjoram: folds
Uncalled bet (250) returned to Hyon_Plantain
Hyon_Plantain: doesn't show hand
Hyon_Plantain collected 825 from pot
*** SUMMARY ***
Total pot 825 | Rake 0
Seat 1: Agueda_Cherry mucked [8s Qh]
Seat 2: Hero mucked [4c 8h]
Seat 3: Pia_Tat Soi (button) mucked [4s Ah]
Seat 4: Heidy_Habanero (small blind) mucked [Jh 2s]
Seat 5: Ayako_Marjoram (big blind) mucked [3d Td]
Seat 6: Vertie_Cayenne mucked [8d 3h]
Seat 7: Hyon_Plantain showed [5h 5c] and won (825)
Seat 8: Kittie_Lentils mucked [6s Qc]



PokerStars Hand #3661299816: Tournament #21391319, $20+$2 - Hold'em No Limit (125/250) - 2018/04/06 23:04:53
Table '#18' Seat #4 is the button
Seat 1: Ming_Rosemary (17,580 in chips)
Seat 2: Hero (14,805 in chips)
Seat 3: Birdie_Grapes (8,875 in chips)
Seat 4: Lorie_Kale (6,198 in chips)
Seat 5: Tisa_Pomelo (9,130 in chips)
Seat 6: Marie_Peach (15,300 in chips)
Seat 7: Rae_Arugula (14,955 in chips)
Seat 8: Gwen_Quinoa (12,655 in chips)
Ming_Rosemary: posts the ante 25
Hero: posts the ante 25
Birdie_Grapes: posts the ante 25
Lorie_Kale: posts the ante 25
Tisa_Pomelo: posts the ante 25
Marie_Peach: posts the ante 25
Rae_Arugula: posts the ante 25
Gwen_Quinoa: posts the ante 25
Tisa_Pomelo: posts small blind 125
Marie_Peach: posts big blind 250
*** HOLE CARDS ***
Dealt to Hero [9d 7d]
Rae_Arugula: folds
Gwen_Quinoa: folds
Ming_Rosemary: folds
Hero: raises 600 to 600
Birdie_Grapes: raises 2375 to 2375
Lorie_Kale: folds
Tisa_Pomelo: folds
Marie_Peach: folds
Hero: folds
Uncalled bet (1775) returned to Birdie_Grapes
Birdie_Grapes: doesn't show hand
Birdie_Grapes collected 1775 from pot
*** SUMMARY ***
Total pot 1775 | Rake 0
Seat 1: Ming_Rosemary mucked [5d 2s]
Seat 2: Hero mucked [9d 7d]
Seat 3: Birdie_Grapes showed [Js Jh] and won (1775)
Seat 4: Lorie_Kale (button) mucked [4h 6d]
Seat 5: Tisa_Pomelo (small blind) mucked [Td 3s]
Seat 6: Marie_Peach (big blind) mucked [Th Kd]
Seat 7: Rae_Arugula mucked [3c 8s]
Seat 8: Gwen_Quinoa mucked [7s Qs]



PokerStars Hand #3661300682: Tournament #21391319, $20+$2 - Hold'em No Limit (125/250) - 2018/04/06 23:06:08
Table '#18' Seat #5 is the button
Seat 1: Jaime_Celery (17,555 in chips)
Seat 2: Hero (14,180 in chips)
Seat 3: Essie_Rutabaga (10,025 in chips)
Seat 4: Lara_Basil (6,173 in chips)
Seat 5: Sarah_Carrots (8,980 in chips)
Seat 6: Werner_Tomatoes (15,025 in chips)
Seat 7: Troy_Prunes (14,930 in chips)
Seat 8: Landon_Fennel (12,630 in chips)
Jaime_Celery: posts the ante 25
Hero: posts the ante 25
Essie_Rutabaga: posts the ante 25
Lara_Basil: posts the ante 25
Sarah_Carrots: posts the ante 25
Werner_Tomatoes: posts the ante 25
Troy_Prunes: posts the ante 25
Landon_Fennel: posts the ante 25
Werner_Tomatoes: posts small blind 125
Troy_Prunes: posts big blind 250
*** HOLE CARDS ***
Dealt to Hero [2c Qh]
Landon_Fennel: folds
Jaime_Celery: folds
Hero: folds
Essie_Rutabaga: folds
Lara_Basil: raises 716 to 716
Sarah_Carrots: folds
Werner_Tomatoes: folds
Troy_Prunes: calls 466 
*** FLOP *** [8h 2h 6s]
Troy_Prunes: bets 1574 
Lara_Basil: raises 5432 to 5432 and is all-in
Troy_Prunes: calls 3858 
*** TURN *** [8h 2h 6s] [9h]
*** RIVER *** [8h 2h 6s 9h] [4d]
*** SHOW DOWN ***
Lara_Basil: shows [Qd Ac] (high card Ace)
Troy_Prunes: shows [9c 7c] (a pair of Nines)
Troy_Prunes collected 12621 from pot
Lara_Basil finished the tournament in 138th place
*** SUMMARY ***
Total pot 12621 | Rake 0
Board [8h 2h 6s 9h 4d]
Seat 1: Jaime_Celery mucked [6c Ts]
Seat 2: Hero mucked [2c Qh]
Seat 3: Essie_Rutabaga mucked [8s 3c]
Seat 4: Lara_Basil showed [Qd Ac] and lost with high card Ace
Seat 5: Sarah_Carrots (button) mucked [5d 7d]
Seat 6: Werner_Tomatoes (small blind) mucked [Tc Qs]
Seat 7: Troy_Prunes (big blind) showed [9c 7c] and won (12621) with a pair of Nines
Seat 8: Landon_Fennel mucked [6d 3h]



PokerStars Hand #3661301471: Tournament #21391319, $20+$2 - Hold'em No Limit (125/250) - 2018/04/06 23:07:20
Table '#18' Seat #6 is the button
Seat 1: Faye_Cabbage (17,530 in chips)
Seat 2: Hisako_Jicama (10,000 in chips)
Seat 3: Hero (14,155 in chips)
Seat 4: Ava_Pears (10,000 in chips)
Seat 5: Davis_Tomatoes (8,955 in chips)
Seat 6: Maryln_Bok Choy (14,875 in chips)
Seat 7: Kyle_Grapes (21,378 in chips)
Seat 8: Miles_Parsley (12,605 in chips)
Faye_Cabbage: posts the ante 25
Hisako_Jicama: posts the ante 25
Hero: posts the ante 25
Ava_Pears: posts the ante 25
Davis_Tomatoes: posts the ante 25
Maryln_Bok Choy: posts the ante 25
Kyle_Grapes: posts the ante 25
Miles_Parsley: posts the ante 25
Kyle_Grapes: posts small blind 125
Miles_Parsley: posts big blind 250
*** HOLE CARDS ***
Dealt to Hero [Js Kc]
Faye_Cabbage: calls 250 
Hisako_Jicama: folds
Hero: folds
Ava_Pears: folds
Davis_Tomatoes: folds
Maryln_Bok Choy: folds
Kyle_Grapes: folds
Miles_Parsley: checks
*** FLOP *** [4c 7c Kh]
Miles_Parsley: checks
Faye_Cabbage: checks
*** TURN *** [4c 7c Kh] [Qd]
Miles_Parsley: checks
Faye_Cabbage: bets 450 
Miles_Parsley: folds
Uncalled bet (450) returned to Faye_Cabbage
Faye_Cabbage: doesn't show hand
Faye_Cabbage collected 825 from pot
*** SUMMARY ***
Total pot 825 | Rake 0
Board [4c 7c Kh Qd]
Seat 1: Faye_Cabbage showed [Ah 8s] and won (825)
Seat 2: Hisako_Jicama mucked [8d 9d]
Seat 3: Hero mucked [Js Kc]
Seat 4: Ava_Pears mucked [5d 9c]
Seat 5: Davis_Tomatoes mucked [As 5c]
Seat 6: Maryln_Bok Choy (button) mucked [Qs 9s]
Seat 7: Kyle_Grapes (small blind) mucked [Jh 5s]
Seat 8: Miles_Parsley (big blind) mucked [7d Th]



PokerStars Hand #3661302332: Tournament #21391319, $20+$2 - Hold'em No Limit (125/250) - 2018/04/06 23:08:38
Table '#18' Seat #8 is the button
Seat 1: Beula_Peas (18,080 in chips)
Seat 2: Sudie_Salak (9,975 in chips)
Seat 3: Hero (14,130 in chips)
Seat 4: Meta_Lychee (9,975 in chips)
Seat 5: Karina_Honeydew (10,000 in chips)
Seat 6: Magan_Goji (8,930 in chips)
Seat 7: Phebe_Pears (14,850 in chips)
Seat 8: Elena_Garlic (21,228 in chips)
Seat 9: Kizzy_Nettles (12,330 in chips)
Beula_Peas: posts the ante 25
Sudie_Salak: posts the ante 25
Hero: posts the ante 25
Meta_Lychee: posts the ante 25
Karina_Honeydew: posts the ante 25
Magan_Goji: posts the ante 25
Phebe_Pears: posts the ante 25
Elena_Garlic: posts the ante 25
Kizzy_Nettles: posts the ante 25
Kizzy_Nettles: posts small blind 125
Beula_Peas: posts big blind 250
*** HOLE CARDS ***
Dealt to Hero [Ac 8d]
Sudie_Salak: folds
Hero: folds
Meta_Lychee: folds
Karina_Honeydew: folds
Magan_Goji: raises 750 to 750
Phebe_Pears: calls 750 
Elena_Garlic: folds
Kizzy_Nettles: folds
Beula_Peas: calls 500 
*** FLOP *** [2d Jc 6c]
Beula_Peas: checks
Magan_Goji: checks
Phebe_Pears: checks
*** TURN *** [2d Jc 6c] [Td]
Beula_Peas: checks
Magan_Goji: checks
Phebe_Pears: bets 3607 
Beula_Peas: folds
Magan_Goji: folds
Uncalled bet (3607) returned to Phebe_Pears
Phebe_Pears: doesn't show hand
Phebe_Pears collected 2600 from pot
*** SUMMARY ***
Total pot 2600 | Rake 0
Board [2d Jc 6c Td]
Seat 1: Beula_Peas (big blind) mucked [Kc Qs]
Seat 2: Sudie_Salak mucked [4d 7c]
Seat 3: Hero mucked [Ac 8d]
Seat 4: Meta_Lychee mucked [Tc Jh]
Seat 5: Karina_Honeydew mucked [2s 4c]
Seat 6: Magan_Goji mucked [5c 5s]
Seat 7: Phebe_Pears showed [6s 6d] and won (2600)
Seat 8: Elena_Garlic (button) mucked [Jd 7d]
Seat 9: Kizzy_Nettles (small blind) mucked [2h Ah]



PokerStars Hand #3661303270: Tournament #21391319, $20+$2 - Hold'em No Limit (125/250) - 2018/04/06 23:09:59
Table '#18' Seat #9 is the button
Seat 1: Bret_Orange (17,305 in chips)
Seat 2: Reyna_Peppers (9,950 in chips)
Seat 3: Hero (14,105 in chips)
Seat 4: Elden_Cilantro (9,950 in chips)
Seat 5: Dennis_Squash (9,975 in chips)
Seat 6: Alexia_Squash (8,155 in chips)
Seat 7: Kenya_Celeriac (16,675 in chips)
Seat 8: Jeremy_Honeydew (21,203 in chips)
Seat 9: Lorita_Cucumber (12,180 in chips)
Bret_Orange: posts the ante 25
Reyna_Peppers: posts the ante 25
Hero: posts the ante 25
Elden_Cilantro: posts the ante 25
Dennis_Squash: posts the ante 25
Alexia_Squash: posts the ante 25
Kenya_Celeriac: posts the ante 25
Jeremy_Honeydew: posts the ante 25
Lorita_Cucumber: posts the ante 25
Bret_Orange: posts small blind 125
Reyna_Peppers: posts big blind 250
*** HOLE CARDS ***
Dealt to Hero [Jd 9d]
Hero: raises 600 to 600
Elden_Cilantro: raises 2400 to 2400
Dennis_Squash: folds
Alexia_Squash: folds
Kenya_Celeriac: folds
Jeremy_Honeydew: folds
Lorita_Cucumber: folds
Bret_Orange: folds
Reyna_Peppers: folds
Hero: folds
Uncalled bet (1800) returned to Elden_Cilantro
Elden_Cilantro: doesn't show hand
Elden_Cilantro collected 1800 from pot
*** SUMMARY ***
Total pot 1800 | Rake 0
Seat 1: Bret_Orange (small blind) mucked [4d 7s]
Seat 2: Reyna_Peppers (big blind) mucked [4c Ac]
Seat 3: Hero mucked [Jd 9d]
Seat 4: Elden_Cilantro showed [Kd As] and won (1800)
Seat 5: Dennis_Squash mucked [6s 8s]
Seat 6: Alexia_Squash mucked [Jc 6h]
Seat 7: Kenya_Celeriac mucked [4h 2c]
Seat 8: Jeremy_Honeydew mucked [Ah Td]
Seat 9: Lorita_Cucumber (button) mucked [5s 8c]



PokerStars Hand #3661304019: Tournament #21391319, $20+$2 - Hold'em No Limit (125/250) - 2018/04/06 23:11:08
Table '#18' Seat #1 is the button
Seat 1: Leo_Pomelo (17,155 in chips)
Seat 2: Ethyl_Lychee (9,675 in chips)
Seat 3: Hero (13,480 in chips)
Seat 4: Ressie_Mango (11,125 in chips)
Seat 5: Dean_Tabasco (9,950 in chips)
Seat 6: Chase_Cucumber (8,130 in chips)
Seat 7: Micah_Chili (16,650 in chips)
Seat 8: Lera_Soy (21,178 in chips)
Seat 9: Monet_Pumpkins (12,155 in chips)
Leo_Pomelo: posts the ante 25
Ethyl_Lychee: posts the ante 25
Hero: posts the ante 25
Ressie_Mango: posts the ante 25
Dean_Tabasco: posts the ante 25
Chase_Cucumber: posts the ante 25
Micah_Chili: posts the ante 25
Lera_Soy: posts the ante 25
Monet_Pumpkins: posts the ante 25
Ethyl_Lychee: posts small blind 125
Hero: posts big blind 250
*** HOLE CARDS ***
Dealt to Hero [2d 9c]
Ressie_Mango: folds
Dean_Tabasco: folds
Chase_Cucumber: folds
Micah_Chili: folds
Lera_Soy: folds
Monet_Pumpkins: folds
Leo_Pomelo: calls 250 
Ethyl_Lychee: folds
Hero: checks
*** FLOP *** [4d Ts 8c]
Hero: checks
Leo_Pomelo: checks
*** TURN *** [4d Ts 8c] [2s]
Hero: checks
Leo_Pomelo: checks
*** RIVER *** [4d Ts 8c 2s] [3h]
Hero: checks
Leo_Pomelo: checks
*** SHOW DOWN ***
Hero: shows [2d 9c] (a pair of Deuces)
Leo_Pomelo: Mucks [Kc 9d] (High Card)
Hero collected 850 from pot
*** SUMMARY ***
Total pot 850 | Rake 0
Board [4d Ts 8c 2s 3h]
Seat 1: Leo_Pomelo (button) mucked [Kc 9d]
Seat 2: Ethyl_Lychee (small blind) mucked [5c 7h]
Seat 3: Hero (big blind) showed [2d 9c] and won (850) with a pair of Deuces
Seat 4: Ressie_Mango mucked [5h Jd]
Seat 5: Dean_Tabasco mucked [3c 7s]
Seat 6: Chase_Cucumber mucked [Kd Js]
Seat 7: Micah_Chili mucked [6h Qh]
Seat 8: Lera_Soy mucked [8d Jc]
Seat 9: Monet_Pumpkins mucked [6s Td]



PokerStars Hand #3661305229: Tournament #21391319, $20+$2 - Hold'em No Limit (150/300) - 2018/04/06 23:12:59
Table '#18' Seat #2 is the button
Seat 1: Patria_Zuchinis (16,880 in chips)
Seat 2: Ramon_Onions (9,525 in chips)
Seat 3: Hero (14,055 in chips)
Seat 4: Jeanna_Alfalfa (11,100 in chips)
Seat 5: Ammie_Tubers (9,925 in chips)
Seat 6: Rosita_Shallot (8,105 in chips)
Seat 7: Sandee_Wasabi (16,625 in chips)
Seat 8: Boyce_Raisins (21,153 in chips)
Seat 9: Aurea_Habanero (12,130 in chips)
Patria_Zuchinis: posts the ante 30
Ramon_Onions: posts the ante 30
Hero: posts the ante 30
Jeanna_Alfalfa: posts the ante 30
Ammie_Tubers: posts the ante 30
Rosita_Shallot: posts the ante 30
Sandee_Wasabi: posts the ante 30
Boyce_Raisins: posts the ante 30
Aurea_Habanero: posts the ante 30
Hero: posts small blind 150
Jeanna_Alfalfa: posts big blind 300
*** HOLE CARDS ***
Dealt to Hero [4c 2s]
Ammie_Tubers: folds
Rosita_Shallot: folds
Sandee_Wasabi: folds
Boyce_Raisins: folds
Aurea_Habanero: folds
Patria_Zuchinis: folds
Ramon_Onions: folds
Hero: folds
Jeanna_Alfalfa: doesn't show hand
Uncalled bet (300) returned to Jeanna_Alfalfa
Jeanna_Alfalfa collected 420 from pot
*** SUMMARY ***
Total pot 420 | Rake 0
Seat 1: Patria_Zuchinis mucked [9s 3s]
Seat 2: Ramon_Onions (button) mucked [9d Ts]
Seat 3: Hero (small blind) mucked [4c 2s]
Seat 4: Jeanna_Alfalfa (big blind) showed [8d 6c] and won (420)
Seat 5: Ammie_Tubers mucked [6s Kc]
Seat 6: Rosita_Shallot mucked [7h 9h]
Seat 7: Sandee_Wasabi mucked [2h 9c]
Seat 8: Boyce_Raisins mucked [6d Ac]
Seat 9: Aurea_Habanero mucked [8s 5s]



PokerStars Hand #3661305779: Tournament #21391319, $20+$2 - Hold'em No Limit (150/300) - 2018/04/06 23:13:50
Table '#18' Seat #3 is the button
Seat 1: Yasmin_Carrots (16,850 in chips)
Seat 2: Sudie_Raisins (9,495 in chips)
Seat 3: Hero (13,875 in chips)
Seat 4: Laree_Lychee (11,490 in chips)
Seat 5: Denita_Fennel (9,895 in chips)
Seat 6: Carmon_Marjoram (8,075 in chips)
Seat 7: Violet_Chard (21,123 in chips)
Seat 8: Johana_Fennel (12,100 in chips)
Yasmin_Carrots: posts the ante 30
Sudie_Raisins: posts the ante 30
Hero: posts the ante 30
Laree_Lychee: posts the ante 30
Denita_Fennel: posts the ante 30
Carmon_Marjoram: posts the ante 30
Violet_Chard: posts the ante 30
Johana_Fennel: posts the ante 30
Laree_Lychee: posts small blind 150
Denita_Fennel: posts big blind 300
*** HOLE CARDS ***
Dealt to Hero [6s 7d]
Carmon_Marjoram: folds
Violet_Chard: folds
Johana_Fennel: folds
Yasmin_Carrots: calls 300 
Sudie_Raisins: folds
Hero: folds
Laree_Lychee: calls 150 
Denita_Fennel: checks
*** FLOP *** [4h Qh Qs]
Laree_Lychee: checks
Denita_Fennel: checks
Yasmin_Carrots: checks
*** TURN *** [4h Qh Qs] [4d]
Laree_Lychee: checks
Denita_Fennel: checks
Yasmin_Carrots: checks
*** RIVER *** [4h Qh Qs 4d] [3c]
Laree_Lychee: checks
Denita_Fennel: checks
Yasmin_Carrots: checks
*** SHOW DOWN ***
Laree_Lychee: shows [9h Kd] (two pair, Queens and Fours)
Denita_Fennel: Mucks [2s 7h] (Two pair)
Yasmin_Carrots: shows [7c Ad] (two pair, Queens and Fours)
Yasmin_Carrots collected 1140 from pot
*** SUMMARY ***
Total pot 1140 | Rake 0
Board [4h Qh Qs 4d 3c]
Seat 1: Yasmin_Carrots showed [7c Ad] and won (1140) with two pair, Queens and Fours
Seat 2: Sudie_Raisins mucked [Kh 2d]
Seat 3: Hero (button) mucked [6s 7d]
Seat 4: Laree_Lychee (small blind) showed [9h Kd] and lost with two pair, Queens and Fours
Seat 5: Denita_Fennel (big blind) mucked [2s 7h]
Seat 6: Carmon_Marjoram mucked [Ac 8h]
Seat 7: Violet_Chard mucked [5d 8s]
Seat 8: Johana_Fennel mucked [3h 4c]



PokerStars Hand #3661307417: Tournament #21391319, $20+$2 - Hold'em No Limit (150/300) - 2018/04/06 23:16:14
Table '#18' Seat #4 is the button
Seat 1: Kiyoko_Jujube (17,660 in chips)
Seat 2: Jere_Mulberry (9,465 in chips)
Seat 3: Hero (13,845 in chips)
Seat 4: Romana_Soy (11,160 in chips)
Seat 5: Abdul_Papaya (9,565 in chips)
Seat 6: Maryln_Juniper (8,045 in chips)
Seat 7: Genna_Lavender (10,000 in chips)
Seat 8: Carita_Habanero (21,093 in chips)
Seat 9: Emilee_Leek (12,070 in chips)
Kiyoko_Jujube: posts the ante 30
Jere_Mulberry: posts the ante 30
Hero: posts the ante 30
Romana_Soy: posts the ante 30
Abdul_Papaya: posts the ante 30
Maryln_Juniper: posts the ante 30
Genna_Lavender: posts the ante 30
Carita_Habanero: posts the ante 30
Emilee_Leek: posts the ante 30
Abdul_Papaya: posts small blind 150
Maryln_Juniper: posts big blind 300
*** HOLE CARDS ***
Dealt to Hero [Ah 4h]
Genna_Lavender: folds
Carita_Habanero: folds
Emilee_Leek: folds
Kiyoko_Jujube: folds
Jere_Mulberry: raises 900 to 900
Hero: folds
Romana_Soy: folds
Abdul_Papaya: folds
Maryln_Juniper: folds
Uncalled bet (600) returned to Jere_Mulberry
Jere_Mulberry: doesn't show hand
Jere_Mulberry collected 1020 from pot
*** SUMMARY ***
Total pot 1020 | Rake 0
Seat 1: Kiyoko_Jujube mucked [7s 4d]
Seat 2: Jere_Mulberry showed [9s Ac] and won (1020)
Seat 3: Hero mucked [Ah 4h]
Seat 4: Romana_Soy (button) mucked [Ad 7c]
Seat 5: Abdul_Papaya (small blind) mucked [2s 5c]
Seat 6: Maryln_Juniper (big blind) mucked [5h Qc]
Seat 7: Genna_Lavender mucked [Qs 8d]
Seat 8: Carita_Habanero mucked [Tc 8c]
Seat 9: Emilee_Leek mucked [Td 9d]



PokerStars Hand #3661308142: Tournament #21391319, $20+$2 - Hold'em No Limit (150/300) - 2018/04/06 23:17:17
Table '#18' Seat #5 is the button
Seat 1: Moses_Peppers (17,630 in chips)
Seat 2: Gary_Plantain (10,155 in chips)
Seat 3: Hero (13,815 in chips)
Seat 4: Albert_Pomelo (11,130 in chips)
Seat 5: Pennie_Quince (9,385 in chips)
Seat 6: Elnora_Marjoram (7,715 in chips)
Seat 7: Trudy_Fennel (9,970 in chips)
Seat 8: Pei_Yams (21,063 in chips)
Seat 9: Paige_Bok Choy (12,040 in chips)
Moses_Peppers: posts the ante 30
Gary_Plantain: posts the ante 30
Hero: posts the ante 30
Albert_Pomelo: posts the ante 30
Pennie_Quince: posts the ante 30
Elnora_Marjoram: posts the ante 30
Trudy_Fennel: posts the ante 30
Pei_Yams: posts the ante 30
Paige_Bok Choy: posts the ante 30
Elnora_Marjoram: posts small blind 150
Trudy_Fennel: posts big blind 300
*** HOLE CARDS ***
Dealt to Hero [Kh 8s]
Pei_Yams: folds
Paige_Bok Choy: folds
Moses_Peppers: folds
Gary_Plantain: folds
Hero: folds
Albert_Pomelo: raises 1320 to 1320
Pennie_Quince: folds
Elnora_Marjoram: folds
Trudy_Fennel: folds
Uncalled bet (1020) returned to Albert_Pomelo
Albert_Pomelo: doesn't show hand
Albert_Pomelo collected 1020 from pot
*** SUMMARY ***
Total pot 1020 | Rake 0
Seat 1: Moses_Peppers mucked [Qs 8c]
Seat 2: Gary_Plantain mucked [6h 2d]
Seat 3: Hero mucked [Kh 8s]
Seat 4: Albert_Pomelo showed [Td Th] and won (1020)
Seat 5: Pennie_Quince (button) mucked [3d 4s]
Seat 6: Elnora_Marjoram (small blind) mucked [5d 5c]
Seat 7: Trudy_Fennel (big blind) mucked [Jh 5s]
Seat 8: Pei_Yams mucked [9h 6s]
Seat 9: Paige_Bok Choy mucked [6c Jc]



PokerStars Hand #3661308758: Tournament #21391319, $20+$2 - Hold'em No Limit (150/300) - 2018/04/06 23:18:11
Table '#18' Seat #6 is the button
Seat 1: Marlyn_Peppers (17,600 in chips)
Seat 2: Bennie_Tabasco (10,125 in chips)
Seat 3: Hero (13,785 in chips)
Seat 4: Audry_Dates (11,820 in chips)
Seat 5: Gino_Celery (9,355 in chips)
Seat 6: Hal_Basil (7,535 in chips)
Seat 7: Morton_Pears (9,640 in chips)
Seat 8: Sheri_Goji (21,033 in chips)
Seat 9: Hoa_Bok Choy (12,010 in chips)
Marlyn_Peppers: posts the ante 30
Bennie_Tabasco: posts the ante 30
Hero: posts the ante 30
Audry_Dates: posts the ante 30
Gino_Celery: posts the ante 30
Hal_Basil: posts the ante 30
Morton_Pears: posts the ante 30
Sheri_Goji: posts the ante 30
Hoa_Bok Choy: posts the ante 30
Morton_Pears: posts small blind 150
Sheri_Goji: posts big blind 300
*** HOLE CARDS ***
Dealt to Hero [Js Jd]
Hoa_Bok Choy: folds
Marlyn_Peppers: folds
Bennie_Tabasco: folds
Hero: raises 700 to 700
Audry_Dates: folds
Gino_Celery: calls 700 
Hal_Basil: calls 700 
Morton_Pears: folds
Sheri_Goji: folds
*** FLOP *** [Ac Qh 6d]
Hero: bets 999 
Gino_Celery: folds
Hal_Basil: calls 999 
*** TURN *** [Ac Qh 6d] [Jh]
Hero: bets 2000 
Hal_Basil: raises 5806 to 5806 and is all-in
Hero: calls 3806 
*** RIVER *** [Ac Qh 6d Jh] [6h]
*** SHOW DOWN ***
Hero: shows [Js Jd] (a full house, Jacks full of Sixes)
Hal_Basil: shows [Qd Ah] (two pair, Aces and Queens)
Hero collected 16430 from pot
Hal_Basil finished the tournament in 149th place
*** SUMMARY ***
Total pot 16430 | Rake 0
Board [Ac Qh 6d Jh 6h]
Seat 1: Marlyn_Peppers mucked [Th 7h]
Seat 2: Bennie_Tabasco mucked [Ks 2s]
Seat 3: Hero showed [Js Jd] and won (16430) with a full house, Jacks full of Sixes
Seat 4: Audry_Dates mucked [4c 8h]
Seat 5: Gino_Celery mucked [3s 4s]
Seat 6: Hal_Basil (button) showed [Qd Ah] and lost with two pair, Aces and Queens
Seat 7: Morton_Pears (small blind) mucked [4h Qs]
Seat 8: Sheri_Goji (big blind) mucked [6c Kh]
Seat 9: Hoa_Bok Choy mucked [8d 7s]



PokerStars Hand #3661309899: Tournament #21391319, $20+$2 - Hold'em No Limit (150/300) - 2018/04/06 23:19:50
Table '#18' Seat #6 is the button
Seat 1: Taylor_Orange (17,570 in chips)
Seat 2: Marry_Bananas (10,095 in chips)
Seat 3: Hero (22,680 in chips)
Seat 4: Linda_Skirret (11,790 in chips)
Seat 5: Bonita_Arugula (8,625 in chips)
Seat 6: Eugena_Ginger (9,460 in chips)
Seat 7: Kami_Anise (20,703 in chips)
Seat 8: Otha_Nettles (11,980 in chips)
Taylor_Orange: posts the ante 30
Marry_Bananas: posts the ante 30
Hero: posts the ante 30
Linda_Skirret: posts the ante 30
Bonita_Arugula: posts the ante 30
Eugena_Ginger: posts the ante 30
Kami_Anise: posts the ante 30
Otha_Nettles: posts the ante 30
Kami_Anise: posts small blind 150
Otha_Nettles: posts big blind 300
*** HOLE CARDS ***
Dealt to Hero [5c 9h]
Taylor_Orange: folds
Marry_Bananas: folds
Hero: folds
Linda_Skirret: folds
Bonita_Arugula: folds
Eugena_Ginger: raises 1200 to 1200
Kami_Anise: raises 20523 to 20673 and is all-in
Otha_Nettles: folds
Eugena_Ginger: calls 8230 and is all-in
*** FLOP *** [Kc 2d Ks]
*** TURN *** [Kc 2d Ks] [8c]
*** RIVER *** [Kc 2d Ks 8c] [4c]
*** SHOW DOWN ***
Eugena_Ginger: shows [Qd Jc] (a pair of Kings)
Kami_Anise: shows [9d Kd] (three of a kind, Kings)
Uncalled bet (11243) returned to Kami_Anise
Kami_Anise collected 19400 from pot
Eugena_Ginger finished the tournament in 148th place
*** SUMMARY ***
Total pot 19400 | Rake 0
Board [Kc 2d Ks 8c 4c]
Seat 1: Taylor_Orange mucked [9c As]
Seat 2: Marry_Bananas mucked [2c 8d]
Seat 3: Hero mucked [5c 9h]
Seat 4: Linda_Skirret mucked [7s 6d]
Seat 5: Bonita_Arugula mucked [Jd 5h]
Seat 6: Eugena_Ginger (button) showed [Qd Jc] and lost with a pair of Kings
Seat 7: Kami_Anise (small blind) showed [9d Kd] and won (19400) with three of a kind, Kings
Seat 8: Otha_Nettles (big blind) mucked [Jh Td]



PokerStars Hand #3661310670: Tournament #21391319, $20+$2 - Hold'em No Limit (150/300) - 2018/04/06 23:20:56
Table '#18' Seat #6 is the button
Seat 1: Frank_Kiwi (17,540 in chips)
Seat 2: Thi_Carrots (10,065 in chips)
Seat 3: Hero (22,650 in chips)
Seat 4: Delena_Cayenne (11,760 in chips)
Seat 5: Logan_Plumcot (8,595 in chips)
Seat 6: Jessi_Mulberry (30,643 in chips)
Seat 7: Adan_Wasabi (11,650 in chips)
Frank_Kiwi: posts the ante 30
Thi_Carrots: posts the ante 30
Hero: posts the ante 30
Delena_Cayenne: posts the ante 30
Logan_Plumcot: posts the ante 30
Jessi_Mulberry: posts the ante 30
Adan_Wasabi: posts the ante 30
Adan_Wasabi: posts small blind 150
Frank_Kiwi: posts big blind 300
*** HOLE CARDS ***
Dealt to Hero [3c 2h]
Thi_Carrots: folds
Hero: folds
Delena_Cayenne: folds
Logan_Plumcot: folds
Jessi_Mulberry: folds
Adan_Wasabi: raises 750 to 900
Frank_Kiwi: folds
Uncalled bet (600) returned to Adan_Wasabi
Adan_Wasabi: doesn't show hand
Adan_Wasabi collected 810 from pot
*** SUMMARY ***
Total pot 810 | Rake 0
Seat 1: Frank_Kiwi (big blind) mucked [4c 2c]
Seat 2: Thi_Carrots mucked [4d 4h]
Seat 3: Hero mucked [3c 2h]
Seat 4: Delena_Cayenne mucked [6d Jh]
Seat 5: Logan_Plumcot mucked [8c Qd]
Seat 6: Jessi_Mulberry (button) mucked [2d 9c]
Seat 7: Adan_Wasabi (small blind) showed [Tc Td] and won (810)



PokerStars Hand #3661311473: Tournament #21391319, $20+$2 - Hold'em No Limit (200/400) - 2018/04/06 23:22:08
Table '#18' Seat #8 is the button
Seat 1: Keenan_Spinach (17,210 in chips)
Seat 2: Jerry_Rhubarb (10,035 in chips)
Seat 3: Hero (22,620 in chips)
Seat 4: Keli_Apples (11,730 in chips)
Seat 5: Kristy_Daikon (8,565 in chips)
Seat 6: Sadye_Plantain (10,000 in chips)
Seat 7: Rickey_Kale (30,613 in chips)
Seat 8: Santa_Salak (12,130 in chips)
Keenan_Spinach: posts the ante 40
Jerry_Rhubarb: posts the ante 40
Hero: posts the ante 40
Keli_Apples: posts the ante 40
Kristy_Daikon: posts the ante 40
Sadye_Plantain: posts the ante 40
Rickey_Kale: posts the ante 40
Santa_Salak: posts the ante 40
Keenan_Spinach: posts small blind 200
Jerry_Rhubarb: posts big blind 400
*** HOLE CARDS ***
Dealt to Hero [2d 5c]
Hero: folds
Keli_Apples: folds
Kristy_Daikon: folds
Sadye_Plantain: folds
Rickey_Kale: raises 800 to 800
Santa_Salak: folds
Keenan_Spinach: folds
Jerry_Rhubarb: folds
Uncalled bet (400) returned to Rickey_Kale
Rickey_Kale: doesn't show hand
Rickey_Kale collected 1320 from pot
*** SUMMARY ***
Total pot 1320 | Rake 0
Seat 1: Keenan_Spinach (small blind) mucked [Qc 7h]
Seat 2: Jerry_Rhubarb (big blind) mucked [6c 2c]
Seat 3: Hero mucked [2d 5c]
Seat 4: Keli_Apples mucked [8h Qd]
Seat 5: Kristy_Daikon mucked [Ks 6h]
Seat 6: Sadye_Plantain mucked [3h 9c]
Seat 7: Rickey_Kale showed [5h 5s] and won (1320)
Seat 8: Santa_Salak (button) mucked [Kd Td]



PokerStars Hand #3661311997: Tournament #21391319, $20+$2 - Hold'em No Limit (200/400) - 2018/04/06 23:22:59
Table '#18' Seat #1 is the button
Seat 1: Kandi_Tomatoes (16,970 in chips)
Seat 2: Elmira_Lemon (9,595 in chips)
Seat 3: Hero (22,580 in chips)
Seat 4: Terisa_Raisins (11,690 in chips)
Seat 5: Annis_Anise (8,525 in chips)
Seat 6: Palma_Tat Soi (9,960 in chips)
Seat 7: Phuong_Celery (10,000 in chips)
Seat 8: Bruno_Jicama (31,493 in chips)
Seat 9: Mickie_Wasabi (12,090 in chips)
Kandi_Tomatoes: posts the ante 40
Elmira_Lemon: posts the ante 40
Hero: posts the ante 40
Terisa_Raisins: posts the ante 40
Annis_Anise: posts the ante 40
Palma_Tat Soi: posts the ante 40
Phuong_Celery: posts the ante 40
Bruno_Jicama: posts the ante 40
Mickie_Wasabi: posts the ante 40
Elmira_Lemon: posts small blind 200
Hero: posts big blind 400
*** HOLE CARDS ***
Dealt to Hero [2d 5d]
Terisa_Raisins: folds
Annis_Anise: calls 400 
Palma_Tat Soi: folds
Phuong_Celery: raises 2800 to 2800
Bruno_Jicama: folds
Mickie_Wasabi: folds
Kandi_Tomatoes: folds
Elmira_Lemon: folds
Hero: folds
Annis_Anise: folds
*** SHOW DOWN ***
Phuong_Celery: shows [Ac Kc] (high card Ace)
Uncalled bet (2400) returned to Phuong_Celery
Phuong_Celery collected 1760 from pot
*** SUMMARY ***
Total pot 1760 | Rake 0
Seat 1: Kandi_Tomatoes (button) mucked [7d Ah]
Seat 2: Elmira_Lemon (small blind) mucked [5c 2s]
Seat 3: Hero (big blind) mucked [2d 5d]
Seat 4: Terisa_Raisins mucked [Jd 8s]
Seat 5: Annis_Anise mucked [8c 6c]
Seat 6: Palma_Tat Soi mucked [2h 9d]
Seat 7: Phuong_Celery showed [Ac Kc] and won (1760) with high card Ace
Seat 8: Bruno_Jicama mucked [5h 3s]
Seat 9: Mickie_Wasabi mucked [Qc 4h]



PokerStars Hand #3661312735: Tournament #21391319, $20+$2 - Hold'em No Limit (200/400) - 2018/04/06 23:24:05
Table '#18' Seat #2 is the button
Seat 1: Hilde_Coconuts (16,930 in chips)
Seat 2: Anette_Turnips (9,355 in chips)
Seat 3: Hero (22,140 in chips)
Seat 4: Twila_Peas (11,650 in chips)
Seat 5: Rheba_Avocados (8,085 in chips)
Seat 6: Jina_Collard (9,920 in chips)
Seat 7: Anisa_Kohlrabi (11,320 in chips)
Seat 8: Violet_Plum (31,453 in chips)
Seat 9: Lupe_Salak (12,050 in chips)
Hilde_Coconuts: posts the ante 40
Anette_Turnips: posts the ante 40
Hero: posts the ante 40
Twila_Peas: posts the ante 40
Rheba_Avocados: posts the ante 40
Jina_Collard: posts the ante 40
Anisa_Kohlrabi: posts the ante 40
Violet_Plum: posts the ante 40
Lupe_Salak: posts the ante 40
Hero: posts small blind 200
Twila_Peas: posts big blind 400
*** HOLE CARDS ***
Dealt to Hero [8c Kh]
Rheba_Avocados: calls 400 
Jina_Collard: calls 400 
Anisa_Kohlrabi: folds
Violet_Plum: raises 1600 to 1600
Lupe_Salak: folds
Hilde_Coconuts: folds
Anette_Turnips: folds
Hero: folds
Twila_Peas: folds
Rheba_Avocados: calls 1200 
Jina_Collard: calls 1200 
*** FLOP *** [As 4d 3h]
Rheba_Avocados: checks
Jina_Collard: checks
Violet_Plum: bets 1961 
Rheba_Avocados: calls 1961 
Jina_Collard: calls 1961 
*** TURN *** [As 4d 3h] [6c]
Rheba_Avocados: checks
Jina_Collard: bets 400 
Violet_Plum: folds
Rheba_Avocados: raises 2400 to 2400
Jina_Collard: calls 2000 
*** RIVER *** [As 4d 3h 6c] [9h]
Rheba_Avocados: bets 2084 and is all-in
Jina_Collard: folds
Uncalled bet (2084) returned to Rheba_Avocados
Rheba_Avocados: doesn't show hand
Rheba_Avocados collected 16443 from pot
*** SUMMARY ***
Total pot 16443 | Rake 0
Board [As 4d 3h 6c 9h]
Seat 1: Hilde_Coconuts mucked [7s Qd]
Seat 2: Anette_Turnips (button) mucked [5s 2d]
Seat 3: Hero (small blind) mucked [8c Kh]
Seat 4: Twila_Peas (big blind) mucked [3c Kc]
Seat 5: Rheba_Avocados showed [6d 6s] and won (16443)
Seat 6: Jina_Collard mucked [Qh 5h]
Seat 7: Anisa_Kohlrabi mucked [6h 7c]
Seat 8: Violet_Plum mucked [Kd Jd]
Seat 9: Lupe_Salak mucked [Qc 7h]



PokerStars Hand #3661314035: Tournament #21391319, $20+$2 - Hold'em No Limit (200/400) - 2018/04/06 23:26:02
Table '#18' Seat #3 is the button
Seat 1: Ona_Ugli (16,890 in chips)
Seat 2: Sandie_Satsuma (9,315 in chips)
Seat 3: Hero (21,900 in chips)
Seat 4: Rocio_Skirret (11,210 in chips)
Seat 5: Tari_Goji (18,527 in chips)
Seat 6: Breana_Chives (3,919 in chips)
Seat 7: Kit_Parnsip (11,280 in chips)
Seat 8: Jenell_Lavender (27,852 in chips)
Seat 9: Loida_Raisins (12,010 in chips)
Ona_Ugli: posts the ante 40
Sandie_Satsuma: posts the ante 40
Hero: posts the ante 40
Rocio_Skirret: posts the ante 40
Tari_Goji: posts the ante 40
Breana_Chives: posts the ante 40
Kit_Parnsip: posts the ante 40
Jenell_Lavender: posts the ante 40
Loida_Raisins: posts the ante 40
Rocio_Skirret: posts small blind 200
Tari_Goji: posts big blind 400
*** HOLE CARDS ***
Dealt to Hero [3d As]
Breana_Chives: folds
Kit_Parnsip: calls 400 
Jenell_Lavender: folds
Loida_Raisins: folds
Ona_Ugli: folds
Sandie_Satsuma: folds
Hero: folds
Rocio_Skirret: calls 200 
Tari_Goji: checks
*** FLOP *** [4h 4s Qc]
Rocio_Skirret: checks
Tari_Goji: checks
Kit_Parnsip: bets 1560 
Rocio_Skirret: folds
Tari_Goji: folds
Uncalled bet (1560) returned to Kit_Parnsip
Kit_Parnsip: doesn't show hand
Kit_Parnsip collected 1560 from pot
*** SUMMARY ***
Total pot 1560 | Rake 0
Board [4h 4s Qc]
Seat 1: Ona_Ugli mucked [8h 3h]
Seat 2: Sandie_Satsuma mucked [Ah 7s]
Seat 3: Hero (button) mucked [3d As]
Seat 4: Rocio_Skirret (small blind) mucked [Ks 5d]
Seat 5: Tari_Goji (big blind) mucked [Th 2h]
Seat 6: Breana_Chives mucked [4c Jd]
Seat 7: Kit_Parnsip showed [Tc Qs] and won (1560)
Seat 8: Jenell_Lavender mucked [5s Ad]
Seat 9: Loida_Raisins mucked [3c Kd]



PokerStars Hand #3661315176: Tournament #21391319, $20+$2 - Hold'em No Limit (200/400) - 2018/04/06 23:27:44
Table '#18' Seat #3 is the button
Seat 1: Timika_Rosemary (16,850 in chips)
Seat 2: Hero (21,860 in chips)
Seat 3: Cleora_Sprouts (10,770 in chips)
Seat 4: Indira_Raisins (18,087 in chips)
Seat 5: Elvina_Prunes (3,879 in chips)
Seat 6: Hailey_Mango (12,400 in chips)
Seat 7: Alesia_Coconuts (27,812 in chips)
Seat 8: Fran_Onions (11,970 in chips)
Timika_Rosemary: posts the ante 40
Hero: posts the ante 40
Cleora_Sprouts: posts the ante 40
Indira_Raisins: posts the ante 40
Elvina_Prunes: posts the ante 40
Hailey_Mango: posts the ante 40
Alesia_Coconuts: posts the ante 40
Fran_Onions: posts the ante 40
Indira_Raisins: posts small blind 200
Elvina_Prunes: posts big blind 400
*** HOLE CARDS ***
Dealt to Hero [Ad Tc]
Hailey_Mango: folds
Alesia_Coconuts: folds
Fran_Onions: folds
Timika_Rosemary: calls 400 
Hero: calls 400 
Cleora_Sprouts: calls 400 
Indira_Raisins: folds
Elvina_Prunes: raises 3439 to 3839 and is all-in
Timika_Rosemary: calls 3439 
Hero: folds
Cleora_Sprouts: folds
*** FLOP *** [6s Td Qs]
*** TURN *** [6s Td Qs] [8d]
*** RIVER *** [6s Td Qs 8d] [6d]
*** SHOW DOWN ***
Timika_Rosemary: shows [9c 9d] (two pair, Nines and Sixes)
Elvina_Prunes: shows [6c Ah] (three of a kind, Sixes)
Elvina_Prunes collected 8998 from pot
*** SUMMARY ***
Total pot 8998 | Rake 0
Board [6s Td Qs 8d 6d]
Seat 1: Timika_Rosemary showed [9c 9d] and lost with two pair, Nines and Sixes
Seat 2: Hero mucked [Ad Tc]
Seat 3: Cleora_Sprouts (button) mucked [Qh Kc]
Seat 4: Indira_Raisins (small blind) mucked [Th 2d]
Seat 5: Elvina_Prunes (big blind) showed [6c Ah] and won (8998) with three of a kind, Sixes
Seat 6: Hailey_Mango mucked [2h 3s]
Seat 7: Alesia_Coconuts mucked [8s 9s]
Seat 8: Fran_Onions mucked [4s Qd]



PokerStars Hand #3661316172: Tournament #21391319, $20+$2 - Hold'em No Limit (200/400) - 2018/04/06 23:29:17
Table '#18' Seat #5 is the button
Seat 1: Jerold_Lime (12,971 in chips)
Seat 2: Sonja_Anise (10,000 in chips)
Seat 3: Hero (21,420 in chips)
Seat 4: Shari_Tubers (10,330 in chips)
Seat 5: David_Leek (17,847 in chips)
Seat 6: Pansy_Olive (8,998 in chips)
Seat 7: Misti_Salak (12,360 in chips)
Seat 8: Edward_Squash (27,772 in chips)
Seat 9: Lavona_Dates (11,930 in chips)
Jerold_Lime: posts the ante 40
Sonja_Anise: posts the ante 40
Hero: posts the ante 40
Shari_Tubers: posts the ante 40
David_Leek: posts the ante 40
Pansy_Olive: posts the ante 40
Misti_Salak: posts the ante 40
Edward_Squash: posts the ante 40
Lavona_Dates: posts the ante 40
Pansy_Olive: posts small blind 200
Misti_Salak: posts big blind 400
*** HOLE CARDS ***
Dealt to Hero [Ks Ah]
Edward_Squash: folds
Lavona_Dates: folds
Jerold_Lime: folds
Sonja_Anise: folds
Hero: raises 999 to 999
Shari_Tubers: folds
David_Leek: calls 999 
Pansy_Olive: calls 799 
Misti_Salak: calls 599 
*** FLOP *** [Th Qd Kh]
Pansy_Olive: checks
Misti_Salak: checks
Hero: checks
David_Leek: checks
*** TURN *** [Th Qd Kh] [8s]
Pansy_Olive: bets 400 
Misti_Salak: raises 1600 to 1600
Hero: calls 1600 
David_Leek: folds
Pansy_Olive: calls 1200 
*** RIVER *** [Th Qd Kh 8s] [Kc]
Pansy_Olive: checks
Misti_Salak: bets 9156 
Hero: calls 9156 
Pansy_Olive: folds
*** SHOW DOWN ***
Misti_Salak: shows [Jh 9c] (a straight, Nine to King)
Hero: Mucks [Ks Ah] (Three of a kind)
Misti_Salak collected 27468 from pot
*** SUMMARY ***
Total pot 27468 | Rake 0
Board [Th Qd Kh 8s Kc]
Seat 1: Jerold_Lime mucked [3c As]
Seat 2: Sonja_Anise mucked [7s 4h]
Seat 3: Hero mucked [Ks Ah]
Seat 4: Shari_Tubers mucked [6h Ac]
Seat 5: David_Leek (button) mucked [5c 4c]
Seat 6: Pansy_Olive (small blind) mucked [3s Ts]
Seat 7: Misti_Salak (big blind) showed [Jh 9c] and won (27468) with a straight, Nine to King
Seat 8: Edward_Squash mucked [2c 5s]
Seat 9: Lavona_Dates mucked [Js 9h]



PokerStars Hand #3661317943: Tournament #21391319, $20+$2 - Hold'em No Limit (250/500) - 2018/04/06 23:31:56
Table '#18' Seat #6 is the button
Seat 1: Leanne_Cabbage (12,931 in chips)
Seat 2: Kiera_Pumpkins (9,960 in chips)
Seat 3: Hero (9,625 in chips)
Seat 4: Alexis_Avocados (10,290 in chips)
Seat 5: Carlos_Garlic (16,808 in chips)
Seat 6: Ronny_Turnips (6,359 in chips)
Seat 7: Verona_Plumcot (28,033 in chips)
Seat 8: Kylee_Coconuts (27,732 in chips)
Seat 9: Pattie_Beets (11,890 in chips)
Leanne_Cabbage: posts the ante 50
Kiera_Pumpkins: posts the ante 50
Hero: posts the ante 50
Alexis_Avocados: posts the ante 50
Carlos_Garlic: posts the ante 50
Ronny_Turnips: posts the ante 50
Verona_Plumcot: posts the ante 50
Kylee_Coconuts: posts the ante 50
Pattie_Beets: posts the ante 50
Verona_Plumcot: posts small blind 250
Kylee_Coconuts: posts big blind 500
*** HOLE CARDS ***
Dealt to Hero [Ad Ac]
Pattie_Beets: folds
Leanne_Cabbage: folds
Kiera_Pumpkins: folds
Hero: raises 1222 to 1222
Alexis_Avocados: folds
Carlos_Garlic: folds
Ronny_Turnips: calls 1222 
Verona_Plumcot: calls 972 
Kylee_Coconuts: folds
*** FLOP *** [4d 2d 6s]
Verona_Plumcot: checks
Hero: bets 2333 
Ronny_Turnips: folds
Verona_Plumcot: folds
Uncalled bet (2333) returned to Hero
Hero: doesn't show hand
Hero collected 4616 from pot
*** SUMMARY ***
Total pot 4616 | Rake 0
Board [4d 2d 6s]
Seat 1: Leanne_Cabbage mucked [Qs 2c]
Seat 2: Kiera_Pumpkins mucked [7c 5d]
Seat 3: Hero showed [Ad Ac] and won (4616)
Seat 4: Alexis_Avocados mucked [3h 7s]
Seat 5: Carlos_Garlic mucked [3c Jh]
Seat 6: Ronny_Turnips (button) mucked [8s Qd]
Seat 7: Verona_Plumcot (small blind) mucked [As Tc]
Seat 8: Kylee_Coconuts (big blind) mucked [3s 9d]
Seat 9: Pattie_Beets mucked [4c Js]



PokerStars Hand #3661319421: Tournament #21391319, $20+$2 - Hold'em No Limit (250/500) - 2018/04/06 23:34:08
Table '#18' Seat #7 is the button
Seat 1: Vada_Peas (12,881 in chips)
Seat 2: Sallie_Cayenne (9,910 in chips)
Seat 3: Hero (12,969 in chips)
Seat 4: Jackie_Juniper (10,240 in chips)
Seat 5: Celena_Alfalfa (16,758 in chips)
Seat 6: Chong_Broccoli (5,087 in chips)
Seat 7: Leisa_Fennel (26,761 in chips)
Seat 8: Lavina_Satsuma (27,182 in chips)
Seat 9: Renna_Chili (11,840 in chips)
Vada_Peas: posts the ante 50
Sallie_Cayenne: posts the ante 50
Hero: posts the ante 50
Jackie_Juniper: posts the ante 50
Celena_Alfalfa: posts the ante 50
Chong_Broccoli: posts the ante 50
Leisa_Fennel: posts the ante 50
Lavina_Satsuma: posts the ante 50
Renna_Chili: posts the ante 50
Lavina_Satsuma: posts small blind 250
Renna_Chili: posts big blind 500
*** HOLE CARDS ***
Dealt to Hero [Ad Ts]
Vada_Peas: calls 500 
Sallie_Cayenne: folds
Hero: folds
Jackie_Juniper: folds
Celena_Alfalfa: folds
Chong_Broccoli: raises 1000 to 1000
Leisa_Fennel: folds
Lavina_Satsuma: folds
Renna_Chili: raises 2500 to 3000
Vada_Peas: folds
Chong_Broccoli: calls 2000 
*** FLOP *** [4d Th Kd]
Renna_Chili: bets 7200 
Chong_Broccoli: bets 2037 and is all-in
*** TURN *** [4d Th Kd] [3s]
*** RIVER *** [4d Th Kd 3s] [7d]
*** SHOW DOWN ***
Chong_Broccoli: shows [Ks Qs] (a pair of Kings)
Renna_Chili: shows [3d 3c] (three of a kind, Threes)
Uncalled bet (5163) returned to Renna_Chili
Renna_Chili collected 11274 from pot
Chong_Broccoli finished the tournament in 157th place
*** SUMMARY ***
Total pot 11274 | Rake 0
Board [4d Th Kd 3s 7d]
Seat 1: Vada_Peas mucked [Kc 2c]
Seat 2: Sallie_Cayenne mucked [Tc 4h]
Seat 3: Hero mucked [Ad Ts]
Seat 4: Jackie_Juniper mucked [6s 7c]
Seat 5: Celena_Alfalfa mucked [Js 4c]
Seat 6: Chong_Broccoli showed [Ks Qs] and lost with a pair of Kings
Seat 7: Leisa_Fennel (button) mucked [Qc 9h]
Seat 8: Lavina_Satsuma (small blind) mucked [6h 5h]
Seat 9: Renna_Chili (big blind) showed [3d 3c] and won (11274) with three of a kind, Threes



PokerStars Hand #3661320640: Tournament #21391319, $20+$2 - Hold'em No Limit (250/500) - 2018/04/06 23:36:02
Table '#18' Seat #7 is the button
Seat 1: Inger_Parnsip (12,331 in chips)
Seat 2: Isiah_Alfalfa (9,860 in chips)
Seat 3: Hero (12,919 in chips)
Seat 4: Jeff_Shallot (10,190 in chips)
Seat 5: Robin_Pomelo (16,708 in chips)
Seat 6: Tuan_Bilberry (26,711 in chips)
Seat 7: Corina_Plumcot (26,882 in chips)
Seat 8: Terri_Bananas (18,027 in chips)
Inger_Parnsip: posts the ante 50
Isiah_Alfalfa: posts the ante 50
Hero: posts the ante 50
Jeff_Shallot: posts the ante 50
Robin_Pomelo: posts the ante 50
Tuan_Bilberry: posts the ante 50
Corina_Plumcot: posts the ante 50
Terri_Bananas: posts the ante 50
Terri_Bananas: posts small blind 250
Inger_Parnsip: posts big blind 500
*** HOLE CARDS ***
Dealt to Hero [3d 6d]
Isiah_Alfalfa: folds
Hero: folds
Jeff_Shallot: folds
Robin_Pomelo: calls 500 
Tuan_Bilberry: folds
Corina_Plumcot: folds
Terri_Bananas: folds
Inger_Parnsip: checks
*** FLOP *** [Js 8s 8c]
Inger_Parnsip: checks
Robin_Pomelo: checks
*** TURN *** [Js 8s 8c] [Th]
Inger_Parnsip: checks
Robin_Pomelo: bets 1351 
Inger_Parnsip: folds
Uncalled bet (1351) returned to Robin_Pomelo
Robin_Pomelo: doesn't show hand
Robin_Pomelo collected 1650 from pot
*** SUMMARY ***
Total pot 1650 | Rake 0
Board [Js 8s 8c Th]
Seat 1: Inger_Parnsip (big blind) mucked [Kd 2s]
Seat 2: Isiah_Alfalfa mucked [Qs 5c]
Seat 3: Hero mucked [3d 6d]
Seat 4: Jeff_Shallot mucked [Td 2c]
Seat 5: Robin_Pomelo showed [8d Ad] and won (1650)
Seat 6: Tuan_Bilberry mucked [9c 7d]
Seat 7: Corina_Plumcot (button) mucked [Tc 3c]
Seat 8: Terri_Bananas (small blind) mucked [3h 9d]



PokerStars Hand #3661321808: Tournament #21391319, $20+$2 - Hold'em No Limit (250/500) - 2018/04/06 23:37:50
Table '#18' Seat #8 is the button
Seat 1: Ericka_Cucumber (11,781 in chips)
Seat 2: Jack_Cilantro (9,810 in chips)
Seat 3: Hero (12,869 in chips)
Seat 4: Linda_Squash (10,140 in chips)
Seat 5: Erasmo_Peppers (17,808 in chips)
Seat 6: Boyd_Kohlrabi (26,661 in chips)
Seat 7: Roni_Spinach (26,832 in chips)
Seat 8: Vonnie_Jicama (17,727 in chips)
Ericka_Cucumber: posts the ante 50
Jack_Cilantro: posts the ante 50
Hero: posts the ante 50
Linda_Squash: posts the ante 50
Erasmo_Peppers: posts the ante 50
Boyd_Kohlrabi: posts the ante 50
Roni_Spinach: posts the ante 50
Vonnie_Jicama: posts the ante 50
Ericka_Cucumber: posts small blind 250
Jack_Cilantro: posts big blind 500
*** HOLE CARDS ***
Dealt to Hero [4h 6s]
Hero: folds
Linda_Squash: folds
Erasmo_Peppers: folds
Boyd_Kohlrabi: calls 500 
Roni_Spinach: raises 2650 to 2650
Vonnie_Jicama: folds
Ericka_Cucumber: calls 2400 
Jack_Cilantro: folds
Boyd_Kohlrabi: folds
*** FLOP *** [7s 4c 8s]
Ericka_Cucumber: bets 1200 
Roni_Spinach: raises 10780 to 10780
Ericka_Cucumber: calls 7881 and is all-in
*** TURN *** [7s 4c 8s] [Qd]
*** RIVER *** [7s 4c 8s Qd] [2d]
*** SHOW DOWN ***
Ericka_Cucumber: shows [Ks Js] (high card King)
Roni_Spinach: shows [8h Ah] (a pair of Eights)
Uncalled bet (1699) returned to Roni_Spinach
Roni_Spinach collected 24862 from pot
Ericka_Cucumber finished the tournament in 155th place
*** SUMMARY ***
Total pot 24862 | Rake 0
Board [7s 4c 8s Qd 2d]
Seat 1: Ericka_Cucumber (small blind) showed [Ks Js] and lost with high card King
Seat 2: Jack_Cilantro (big blind) mucked [7h Ac]
Seat 3: Hero mucked [4h 6s]
Seat 4: Linda_Squash mucked [Th 2s]
Seat 5: Erasmo_Peppers mucked [Kd 3c]
Seat 6: Boyd_Kohlrabi mucked [As 9d]
Seat 7: Roni_Spinach showed [8h Ah] and won (24862) with a pair of Eights
Seat 8: Vonnie_Jicama (button) mucked [Ts 5c]



PokerStars Hand #3661322864: Tournament #21391319, $20+$2 - Hold'em No Limit (250/500) - 2018/04/06 23:39:26
Table '#18' Seat #1 is the button
Seat 1: Viola_Potatos (10,000 in chips)
Seat 2: Leon_Yams (9,260 in chips)
Seat 3: Hero (12,819 in chips)
Seat 4: Goldie_Pears (10,090 in chips)
Seat 5: Booker_Okra (17,758 in chips)
Seat 6: Larae_Fennel (26,111 in chips)
Seat 7: Devon_Lentils (39,913 in chips)
Seat 8: Mandy_Onions (17,677 in chips)
Viola_Potatos: posts the ante 50
Leon_Yams: posts the ante 50
Hero: posts the ante 50
Goldie_Pears: posts the ante 50
Booker_Okra: posts the ante 50
Larae_Fennel: posts the ante 50
Devon_Lentils: posts the ante 50
Mandy_Onions: posts the ante 50
Leon_Yams: posts small blind 250
Hero: posts big blind 500
*** HOLE CARDS ***
Dealt to Hero [Qh 6c]
Goldie_Pears: folds
Booker_Okra: calls 500 
Larae_Fennel: folds
Devon_Lentils: folds
Mandy_Onions: folds
Viola_Potatos: calls 500 
Leon_Yams: raises 8960 to 9210 and is all-in
Hero: folds
Booker_Okra: folds
Viola_Potatos: folds
Uncalled bet (8710) returned to Leon_Yams
Leon_Yams: doesn't show hand
Leon_Yams collected 2400 from pot
*** SUMMARY ***
Total pot 2400 | Rake 0
Seat 1: Viola_Potatos (button) mucked [3d 3c]
Seat 2: Leon_Yams (small blind) showed [5h Kh] and won (2400)
Seat 3: Hero (big blind) mucked [Qh 6c]
Seat 4: Goldie_Pears mucked [2d 6h]
Seat 5: Booker_Okra mucked [Qc Js]
Seat 6: Larae_Fennel mucked [2s 5c]
Seat 7: Devon_Lentils mucked [3h 9d]
Seat 8: Mandy_Onions mucked [3s 6d]



PokerStars Hand #3661323928: Tournament #21391319, $20+$2 - Hold'em No Limit (250/500) - 2018/04/06 23:41:05
Table '#18' Seat #2 is the button
Seat 1: Elene_Satsuma (9,450 in chips)
Seat 2: Thora_Fennel (11,110 in chips)
Seat 3: Hero (12,269 in chips)
Seat 4: Otilia_Pinto (10,040 in chips)
Seat 5: Loise_Prunes (17,208 in chips)
Seat 6: Elwood_Tamarind (26,061 in chips)
Seat 7: Louann_Cabbage (39,863 in chips)
Seat 8: Kasey_Juniper (17,627 in chips)
Elene_Satsuma: posts the ante 50
Thora_Fennel: posts the ante 50
Hero: posts the ante 50
Otilia_Pinto: posts the ante 50
Loise_Prunes: posts the ante 50
Elwood_Tamarind: posts the ante 50
Louann_Cabbage: posts the ante 50
Kasey_Juniper: posts the ante 50
Hero: posts small blind 250
Otilia_Pinto: posts big blind 500
*** HOLE CARDS ***
Dealt to Hero [2s Qs]
Loise_Prunes: folds
Elwood_Tamarind: folds
Louann_Cabbage: folds
Kasey_Juniper: folds
Elene_Satsuma: folds
Thora_Fennel: bets 11060 and is all-in
Hero: folds
Otilia_Pinto: folds
Uncalled bet (10560) returned to Thora_Fennel
Thora_Fennel: doesn't show hand
Thora_Fennel collected 1650 from pot
*** SUMMARY ***
Total pot 1650 | Rake 0
Seat 1: Elene_Satsuma mucked [9h Kd]
Seat 2: Thora_Fennel (button) showed [6d Ah] and won (1650)
Seat 3: Hero (small blind) mucked [2s Qs]
Seat 4: Otilia_Pinto (big blind) mucked [7s 3h]
Seat 5: Loise_Prunes mucked [7c 8s]
Seat 6: Elwood_Tamarind mucked [6c 9c]
Seat 7: Louann_Cabbage mucked [Jh 8h]
Seat 8: Kasey_Juniper mucked [5d 8d]



PokerStars Hand #3661324554: Tournament #21391319, $20+$2 - Hold'em No Limit (300/600) - 2018/04/06 23:42:02
Table '#18' Seat #3 is the button
Seat 1: Terrie_Skirret (9,400 in chips)
Seat 2: Traci_Lime (12,210 in chips)
Seat 3: Hero (11,969 in chips)
Seat 4: Ranee_Rosemary (9,490 in chips)
Seat 5: Keith_Plumcot (17,158 in chips)
Seat 6: Robbie_Apples (26,011 in chips)
Seat 7: Amalia_Cayenne (39,813 in chips)
Seat 8: Warren_Skirret (17,577 in chips)
Terrie_Skirret: posts the ante 60
Traci_Lime: posts the ante 60
Hero: posts the ante 60
Ranee_Rosemary: posts the ante 60
Keith_Plumcot: posts the ante 60
Robbie_Apples: posts the ante 60
Amalia_Cayenne: posts the ante 60
Warren_Skirret: posts the ante 60
Ranee_Rosemary: posts small blind 300
Keith_Plumcot: posts big blind 600
*** HOLE CARDS ***
Dealt to Hero [Js 8h]
Robbie_Apples: folds
Amalia_Cayenne: folds
Warren_Skirret: folds
Terrie_Skirret: folds
Traci_Lime: folds
Hero: raises 1500 to 1500
Ranee_Rosemary: folds
Keith_Plumcot: calls 900 
*** FLOP *** [7c Ac 2d]
Keith_Plumcot: checks
Hero: bets 1900 
Keith_Plumcot: raises 9480 to 9480
Hero: folds
Uncalled bet (7580) returned to Keith_Plumcot
Keith_Plumcot: doesn't show hand
Keith_Plumcot collected 7580 from pot
*** SUMMARY ***
Total pot 7580 | Rake 0
Board [7c Ac 2d]
Seat 1: Terrie_Skirret mucked [Qs Th]
Seat 2: Traci_Lime mucked [8d 5h]
Seat 3: Hero (button) mucked [Js 8h]
Seat 4: Ranee_Rosemary (small blind) mucked [8c 3d]
Seat 5: Keith_Plumcot (big blind) showed [6c Qc] and won (7580)
Seat 6: Robbie_Apples mucked [4h 6s]
Seat 7: Amalia_Cayenne mucked [Qd 2c]
Seat 8: Warren_Skirret mucked [6h Jh]



PokerStars Hand #3661325232: Tournament #21391319, $20+$2 - Hold'em No Limit (300/600) - 2018/04/06 23:43:05
Table '#18' Seat #4 is the button
Seat 1: Marc_Sprouts (9,340 in chips)
Seat 2: Dell_Tabasco (12,150 in chips)
Seat 3: Hero (8,509 in chips)
Seat 4: Alysha_Olive (9,130 in chips)
Seat 5: Twana_Apples (21,278 in chips)
Seat 6: Dalila_Honeydew (25,951 in chips)
Seat 7: Lemuel_Lavender (39,753 in chips)
Seat 8: Jeni_Kohlrabi (17,517 in chips)
Marc_Sprouts: posts the ante 60
Dell_Tabasco: posts the ante 60
Hero: posts the ante 60
Alysha_Olive: posts the ante 60
Twana_Apples: posts the ante 60
Dalila_Honeydew: posts the ante 60
Lemuel_Lavender: posts the ante 60
Jeni_Kohlrabi: posts the ante 60
Twana_Apples: posts small blind 300
Dalila_Honeydew: posts big blind 600
*** HOLE CARDS ***
Dealt to Hero [2s Ah]
Lemuel_Lavender: folds
Jeni_Kohlrabi: folds
Marc_Sprouts: folds
Dell_Tabasco: folds
Hero: folds
Alysha_Olive: folds
Twana_Apples: folds
Dalila_Honeydew: doesn't show hand
Uncalled bet (600) returned to Dalila_Honeydew
Dalila_Honeydew collected 780 from pot
*** SUMMARY ***
Total pot 780 | Rake 0
Seat 1: Marc_Sprouts mucked [6c 2h]
Seat 2: Dell_Tabasco mucked [Qh 5h]
Seat 3: Hero mucked [2s Ah]
Seat 4: Alysha_Olive (button) mucked [5d 8h]
Seat 5: Twana_Apples (small blind) mucked [5c 3d]
Seat 6: Dalila_Honeydew (big blind) showed [4h 8d] and won (780)
Seat 7: Lemuel_Lavender mucked [Tc 7c]
Seat 8: Jeni_Kohlrabi mucked [Jh 7s]



PokerStars Hand #3661325977: Tournament #21391319, $20+$2 - Hold'em No Limit (300/600) - 2018/04/06 23:44:14
Table '#18' Seat #5 is the button
Seat 1: Mose_Avocados (9,280 in chips)
Seat 2: Eliseo_Bananas (12,090 in chips)
Seat 3: Hero (8,449 in chips)
Seat 4: Maxima_Kohlrabi (9,070 in chips)
Seat 5: Ethel_Sprouts (20,918 in chips)
Seat 6: Quyen_Lettuce (26,671 in chips)
Seat 7: Lenard_Kale (39,693 in chips)
Seat 8: Renay_Satsuma (17,457 in chips)
Mose_Avocados: posts the ante 60
Eliseo_Bananas: posts the ante 60
Hero: posts the ante 60
Maxima_Kohlrabi: posts the ante 60
Ethel_Sprouts: posts the ante 60
Quyen_Lettuce: posts the ante 60
Lenard_Kale: posts the ante 60
Renay_Satsuma: posts the ante 60
Quyen_Lettuce: posts small blind 300
Lenard_Kale: posts big blind 600
*** HOLE CARDS ***
Dealt to Hero [6s 9c]
Renay_Satsuma: folds
Mose_Avocados: folds
Eliseo_Bananas: folds
Hero: folds
Maxima_Kohlrabi: raises 2580 to 2580
Ethel_Sprouts: folds
Quyen_Lettuce: raises 10860 to 11160
Lenard_Kale: folds
Maxima_Kohlrabi: calls 6430 and is all-in
*** FLOP *** [Qc 9s Jh]
*** TURN *** [Qc 9s Jh] [8h]
*** RIVER *** [Qc 9s Jh 8h] [7h]
*** SHOW DOWN ***
Maxima_Kohlrabi: shows [Jc Jd] (three of a kind, Jacks)
Quyen_Lettuce: shows [Ts As] (a straight, Eight to Queen)
Uncalled bet (2150) returned to Quyen_Lettuce
Quyen_Lettuce collected 19100 from pot
Maxima_Kohlrabi finished the tournament in 148th place
*** SUMMARY ***
Total pot 19100 | Rake 0
Board [Qc 9s Jh 8h 7h]
Seat 1: Mose_Avocados mucked [7d Tc]
Seat 2: Eliseo_Bananas mucked [Kh 4h]
Seat 3: Hero mucked [6s 9c]
Seat 4: Maxima_Kohlrabi showed [Jc Jd] and lost with three of a kind, Jacks
Seat 5: Ethel_Sprouts (button) mucked [3h Kc]
Seat 6: Quyen_Lettuce (small blind) showed [Ts As] and won (19100) with a straight, Eight to Queen
Seat 7: Lenard_Kale (big blind) mucked [Ac 9h]
Seat 8: Renay_Satsuma mucked [5c 8s]



PokerStars Hand #3661326713: Tournament #21391319, $20+$2 - Hold'em No Limit (300/600) - 2018/04/06 23:45:23
Table '#18' Seat #5 is the button
Seat 1: Loyce_Tabasco (9,220 in chips)
Seat 2: Ciara_Onions (12,030 in chips)
Seat 3: Hero (8,389 in chips)
Seat 4: Sunni_Papaya (20,858 in chips)
Seat 5: Felton_Satsuma (36,701 in chips)
Seat 6: Rae_Broccoli (39,033 in chips)
Seat 7: Gay_Apricots (17,397 in chips)
Loyce_Tabasco: posts the ante 60
Ciara_Onions: posts the ante 60
Hero: posts the ante 60
Sunni_Papaya: posts the ante 60
Felton_Satsuma: posts the ante 60
Rae_Broccoli: posts the ante 60
Gay_Apricots: posts the ante 60
Rae_Broccoli: posts small blind 300
Gay_Apricots: posts big blind 600
*** HOLE CARDS ***
Dealt to Hero [9h 2c]
Loyce_Tabasco: folds
Ciara_Onions: folds
Hero: folds
Sunni_Papaya: calls 600 
Felton_Satsuma: folds
Rae_Broccoli: calls 300 
Gay_Apricots: checks
*** FLOP *** [Ac 7c 3c]
Rae_Broccoli: checks
Gay_Apricots: checks
Sunni_Papaya: checks
*** TURN *** [Ac 7c 3c] [Ah]
Rae_Broccoli: checks
Gay_Apricots: checks
Sunni_Papaya: checks
*** RIVER *** [Ac 7c 3c Ah] [Jd]
Rae_Broccoli: checks
Gay_Apricots: checks
Sunni_Papaya: checks
*** SHOW DOWN ***
Rae_Broccoli: shows [6s Ts] (a pair of Aces)
Gay_Apricots: shows [3s 8c] (two pair, Aces and Threes)
Sunni_Papaya: Mucks [5h 6h] (One pair)
Gay_Apricots collected 2220 from pot
*** SUMMARY ***
Total pot 2220 | Rake 0
Board [Ac 7c 3c Ah Jd]
Seat 1: Loyce_Tabasco mucked [Kc 2s]
Seat 2: Ciara_Onions mucked [6d Qh]
Seat 3: Hero mucked [9h 2c]
Seat 4: Sunni_Papaya mucked [5h 6h]
Seat 5: Felton_Satsuma (button) mucked [5d Qs]
Seat 6: Rae_Broccoli (small blind) showed [6s Ts] and lost with a pair of Aces
Seat 7: Gay_Apricots (big blind) showed [3s 8c] and won (2220) with two pair, Aces and Threes



PokerStars Hand #3661327504: Tournament #21391319, $20+$2 - Hold'em No Limit (300/600) - 2018/04/06 23:46:35
Table '#18' Seat #7 is the button
Seat 1: Teena_Habanero (9,160 in chips)
Seat 2: Edward_Onions (11,970 in chips)
Seat 3: Hero (8,329 in chips)
Seat 4: Jacki_Soursop (10,000 in chips)
Seat 5: Louie_Yuzu (20,198 in chips)
Seat 6: Lazaro_Mango (36,641 in chips)
Seat 7: Darcel_Pinto (38,373 in chips)
Seat 8: Cara_Parnsip (18,957 in chips)
Teena_Habanero: posts the ante 60
Edward_Onions: posts the ante 60
Hero: posts the ante 60
Jacki_Soursop: posts the ante 60
Louie_Yuzu: posts the ante 60
Lazaro_Mango: posts the ante 60
Darcel_Pinto: posts the ante 60
Cara_Parnsip: posts the ante 60
Cara_Parnsip: posts small blind 300
Teena_Habanero: posts big blind 600
*** HOLE CARDS ***
Dealt to Hero [3s 5s]
Edward_Onions: folds
Hero: folds
Jacki_Soursop: folds
Louie_Yuzu: folds
Lazaro_Mango: calls 600 
Darcel_Pinto: raises 3011 to 3011
Cara_Parnsip: folds
Teena_Habanero: folds
Lazaro_Mango: folds
Uncalled bet (2411) returned to Darcel_Pinto
Darcel_Pinto: doesn't show hand
Darcel_Pinto collected 2580 from pot
*** SUMMARY ***
Total pot 2580 | Rake 0
Seat 1: Teena_Habanero (big blind) mucked [Td 9s]
Seat 2: Edward_Onions mucked [Js Qd]
Seat 3: Hero mucked [3s 5s]
Seat 4: Jacki_Soursop mucked [2s Tc]
Seat 5: Louie_Yuzu mucked [4d Ah]
Seat 6: Lazaro_Mango mucked [7s Qs]
Seat 7: Darcel_Pinto (button) showed [Qh Jh] and won (2580)
Seat 8: Cara_Parnsip (small blind) mucked [2c 5c]



PokerStars Hand #3661328383: Tournament #21391319, $20+$2 - Hold'em No Limit (300/600) - 2018/04/06 23:47:59
Table '#18' Seat #9 is the button
Seat 1: Hugh_Papaya (8,500 in chips)
Seat 2: Herma_Lavender (11,910 in chips)
Seat 3: Hero (8,269 in chips)
Seat 4: Monte_Lychee (9,940 in chips)
Seat 5: Adria_Coconuts (20,138 in chips)
Seat 6: Venita_Bananas (10,000 in chips)
Seat 7: Marcos_Cucumber (35,981 in chips)
Seat 8: Edie_Lychee (40,293 in chips)
Seat 9: Mertie_Goji (18,597 in chips)
Hugh_Papaya: posts the ante 60
Herma_Lavender: posts the ante 60
Hero: posts the ante 60
Monte_Lychee: posts the ante 60
Adria_Coconuts: posts the ante 60
Venita_Bananas: posts the ante 60
Marcos_Cucumber: posts the ante 60
Edie_Lychee: posts the ante 60
Mertie_Goji: posts the ante 60
Hugh_Papaya: posts small blind 300
Herma_Lavender: posts big blind 600
*** HOLE CARDS ***
Dealt to Hero [Qh 9h]
Hero: bets 8209 and is all-in
Monte_Lychee: folds
Adria_Coconuts: folds
Venita_Bananas: folds
Marcos_Cucumber: folds
Edie_Lychee: calls 8209 
Mertie_Goji: folds
Hugh_Papaya: folds
Herma_Lavender: folds
*** FLOP *** [3s 2s Ah]
*** TURN *** [3s 2s Ah] [8s]
*** RIVER *** [3s 2s Ah 8s] [8d]
*** SHOW DOWN ***
Hero: shows [Qh 9h] (a pair of Eights)
Edie_Lychee: shows [Ac Ad] (a full house, Aces full of Eights)
Edie_Lychee collected 17858 from pot
Hero finished the tournament in 139th place
*** SUMMARY ***
Total pot 17858 | Rake 0
Board [3s 2s Ah 8s 8d]
Seat 1: Hugh_Papaya (small blind) mucked [Th 5h]
Seat 2: Herma_Lavender (big blind) mucked [Kc 5s]
Seat 3: Hero showed [Qh 9h] and lost with a pair of Eights
Seat 4: Monte_Lychee mucked [Tc Kh]
Seat 5: Adria_Coconuts mucked [2d 7d]
Seat 6: Venita_Bananas mucked [6s 3c]
Seat 7: Marcos_Cucumber mucked [Ks 9s]
Seat 8: Edie_Lychee showed [Ac Ad] and won (17858) with a full house, Aces full of Eights
Seat 9: Mertie_Goji (button) mucked [4h Qc]




